,sha256,family,total,call,return,jump,forward,backward
0,00011e3c72f77fd7cebaf0a59c411a5ad5dd4778d30fa085e18e05de77678b92,adware,222592,843,1665,1773,2616,1665
1,0014f640f54d304a7c34797ae7dc81cde9215ada4a04a6a39e5693e3290cef3d,adware,198733,750,1496,1668,2418,1496
2,005de2971db4c3704264fd0771d3a32255e468e2972dc921611487e3c2db3333,adware,235432,1029,1816,1955,2984,1816
3,00e29c9e76baeeb012be5c9c3d4f8fc1477e70619108dd279fa3b1f9d575be79,adware,234597,927,1818,1957,2884,1818
4,011518b58379d986a4fad32065db413516b5ad561bab9a377f96bce6e13cbdfd,adware,235425,1036,1851,1872,2908,1851
5,0116d8e66e7097226cbd44f831f986f025a0f1a2387f4fe3d01db59a10bfbc85,adware,1186154,4641,9598,9296,13937,9598
6,013bc0a63121c9578140fdc79be9f37b5a466524ed71946a3315abc59fa5959a,adware,231948,944,1773,1910,2854,1773
7,0165607397098be2dbd3bec66a1283401df86e21177f89c576eae7d338fd4623,adware,198510,736,1596,1726,2462,1596
8,018b1c67cd10e524a90c6d89276883827fd81a0603aa52e08902fdbf746d46c7,adware,223166,939,1666,1849,2788,1666
9,01c4b5b405d65576a75b0348515e210ca762dd6d2c50d38d890833ae27f93c57,adware,315648,1399,2443,2582,3981,2443
10,02000f79a38435a3c2bd076699f5926ea636b5742d8a445470ff7b9d4f2fe358,adware,198398,772,1592,1621,2393,1592
11,0212d9f12ae45c6551560890ea59176afcad1d3819981c036b1c26bc2c6ae9a6,adware,221025,892,1726,1805,2697,1726
12,02e4f4542e947ad41b52d89d2c68748705977684d39bb7edc57920640e4f6832,adware,222832,861,1660,1801,2662,1660
13,031c6307dcca200ccfccde6c003397917b1b560f7f0510e15d74f2adb076baec,adware,222064,838,1757,1766,2604,1757
14,03a02c770fd5e27f7d7ab7a75358b831de61c35dd1cc40437f07ef364649e6c9,adware,378262,1500,2975,3231,4731,2975
15,0408eed39aee7c02e3eac8c967f786bebab5b2716332dddc63529ada7cbe94d2,adware,219978,854,1682,1874,2728,1682
16,043d4df41c07fe4884902bf67fa987824010ee7f7ad1200ef27649009df1dff2,adware,198499,810,1604,1651,2461,1604
17,04b6313df1909bd5ea822e9243055821b86eba5541560fa45eae4ef245fc4e36,adware,215290,855,1757,1776,2631,1757
18,04ce108c3fb4be818de2df39ec3d95d5d13801c83fe6076408b6b0ac20207f4b,adware,233877,970,1940,1971,2941,1940
19,04df3eab2ec77d6c372a494048947f08c0e77973cde508198229f22e5bd33df3,adware,198291,741,1587,1590,2331,1587
20,04df4a4a1527a82fe7f73c39dc093ef6b985b9998480573edfbfd208176d8271,adware,198511,809,1547,1555,2364,1547
21,04e0a516f49247e8919474f24b08d8739ccf8c767c385a099137765b6fac6e35,adware,198539,792,1557,1637,2429,1557
22,05361044708eb2d4287cc0f23c5c95dfa77a3e9f86a669cbb7600bb81a9630e6,adware,198413,757,1599,1550,2307,1599
23,053dc3e6ee647eeb4d33c70a6b61b982d12739ed02639ba7ed83a964d606fbba,adware,234523,1006,1845,1986,2992,1845
24,0544c3470cf378667bb6c192d183f915c61a903c058ca36dae50ccbc40e895e2,adware,533952,2355,4171,4259,6614,4171
25,057a4df8fd9b3eb004e3bce216c96dc90fc0620144d239b8dce58ac7f44c745b,adware,466748,1893,3620,3746,5639,3620
26,057ccfe7659e09eb9c736f2e86c292af93e5ecd64a0ed99bf753589875d8c218,adware,221604,890,1767,1854,2744,1767
27,067f916c7a77d9bcc9e85b68aaa2d6267689122b89be35cc836598d95d00b7ea,adware,232750,968,1871,1913,2881,1871
28,06e0c11a84b3e6ae1e030fed61e633c26ceee86b9b725cf925c4715ecb234265,adware,198442,767,1538,1601,2368,1538
29,072e28b63ebeca48e0f3678033648c388ead94cf04668ff25c586cc566d12b12,adware,554130,2331,4376,4592,6923,4376
30,07589cf1fb715fca03db3f26c874715a89939e7783c0f182efe9fc2cd0e9b366,adware,234073,974,1854,1951,2925,1854
31,07690a38b5267b6bfe423c754990717925e166e78cd5ee2617770e9a43c16ba3,adware,227702,917,1802,1726,2643,1802
32,07e02b5b9b0e56187ed9eb51bc80327a05ac164c83766834f62c4b32702e7a3d,adware,198700,801,1594,1624,2425,1594
33,080a70f9407b06b579610dfba182457c39b47e794735126d779d6962ffe03834,adware,503900,2155,4031,4188,6343,4031
34,0841565227dfd61a52c9a54d1bca5ea2a4aa26b7d3e7c9e2d2d5694ef8809f2d,adware,207992,879,1712,1738,2617,1712
35,08448b66f7416d9c99e5087760fe89f9894703b808f1dc1b32079ba2bbb28b6d,adware,976011,3926,7595,7955,11881,7595
36,084ac3e0cc7e8f7ecdf921fc9a45bbe696c0b71dd9a73bab16651dd4ff8bdce9,adware,222371,880,1785,1928,2808,1785
37,08d80400fd7d6c2b33d434f58cc8f3397a6bd9edf9f4fe606782483fcca21cd4,adware,733440,2997,5782,5882,8879,5782
38,08e380a7e6002a8ee5684ca5d8a81aefa719cc6f44fe2655e5776a2cf9d7ed96,adware,198598,782,1560,1655,2437,1560
39,08f9d4c077f62deb87b17238ac2fa55f81cb63139408f933176019463cb19a30,adware,335622,1336,2660,2751,4087,2660
40,096f458c9f4e5b6c8044e9d0c3218fab209ce9f19b901d3b00e609886c064d00,adware,235338,1008,1835,1890,2898,1835
41,0970d266ae5c0ae3e38778f48de68e5598ee53ec371586d6d39423313356f175,adware,738954,2963,5871,5913,8876,5871
42,09b2b9fc1acf5e04912e7121b643d94b721d74c98ef8617b3db6ae93734e44ff,adware,219495,892,1808,1634,2526,1808
43,09cc6957b14bc613ab441656db6d0d2a82983ec76cd8992cafa15c5455a45a0f,adware,207395,824,1597,1674,2498,1597
44,0a3f128a558751a1dea1b8c7334c1965640b69d8de0e16396c0a5c5489edae76,adware,318350,1398,2643,2609,4007,2643
45,0a6cba3eca1e31030dfc5cef9775a08f41641c50b7a7307951e2accbe0f05a4b,adware,553351,2329,4369,4466,6795,4369
46,0af473a4ae6f7aa0962892ecf561be2bc3f7306e8495b3302abf1f5a999294d8,adware,198619,732,1531,1588,2320,1531
47,0b4b02fd3ec77549e292495b80a3975d6a1d87b88cb8e70ef5ae683132990d60,adware,222093,841,1765,1814,2655,1765
48,0b52c37577696403269889ba78b96cd990e4a9c2bf7eeed93c26aeea36882e19,adware,207254,862,1598,1736,2598,1598
49,0b5306ebccfbcdbe6e5d9d1bdb31113eeeebcf147d6b7fbd17cb47448597df7c,adware,827102,3436,6485,6537,9973,6485
50,0b5d3a7eeb0cc5ac73e80edb6f6159d5ab742933133692ca5048978f6541db19,adware,192851,809,1541,1608,2417,1541
51,0b7d7c41dfcd52ba2b63246c90ea1f0a32ab0188969bc850e9c8389d3104be9a,adware,206538,837,1582,1796,2633,1582
52,0c10714b93fa243179dcaa804564e17f9e10f6758d716f8d30ac5c18e8a548ce,adware,198397,768,1595,1647,2415,1595
53,0c63a0764c53ceffbe1a5e0ef7013166bf4449c353c293f8eaa9d91148b9cd42,adware,480580,1929,3791,3850,5779,3791
54,0d306ab55e3720b51116bc612ecb60bb662049ccbe3b99be6dad970df3fb9961,adware,309063,1330,2290,2585,3915,2290
55,0d3eae49966ace6b00aa82a0067336bc7aac49d20c9c3560e20226cf9f770099,adware,221032,807,1668,1772,2579,1668
56,0de091a47b149f407dad62ee529b9a3bb6e9b931d1df847746a46b34be211dbb,adware,194291,713,1585,1539,2252,1585
57,0e2086d8baca29315cf34a392fa25e72dd5022fc021cc6ac709076cc644a5e9d,adware,233038,1004,1825,2003,3007,1825
58,0e5d375e80974b085f2b6714829a1e9e218f2dc4ebbf3ceb91a270a7251d6c94,adware,198630,763,1586,1655,2418,1586
59,0e8310cdcf8fe04313d2bede66aca2c1179a31b243638290fa1b49510b73a618,adware,533743,2237,4090,4308,6545,4090
60,0ee71b546655f0cf1ffb23800be810dd6ac0e7f2a638badd1aab75e3077d2528,adware,735467,3087,5800,5910,8997,5800
61,0f5bde0bfe374c8dc9bc427a624cf7c2cde84641241990dd278c9a0a5c566975,adware,198438,759,1544,1647,2406,1544
62,0f838f676a335d296e640277b5bee2e16cddc73a3442e6083ba905077381a4b4,adware,221319,795,1742,1734,2529,1742
63,0ff80a0bd0acd8cfc6bc00222512fdef15673826a5484cd1f429519411304961,adware,235815,957,1840,1954,2911,1840
64,0ff8d95913dccd9c1767cd5f86b9712545c7befff55d1184af9e5e884ca9779b,adware,221268,834,1689,1709,2543,1689
65,0ff9fd6716f0397174f60d9035cc283be4016867c25519b1e901d5d35b0e7046,adware,730210,2998,5673,5759,8757,5673
66,10080b1ca985985363be22deb52dab67667cbfdb39c5a9b5a1bd3592b56ab080,adware,198257,760,1548,1574,2334,1548
67,1017bb61a5e07eccec2528f82e88f53efa2fbfa9f16fc6513e1dff39f6b7bfc8,adware,307232,1204,2508,2424,3628,2508
68,1022662fd4a385aa6f71708f74eaae4df838e002aee2954ee4e376a2721c7da3,adware,198309,755,1582,1596,2351,1582
69,1054cc303abd50da662ba129a5a04b978bb996f5fb60dabcab9cfb8bad391f7b,adware,398898,1600,3103,3072,4672,3103
70,105fe2ae072017b0d9632aa6d4b6c4824a3d2dbf76ef20f0672acfa699da06d6,adware,741348,3229,5715,5955,9184,5715
71,10a69db5c3a654c81f84a25c01c749a623166987ceda1653792f6adcc32e9ba1,adware,192726,698,1594,1598,2296,1594
72,10aead7a5578075e62a0f1c79e1485804a5d7b462801205d98235b56396928f3,adware,529069,2070,4210,4317,6387,4210
73,10bafc26114e1aafb4dfea0741faf9e813968e21cc2815da868c7286afee49db,adware,966127,3988,7530,7773,11761,7530
74,1112d2eeacce9d810cc597c91520468b478d49132b86f6c169c62eb319fa8c3c,adware,234228,913,1865,1933,2846,1865
75,117b470e2b5cc0f019a7e25a0170b8ea6bc398115bfc44d40d651ce6019c4a47,adware,589643,2599,4702,4931,7530,4702
76,11b30d21ed483bd30e29267af75557f4b01625786cd940ab6f2a7c69c0a5e044,adware,367691,1455,2915,2813,4268,2915
77,1239f72e4fc71ac0e311d5e82d933a197c26df24b13bfb8dd1ad27c8d707c110,adware,699936,2851,5612,5818,8669,5612
78,1273eaeef2a490b7d77ae6be308ee72eecbc1bcef3ae28ed7eb666184fe1b1ab,adware,236578,984,1938,1926,2910,1938
79,1321a6abe6f3e85eefe6bcd1676f324215718662d029f8b50e770be03e018c93,adware,534012,2300,4299,4201,6501,4299
80,13246eecf3dd1d937c2514c93437f2b57e5bc1e234110866cc24c2b6d3e8849e,adware,235188,937,1856,1929,2866,1856
81,133be71cb739d389966e158015d57023c5b5eb3751234e475ab9438e9572ac21,adware,233026,947,1787,1905,2852,1787
82,134e612ff4c69d05962449407b17d5c07a2ff9c0f5e235cfd86ca9a6f8347a61,adware,612208,2479,4777,5130,7609,4777
83,139f0bfd7d8df58da2ba5461c07e6d37fc3f98be216972c55e0989c9f95679ed,adware,133398,513,1075,1111,1624,1075
84,13c7a1b34a7e4ae9979c6b0a32ae8bedf48f9ab674561166f9e96c1067d3b069,adware,233622,934,1802,1973,2907,1802
85,14142e5a3efedbc0a816bd51b8fda92f0aeededca0653b15f2b5593ac5e7dd27,adware,355723,1516,2815,2910,4426,2815
86,14253ee40825e5d19cfdc5dc42f79cabbce35bce52ed3c43f81303b73b128fad,adware,234670,976,1760,1972,2948,1760
87,1429f689e67ebf3ea95d56d2184678fd2347dcf75fc1562b77b3511a031e39ee,adware,233783,967,1825,1927,2894,1825
88,145d20b6bd102d0bc7839ba6c999e9fdaaa712ca1b1508a151cf5cb8e6b9314d,adware,224491,826,1714,1872,2698,1714
89,1489eacdca3334562feb6d38db6007777743156893b1e1e798a49d6e47f4add3,adware,328847,1353,2652,2598,3951,2652
90,14f08c4b0921df96f6418f9cfa62be6bc23781a0f3727f3fd52adf4992e6217a,adware,198834,733,1576,1683,2416,1576
91,150d309579e2f9cfea4150261487a9e07889c311b3ea0f0e2a6542e6a6c169d4,adware,198315,781,1557,1654,2435,1557
92,154c84e047a476bf92c2a8a2e94308b5a81a4280c2cb563d18195a1cae84faa8,adware,232382,966,1770,1881,2847,1770
93,157ffd142aad2ae3cfe1e1f32328392b084f6e0488e861ba50ab4d7bbd4d4ca6,adware,234068,957,1873,1954,2911,1873
94,15aa5fcaf9dfe5498b345ccc176cbad43d4977865db337685b3b5c08ab0fe011,adware,971994,3981,7600,7665,11646,7600
95,15d65cb20a73df07e139c78e3002d10cbb3eabd2971ea1bd80747517e546201b,adware,198907,772,1575,1654,2426,1575
96,15ddc73ac9850b793327534f69f6d38da6765b51303dd99b82d6f3d91d8276d7,adware,221703,861,1803,1867,2728,1803
97,168becaf4e65d689cde65ad8342d4254ee182e34e505f067c450bd9dc89f1477,adware,535013,2295,4245,4275,6570,4245
98,169fe52dc6142296d7bc1ab632a9a85017392b3d36c3e69e00e3556ba984c465,adware,979490,4001,7824,7750,11751,7824
99,16d878295966292be2b9a30032af4bec1effe10bfa9b208861cb75a6f3f02e90,adware,236010,963,1782,1909,2872,1782
100,172166e21f4c68747bcd2f262ce839e8f398728864b6b4d443094982c6d728fa,adware,235044,971,1834,1935,2906,1834
101,17b73a6dfa6e3b21afd8ef1b341c057a78016f78137896cd10a1e07a02ae1e85,adware,216719,847,1701,1724,2571,1701
102,1854d000fc487bd1624e422679f971a38a785c0698a21d3f19162c655fd9315e,adware,232709,973,1864,1838,2811,1864
103,189702641f305d970f3bcc4d1380f7796472d5bfdd4781d995262915f5ebb682,adware,1180643,4563,9369,9408,13971,9369
104,18be74d5fc8b8beac745d7332e3d7a1d8846b5bb78eef03dc9eb920daf0c558a,adware,355097,1427,2818,2868,4295,2818
105,1921eaecf17cd1840048c9e6f6f0fb6f21532d10cb0c3c5a7f5ca38ab57ab126,adware,195581,773,1623,1610,2383,1623
106,192c70da8adf9eee2288d6ff483f88d489919e14740ae172b85552d73c41d4a4,adware,231058,969,1818,1815,2784,1818
107,195a7c119d4241c44c9cb01a9a34d6ff158a1071a556e01292e2da375c6589a5,adware,223437,888,1761,1803,2691,1761
108,196a89e99ab0a5f85a491af06f7e48142e84f4495e991f48d8afa876797003ba,adware,234049,979,1830,1973,2952,1830
109,196bbba6dc8e5413fc68d4e291938841875b7f8352d537c00c000af6041e3822,adware,466225,1891,3678,3633,5524,3678
110,197c547f406732160b608efac7518bd45a4af72e43f88a52cd7ca91db21ee9e6,adware,839952,3455,6754,6618,10073,6754
111,199c1915e8cbabdee3cfc4b144a5bb8d197bbfff71a3fae2bd6174db933ff8cc,adware,217628,856,1783,1661,2517,1783
112,19bbe7bdc1e340889ec6391d225d9fce553df5ac5347bb2c0df440587a523483,adware,974335,3989,7608,7800,11789,7608
113,1a9e8aa2e08c507233d00681fb2350b418a0f078c20f2591df1db62e9b129923,adware,234732,978,1846,1925,2903,1846
114,1ac75aa88763cbb78f665184f609bcd471f17438bab893944bde3147c02e642c,adware,233016,932,1817,1976,2908,1817
115,1b67e1ed3bd48c0f36a275a8a6e7ba02755fc15cd44b813051310238d3885327,adware,498498,2121,3979,3986,6107,3979
116,1b6a228897390ed31955be1219c17ad9f51fca1120aa2bf97c09cf411b2f4910,adware,222118,871,1731,1809,2680,1731
117,1c1b7ba374acbb17e31e85c4bf06baa047d827f19a566dbd6294256b2aec342f,adware,195293,793,1690,1653,2446,1690
118,1c3845887e591268ba30bd0a6616acb78cbc878d3a9f1d1f4d6c1e4fa0698179,adware,221909,879,1844,1768,2647,1844
119,1c6a18ec33e0e57d7d48a4d0a41cd0912314ef37246a006446bacbc10544a552,adware,502940,2023,3927,4007,6030,3927
120,1c965d1d3ee34aff53ae9838538b0eb94df91e96ed808f11c363383ecb6c3c73,adware,198139,737,1567,1633,2370,1567
121,1cbdead576af3c4065a83ec0cc6db7dde2b310a225929cb9e365420fa1272a21,adware,215518,840,1687,1807,2647,1687
122,1cece67fef6df52f54f5bd6e8ae85c6fe8449c48961cdee7ae2db824545fe10b,adware,198852,763,1637,1635,2398,1637
123,1ddcc13305fff6b2c32398ebaad2e2096f3d80e8ce9359320b877edf0900e368,adware,222157,864,1777,1819,2683,1777
124,1e1dcb6fe866873816a2560d011c51e28c04e8afe8fcc80805e7411ae78268b7,adware,198584,813,1539,1670,2483,1539
125,1e29ba9993c209b7b1d37c3b37b8ddce7db4c2f362e7a8f93e6e20112e37b84a,adware,222565,875,1734,1826,2701,1734
126,206acbed2493fb5dcb0df179982653c75395afe03b3424b5259f7c9155c20363,adware,1022102,4217,8015,8255,12472,8015
127,211e86799644c21b3c0749e1670cfe543efcc6d1d57f6d21583027b8b1f2a87f,adware,224999,902,1679,1855,2757,1679
128,215e433505fa3c6525515732f1ebb241886d2cb7f355a587468767fba1825bbb,adware,235358,960,1871,1888,2848,1871
129,2193216cb7567533fa84f9b239fbb7882afe45bcc9ae0aea55de6a6d634a3582,adware,807733,3359,6392,6491,9850,6392
130,2219b67bc2f8a0506ebd1fd70b266cca1de69bd0094312c9e08619ae7eaedace,adware,485945,2020,3735,3907,5927,3735
131,221dc86eaf25293046003fc1342cb7094b1fcf8b0f511282238909bf19689f81,adware,198688,793,1563,1709,2502,1563
132,222010fbccc2a80abc8443dfbfcc7607e429932bac5ca366b38a5916f62bd2a4,adware,304310,1259,2432,2421,3680,2432
133,22b80a01cef18060e701a584e20d8cfd8245d6648d72118f0a486458250626e9,adware,550252,2197,4292,4499,6696,4292
134,22d0f9596e86a61635d1d23611e1843d0090a967523efc89602d9daaab7c1492,adware,1021444,4417,8075,8414,12831,8075
135,22d53f74c78b2fdd4a519711a94c2d7dee4cb2111a18cc017e86f45230099b5e,adware,1193626,4732,9225,9620,14352,9225
136,2310290968f7c8b63b98d91be6c3d3d5358c9462393d71f81e164bf824c9aabd,adware,198564,763,1599,1650,2413,1599
137,2365bc7a14f5239a4bf23507fa52644e84b7d5f52320e871b42116e5938ffe2b,adware,533658,2258,4214,4340,6598,4214
138,2390815571f01ebac5bb5656a10e3a3b77ed06fa0d5bf151c8bc524ccd9e4862,adware,233715,942,1813,1903,2845,1813
139,248df6327eea29f163ba9db7f5659f58d807043e332e2b24c8bbc531fcaf0db4,adware,198411,747,1566,1638,2385,1566
140,2537df4fa001da6ccbbd23e859139b1a2d8ec64afbcda8e178e6380c6a5e162a,adware,235047,968,1782,1950,2918,1782
141,25615d0773b9ca9bc9a65039ee967d1b593f4a071240adde2b455710774725e6,adware,1182932,4632,9543,9305,13937,9543
142,25bcc29b074cccd1ffdd4c973619d39ce41f59d93a4c2a36ec9226ba210ba97f,adware,234657,960,1871,1933,2893,1871
143,262699fc48a3538833696a8dd96035335bf61c948f8223829c1c777bd954af10,adware,224346,798,1782,1797,2595,1782
144,2635af5e4ead6a67f0d79705bde07158c31f834b9134b1be7e8a7a1bad0b9d17,adware,222890,848,1755,1791,2639,1755
145,2685d0890492f787df0d52e2e936fe21c32bd6d221bba631e0cd5c68cb1225eb,adware,236922,938,1890,1894,2832,1890
146,26e9b24288621be4b9bc2aacafb6e054f2ce0691cf060aaadd09f12d33025b0f,adware,205607,885,1594,1734,2619,1594
147,26f7545d78e728ebf12af30545a752e70c87f10da96eca38f3b5727f7ce83878,adware,198417,792,1596,1624,2416,1596
148,2707b4fdf131f8f453383db75a6af36996e8812b659279faa54b7632cba939f9,adware,235499,958,1899,1926,2884,1899
149,27510fe640171a20b5f1b88603da3d1f6bab8c82c035cc961f23397058fed663,adware,236260,949,1823,1937,2886,1823
150,2785eda002d042c6897c6965010113493f4b20610bcd3b4ac7209f867b7ca714,adware,303384,1291,2366,2444,3735,2366
151,2906b51d61df1875c0de8c4613232550e9589c3c30df1511b31c9192aa66e647,adware,235387,1007,1840,1945,2952,1840
152,2913f65719e215cd64b82e0a6615a089861c55b5d1d1f9cee43316d26b8c5d15,adware,467369,1962,3659,3689,5651,3659
153,29151d828e074c99d716ba96d2f79106b1e4f8712a27bb83349ad32b6173e32f,adware,737095,3116,5817,5705,8821,5817
154,293ad706fa1d950066fcbbaad1ea53c0c73c48f44cd212ee5289e0dd51e2becd,adware,470053,2044,3793,3788,5832,3793
155,293b9bda3aad2c3bcc5c9db1dc85ad39e8ade69d6461c07a32d403a65d658918,adware,387091,1587,3123,3032,4619,3123
156,296beeb5f68fa3830f98e8b9d4c9a4fdc9b46b8cd36ddd496b1aa63ee61b906a,adware,231034,989,1976,1892,2881,1976
157,29a45138bcd9ff02701d9de9d813735900f64f64a8db927ef8aee3ba8027316d,adware,198627,805,1576,1598,2403,1576
158,2a22c203dbb37731d2f0f788b97abddc7cabee26e1f2abcc39c3bc0dcde133d3,adware,192873,801,1533,1623,2424,1533
159,2a3ce8852dd0ee17f7852a34c0c4f6e6957b6c368d02b94b77f9672a73483ddb,adware,736092,3033,5617,5844,8877,5617
160,2aa6dc54910fd01c44249388cb8c0f63192ee767028284fd16b138655f57e62f,adware,964082,3873,7686,7710,11583,7686
161,2aaafd59b1976783f0cfd7e8d9747887be65962151e14bd42773b07683f906bc,adware,233897,946,1890,1962,2908,1890
162,2aac8c7e9f9fe89176a97cb421866ad26d498b7e00af7e06ccf8d127dcf0e11a,adware,974458,3988,7773,7625,11613,7773
163,2b07c5d97952d7c0016ad30270dc80411c4229ba3901813ac33c547548f46831,adware,610319,2528,4778,5072,7600,4778
164,2b44e5d18dcf7ee2398f4dbb6d0290226baefdfd1736d3c2d293029c485d8474,adware,614568,2606,4882,4988,7594,4882
165,2b81ec5e92f7c4c4a4c7d7b09236d6c84f18a229d093067d7c5018638e370749,adware,351095,1357,2747,2753,4110,2747
166,2b823e177ae51376b024fb75ece35ea303922548e9d70a348f9beec2e3576399,adware,971848,4013,7658,7746,11759,7658
167,2bbbf25f70c128340888929c367ff4ac2189b1b8d2e1267389e4390d2664a3c9,adware,216993,852,1669,1672,2524,1669
168,2c001465fb7e4c83abe04807759d69d0e83b75afd29a64d745b56fbab38b75b4,adware,216298,856,1735,1697,2553,1735
169,2c6e79399d433f9e85c08d4760c528ddfe9192201d4a5dc80c31e73110669d30,adware,198508,748,1607,1591,2339,1607
170,2c9f1162cc91d4a79aa5bbbb91e33d81fe474e9d0662278f64efb534fefc2a1d,adware,233444,928,1947,1943,2871,1947
171,2cd1d6b6678fbcbd09a09c6d5f9e438751989752d8cd90c976b917ac7b33fc3d,adware,198467,817,1578,1623,2440,1578
172,2cfde731eefb9bea351cc8703b776502b29538e754b8ae33f2e907e5bef57bca,adware,198288,737,1610,1646,2383,1610
173,2cfe40d09b833a32ec5424772f70109b596af32fb67acdfa22b06a7e191858b6,adware,27455,114,186,197,311,186
174,2d03a9eb8aa4d2670730a57eb0ed907233c8457d82f185bf4cb9573ef3c22759,adware,435194,1775,3483,3436,5211,3483
175,2d1572e30d060ded5a9d5db54df51e83263315cb66556f3686b2ce779719a5f5,adware,309382,1281,2361,2441,3722,2361
176,2d74aaf743737679e67e58860a4b5cdf9b4e8142af49e34031f923d42d7a6eaf,adware,533829,2187,4271,4233,6420,4271
177,2db2e42be59e888b50916f61afb3af0606aea012465e61d24107876eacf23965,adware,198582,812,1652,1683,2495,1652
178,2db2f89f0e5e9032267c3f1943c3b55632ff9eae49f7334eefca7fe2bbd135ee,adware,233904,912,1883,1947,2859,1883
179,2dcf6794be84076d94c5223c2f0db7552e41b86b5482d02aafadb7f9f692688c,adware,227265,860,1857,1898,2758,1857
180,2dd85e1d55f8d832c06ed75dd01d4d84dc0b994543e37fb59cd3308707f00bea,adware,198576,743,1567,1715,2458,1567
181,2dde4d1e89b5c473ad4fbf1bb7def55ea658cd3c0c0e3089705d34a85bf595d8,adware,358079,1467,2970,2814,4281,2970
182,2e5d45ed626771b8202e08e547cdcb4361e537bc91b222fe7a1b54baffb8f24b,adware,469784,2050,3707,3897,5947,3707
183,2e607a28dabe2bdd75f1e68c89bc1b3caa46119280b870a4ae7874789f246323,adware,198432,814,1560,1665,2479,1560
184,2efdbbbcce1127b3ac5e54082f0f3c5bf3ae3d8e632cac28e5f4ea9594d6f3ca,adware,221888,818,1725,1732,2550,1725
185,3034818950ea3762a5af34751ec2793e4d0afe70af069536a9d0d4f26dbe4c6b,adware,198004,782,1577,1571,2353,1577
186,3084641735416eca6542a63b3b79d15869fb066a160f62ce1c95affbe0aff503,adware,235452,980,1804,1885,2865,1804
187,3084f9cdf78fbd396fbcc43301e783dfa11e55474f16e45d790cae0db1a6c702,adware,236348,943,1908,1847,2790,1908
188,30e4cd520c75b1d498ac8ff8c0f5649c45623371b3a89334bfd0d2fc51576cdf,adware,351614,1372,2729,2744,4116,2729
189,310ac927772b07f57e45d9090d7efd90f278760959982f8c04df38251a64c185,adware,216109,819,1746,1747,2566,1746
190,3183ecd8d6743aba098eb948329e275234c96d62f67aa434c873f2004f54a831,adware,236013,1018,1862,1902,2920,1862
191,322ee46163ec621c171840e39ec8f6489c601767d3b715add77ba02eb0219d87,adware,968868,3897,7540,7789,11686,7540
192,326b75d93c992f06f2ae9f9d549fc463218c48e59be708c61c8d864cb099a73c,adware,27406,97,217,226,323,217
193,32d79cb5eb3544660ac85f82c3f49a73c849f52a2b330fa3beb8cae1a8133995,adware,216604,796,1688,1795,2591,1688
194,3346d8e2924e0dbb3c14a4fab506b0585ad53682f5c3bf09d0679f1d91c6575d,adware,463185,1984,3568,3899,5883,3568
195,33936044267525019b24dbd180a4f951b120bb4e7038e0413875901c13bb4f10,adware,235017,1004,1879,1863,2867,1879
196,33b48a48136aa89c68473de81ca79e9fd740b1febc0787365249773d438d4b39,adware,221246,831,1806,1799,2630,1806
197,33bc5875afa77b5540244bfe3ffd53d3187ad7c27b715a498f923bb1996be7de,adware,217616,830,1708,1736,2566,1708
198,33ccd97905396b92b565703a513ca381b9f78fa46800b02e21ad5d4f5fbfef8b,adware,223274,885,1762,1814,2699,1762
199,33e3a8f22adb15287021dd7884fc0c073371ad65da917ef4e88c29d853536bb2,adware,221908,896,1697,1766,2662,1697
200,340c26dfda9821fe7b8937f6ef8224efc142d087b936c296f6e4e0243f488471,adware,737824,3032,5760,6075,9107,5760
201,340f94713dd3099bcc8ff47986bf7cc4fb52dc85255caaac219a39fbce9c1c95,adware,234484,917,1877,1923,2840,1877
202,3445257af5f8a603de6cab822f97d52a5cfaebcf65f36017b51463c6e4c45156,adware,534389,2169,4230,4231,6400,4230
203,34556a4e18d3ab5c809a0bfeb565c287455111c92a6757a5fde3cdbfde785590,adware,198314,796,1557,1601,2397,1557
204,34915b14bfac5272a7760b774a5fe507d492e10f91205905131871ac41a4fb4c,adware,205775,922,1583,1772,2694,1583
205,34b95200dd69337a3c0d441824418ed224bceb0e1e23c524a2db89917e725956,adware,220625,873,1787,1714,2587,1787
206,34c71203c9f6b7ec988b4bd38b48c6fed4e61a6ac73d2d516bbe878968dab6cc,adware,610398,2520,4952,4817,7337,4952
207,34e588f3d961a56183d00595d15cbb5f8b0c32be1ab589c1ed95b1dc3a54d56a,adware,655286,2766,5070,5431,8197,5070
208,3539edc11c8b857fc78f69afe4963bc3895a6d8b5b37ae39430629c50e9f286a,adware,235534,940,1869,1973,2913,1869
209,35408ebf0b53a609bf3a2ffcd04796c513583f3a2b58cb4cc490873afad2e2b3,adware,237081,993,1863,1851,2844,1863
210,361689bc6d30911e87285940702a36a688e748d9f3a1cd4744ccb721380726a1,adware,465490,1948,3589,3770,5718,3589
211,36223af4abfe19e3a10246163009521468c24a1a2f62f2a23c3fbf55d7ef97b9,adware,223462,861,1787,1828,2689,1787
212,3630c957be6761fbd5ebd83d760939b72054d417d363bba2391845f6adbe12e1,adware,234886,891,1801,1887,2778,1801
213,36850b99d61823cc24835c4adcdbf55bde7498f78fd03209341da13aea40f30b,adware,218741,839,1745,1738,2577,1745
214,374d75018faa523b0f09cf2f82a0e6f39c8c243be52a3c1341f56030f7799b8a,adware,235446,958,1819,1900,2858,1819
215,37a484b8bd8ec1cae668a53d6a76cc907e470d7a7c58cb65b63a7e298c737243,adware,221059,862,1839,1848,2710,1839
216,37bc29b5e8ac0148ca5ce49a5d0e10824448662e1c68a2bb6e50fc000ecb45d9,adware,198645,731,1585,1678,2409,1585
217,3808b22bf7611f4484bb5138bd3c5a82b1cb0ffaa00698e1a12740bc18e418d6,adware,220569,831,1800,1683,2514,1800
218,38092d06a47a43bb15c13cee61283513f1b6a9b29614899ba0d260ec72f9b4b0,adware,335740,1401,2616,2694,4095,2616
219,382708369d182d23c3f3cf549e5cbead5e5e877789628cceaaf93895c1c5dea0,adware,198591,724,1560,1636,2360,1560
220,3851b8c4a58cac935a2da6f55315364edefdf66797f519f0fa4feac3c0a87649,adware,1038381,4388,8174,8504,12892,8174
221,38dedc1e9f67b0e001bf4f81a80894cb7cbd9f727fda3177ecda9c3429f3bfbc,adware,198980,765,1685,1577,2342,1685
222,38f56e39887a83e5e3750e3bd907e98a07286bf2a606e331033e3d256499709e,adware,198142,754,1574,1615,2369,1574
223,396b7fbbc3e80a9a2a6d20b142f3ac3873df5e43d16debb95e496ad7d784afd2,adware,198418,863,1481,1619,2482,1481
224,398550a7b32b0e6a2f8d249a424644a6b5d7cca2cb9b8c8d73afa48eccba6824,adware,236740,996,1909,1996,2992,1909
225,3a0159f4787064859aa67cbfbf9b144f1ba387f5f98671b786d6cda57da7fd2c,adware,232886,958,1768,1958,2916,1768
226,3a5515798911e1d7936e8ad3b78793a6470f79f70efbb191312c51ec10069bab,adware,310541,1310,2410,2459,3769,2410
227,3ac0e899bda463256c3fdab5c6ef36c250c30f089e6a2402fd2081766075c41e,adware,221461,893,1837,1793,2686,1837
228,3ac8a197d9ba1340f8a5a1dae35bf86815561868c7c2a18e8b0ae5f480a2a2df,adware,317185,1362,2513,2615,3977,2513
229,3ad0e3778cb4b6e6d6234b0ccb35789c18f79a35619fffe2af4ad57d85b39113,adware,220756,837,1760,1865,2702,1760
230,3ad6017e4e1ad4bec81d2715ade730bea1325c649a68b051e26ffbb87afff3a5,adware,206828,824,1686,1727,2551,1686
231,3ad70f961b0525fd8e04f7bac1b0e4097d4dc974971047b2d3d20b8f7d54b865,adware,233276,860,1889,1869,2729,1889
232,3ad9387cae0733e3c386606a88c2428a7050d80aeed373d0950f5342ffa57f3a,adware,234731,984,1802,2040,3024,1802
233,3b004ea39ddb084106358747e40ca38268d7b598567a4b6dfde42ec39c6f864a,adware,243449,984,1911,1866,2850,1911
234,3b1d6ab12300b7cda68e39a4aea7d50a2fadda3f5794d0dcefa3b5593c05cbb9,adware,235673,948,1835,1888,2836,1835
235,3b439ee43dbf9a5017f56dab7f0277ef5c9189ce0df0386b777608f2ecb0dbbf,adware,27409,99,225,258,357,225
236,3b9a385ef7a388a68b170cbe1b042766fed67c6882715d3bb9dd317f341cc1f8,adware,367606,1481,2933,2921,4402,2933
237,3bdbb71f9763cec6321ab3fa9c90fb0d33436af51dbc86a2cf5692a70cc273ab,adware,237160,996,1856,1931,2927,1856
238,3c0e0fb574f850cd52e37fa5d24d150d3095a171235b095924cd50308ddda7c3,adware,236184,1063,1900,1952,3015,1900
239,3c119f41d16a023bdff6768c27702b9ba7a06f5d717f8eaafa153dc4ad398723,adware,233506,980,1787,1884,2864,1787
240,3c1f43f9a1338ed539a020b1dd60104180064b65bc8741dd7eba8468d723420c,adware,193009,810,1531,1628,2438,1531
241,3c3eeb83422186a5161a13e95a08ea1552ebcbf7ebc535b8ab7cb704eb744010,adware,221966,858,1700,1849,2707,1700
242,3c719b8a5f2735ac1a0357bdfede58c760523c79f85023e2b9fdcbe86df8c376,adware,840392,3512,6655,6782,10294,6655
243,3cdedf66afcc31e3e23bd090049018255b35a08293d4f97221d807b59fb28c89,adware,336283,1340,2686,2693,4033,2686
244,3cfd06331947727f18398ddf393e4a88c42fa55bb9e3a00bc50be9793d7865d1,adware,198755,781,1584,1660,2441,1584
245,3d7074aa0251f4db3498cbb339864b6fe4230d2eac6c15f93f48a941e8dd5181,adware,233040,917,1810,1956,2873,1810
246,3f03941948ecfb07faeed75347fe402424be7dc3bca54255dadff6ebca09fa9a,adware,234590,1017,1868,1967,2984,1868
247,3f6817e8ebf04d93d89d586a2bdc04fa205b908918dbae80edd48b7a13f8d272,adware,740495,3138,5677,5961,9099,5677
248,3f9c2aaf18950117fc3795633fb6db5db2feb5af619d3a3fcef6fa78c9e19da6,adware,198539,760,1572,1658,2418,1572
249,4002516753ee0af67023e01801ac9048fb03fbef00a87e4bb7d3db9bf9a99af9,adware,794545,3236,6336,6427,9663,6336
250,40750c33968c1f7f4092eabd8972fa30c010614d1514366f0522f11f2bda067e,adware,235722,976,1822,1911,2887,1822
251,408682e768e5551d064d5946e0892e77a0182a614517f37ec6fd4fcaee84a585,adware,309063,1309,2506,2592,3901,2506
252,40c3af04bcf674231c7489d79728594e70bc26f53b82a6240da1c54defd1837b,adware,732354,2851,5831,5844,8695,5831
253,418ff3679c2defa663c00fad1db414172612130b3a0daab9ec883de41dd6d507,adware,206505,824,1697,1703,2527,1697
254,41b0c74ef775e6a40d2fe0ced4a282697db1fd2fa7b9ed9b19663f7406364f85,adware,198388,805,1597,1667,2472,1597
255,41ea8c3a74e0776dc8db2915dc768e7394fa0e3b770b20b34832897c712f7893,adware,236827,1053,1867,1918,2971,1867
256,423c4309a7e9d9e59ca529cbe039c4dc24a3a1e262e1f9a60c334ecc639ced05,adware,616261,2798,4814,5135,7933,4814
257,42553871a722a75e2e13fc169449351a8ed4bc67d8402594b7f763df084497db,adware,236212,965,1824,1964,2929,1824
258,428f3230be61b969cff5f7f70a8e6ceef4026a2326e17671bf2888bc78d5cbb5,adware,388639,1591,3001,3036,4627,3001
259,4369504708a6dc9b12f09d038198daa3aecedb912b9b172d8f6f78ae04cb81de,adware,233629,974,1885,2022,2996,1885
260,437adc8b897f30bb71a44036146bf972d4734a667e684b504e8d0d2a4a3a3d77,adware,236466,1017,1837,1995,3012,1837
261,43929b37c2f0998f35d1ca827de3d47b406575d2883b40f3e0efc58702d103fe,adware,198297,750,1603,1697,2447,1603
262,439cb022bd1b8a965591f8cd7b2b3f56ebad552ac8a7815d512fbfecd63f24ad,adware,27406,117,225,219,336,225
263,43aec094b421ee6070a6a70bee7be55dfd49989ce65d192a6f52053b0270d5c9,adware,305015,1329,2479,2399,3728,2479
264,43b127f954d59411a73b3ef885f033ad0295a07cf6ecbd539788ffcfba0949a1,adware,566053,2462,4506,4710,7172,4506
265,43f2fe555c610e7271707575591c3b31c2792b7cf94ea36f869a3bc2314b30c7,adware,234003,984,1864,2039,3023,1864
266,4431b10d331cd1c32d7ef7fc5c196858c17c2335cd0ca07418be65b39262c500,adware,222993,885,1813,1784,2669,1813
267,44617bfb46b581ca1ac5c3c6ab2dd09b7d4fbb29e178f3578ca83b0f84d37aed,adware,306005,1314,2403,2463,3777,2403
268,447472077c8d37da49670d96c818382ebefbdf55d911b67d2942263aef327026,adware,235857,1019,1896,1947,2966,1896
269,448950e454f6092262ce2720c0305342d9942c9e2164d4c585de427d7bdc211b,adware,309481,1212,2470,2457,3669,2470
270,449a3c75ff47612ad236e4944006b010b1c0c7b901b2a4146f030befa4857ee5,adware,234071,942,1799,1912,2854,1799
271,4502b6ad32a94ce0d00af5aeb97e19ac5eed2f79ba9f4d73a338f1ed0b77b41c,adware,198661,745,1578,1619,2364,1578
272,4545b68c6af01f78c7dcf46fc2e29e74f0b9af8cbbce70c51622f4df6ee7d37d,adware,198307,772,1551,1570,2342,1551
273,45564200c3b5dacfe20ff7f627e8fbca6115b833628223c1dd94508b740b6cc8,adware,198131,778,1607,1573,2351,1607
274,46065dee1759e89da3f1bb0e2d9228da187ff34a841b7e4fb0f32ed826b5d4c2,adware,456607,1889,3634,3562,5451,3634
275,46271df1169504ef30645f618c4c6d30c5675fa69bc4cbda2efdce8c50b35d98,adware,235159,1005,1774,1950,2955,1774
276,46512be187c3772aa84bdfbb6030fbaeb881edeb3a58557745167bb63a141406,adware,232332,981,1777,1955,2936,1777
277,468da6e8cd0d6e104ffda12c4b3cd96e181bd2945f3a6771ff3baa952f48aad2,adware,198556,729,1529,1576,2305,1529
278,4704588081b7728e31d8398e69125f588c90f3e9321afd1d8dae289a7f8bc60e,adware,206550,847,1625,1672,2519,1625
279,4735279e9439d0a859936c9bb2e908c29a9a8624c8833710e87f117e10340911,adware,223653,866,1853,1852,2718,1853
280,473d141343282d0ac07545252ca8db12c0915579e3bc9c323ca1061bccecd6d8,adware,198593,741,1594,1679,2420,1594
281,474d9adf3dce9b69e933210b6dc9d7d6ff0e490e6bb156b8e0d10f736fb3944c,adware,235952,947,1829,1973,2920,1829
282,475cc1495a9733db2d14ab04b84f7f852e9dc68623f8330e45e1c90057a46bfc,adware,198478,779,1596,1646,2425,1596
283,486b113606ba9fbabb749a092655fa7bff01ed55b5cb18ff0299c5281036797d,adware,194869,738,1609,1506,2244,1609
284,489f2978cc73630ee930a98bfa8842789f2f14f3b7fe46fba3e1633ac1407d29,adware,206967,840,1705,1750,2590,1705
285,48a4c56af32cb05dccf796c0801fa7566efd3e90d5b352d36a1aa4146c05bbd4,adware,1192605,4837,9606,9405,14242,9606
286,48aee0baad09c10540d4621f8cb1449edfc29d43a1c6f5ba045e60ae1e9995ca,adware,198592,768,1598,1605,2373,1598
287,48d08572ae08106a65ddea4f9b870f1ee2f73cde618b2db6430937d5ac2a7d2e,adware,735802,3022,5868,5852,8874,5868
288,49709050249822422595070979c18410de2af06ae63c3e3a3f1ea63d8c97ef46,adware,971158,4021,7622,7696,11717,7622
289,49ee355faa474e6861bc83e718064298f55d4d247e940d919a97950d51df2605,adware,233914,961,1889,2061,3022,1889
290,4a3fe74ebb64043865b2e0305db773d4e961cc18d1d507c3b89d770f9ce19899,adware,193295,768,1521,1684,2452,1521
291,4a90517a111b1335f2510749af75c4cce9d873bf68d58a3654813b6d2171f18a,adware,232832,956,1839,1950,2906,1839
292,4a9e78dd3583191021bddf0ff03187571b44106c36dac6b5f93f864c3f2510d3,adware,234344,935,1877,2036,2971,1877
293,4ae8d5a87ed5069af5bed56483f58378f0a3aab176924919b86836dc05576a08,adware,653389,2949,5147,5303,8252,5147
294,4afeb30a998841d26501ca3efd97e01f8a3339aa2c9c9fb27b1b94db8ac1993f,adware,236376,1008,1940,1973,2981,1940
295,4b6e6a7fcd79646cd0df9c25909e9f06d50cc281071095d997d4864f56a4a0fd,adware,234787,984,1853,1893,2877,1853
296,4bace7a165d4155f5801690b76dd63cb09be3428111a755ff51378d30ed37664,adware,205771,850,1629,1803,2653,1629
297,4bc7e9e1420305aa92978709c3da86079a2b6e033675394c92c5d3e93ea5d793,adware,618822,2730,4913,5231,7961,4913
298,4bf92ef8314d274f9b67bede3a951ac1c69c1b159da084b9c8c5e1540e81a21f,adware,27401,99,203,217,316,203
299,4c118690be0504129bc72d0ab011df6fd600178d59a9a792762980830f9df2d1,adware,371909,1533,2948,3241,4774,2948
300,4c598edda9c4d2c393a40fe4558e54bad0796b4ec1b6d890378cc8de73cf935a,adware,799111,3280,6354,6442,9722,6354
301,4c6c47b9e06fd9d267e91760dbd6fe54c7cd6ef4de4616575956405e4f31c5bf,adware,198606,816,1549,1638,2454,1549
302,4c6cf75605686594efe56e4114a8f77d96c967326f8945b71fa02548c275552a,adware,469824,2080,3763,3776,5856,3763
303,4d43c7b13ac3f75a9fefc94f74d33ff1b34177fd2f4d65ec119a041f327b846f,adware,221167,843,1765,1723,2566,1765
304,4dab4347ea5b133357af9e110d4e88494e4431c1898b66efb8a222bedf0d416d,adware,220820,830,1782,1795,2625,1782
305,4dd7fd21e0b0cd9f95672736ddc719fe61f4ff24211d714929254e2d162671fc,adware,233838,945,1829,1954,2899,1829
306,4e10e34b67527811204c6729a650e4d0e0770f8be32a11d2f75f3f9592da97ee,adware,198681,768,1571,1571,2339,1571
307,4e207285fda11a6309830848760f09cf861f3e802f7adf16aba2c008ee741b31,adware,336846,1418,2741,2693,4111,2741
308,4e533de2e864bf08216f38cb21f8a5384f74156613d4ccad3cd37afc38f4be33,adware,234712,950,1815,1927,2877,1815
309,4e90f8e5249057a052920ff7d1fd794740d890b29d4561c612141eb012994604,adware,233733,940,1839,1944,2884,1839
310,4ecb1c9274e51f67d0398b678004b23ffa309f04ed5c5f4ee4a807bdb7bf8b00,adware,222724,855,1727,1774,2629,1727
311,4f217018c71659a52fbf512b8dd128a087affdcc4734f287e6ffae4c6e35aeac,adware,460826,1952,3618,3786,5738,3618
312,4fa06147b86264f26abd6f8fe567ad6307ea5e73ecd1f439db7915002117363f,adware,469120,1988,3677,3774,5762,3677
313,507eedcbed4a4f4e9e2da816ae975f86a994d1b667c824780b77ce71d75a98d4,adware,1185153,4737,9386,9538,14275,9386
314,5178200377243c973bd25b5e4dc7f31010676fb55064df9589424e7b9b2ebed6,adware,967067,4004,7350,7631,11635,7350
315,517c51e46731fce5d22c1313b627f1633c0551d794957eb11670ba0f55c76efa,adware,198493,724,1626,1508,2232,1626
316,51de4ebf9267c228de32cf99790bf099cce05cf9f979236b912f345aba0f65eb,adware,232864,929,1756,1887,2816,1756
317,51e9c866d9aa522ff133997338f3361482762c7d7006c173cc77f7907f3247a3,adware,469540,1997,3610,3861,5858,3610
318,51f963daf6d015ec7278bba77f97cdea3f48116ec8b21fedbbc71783d9645944,adware,506552,2125,3924,4207,6332,3924
319,5227d8e8ac7e72014cea1120d253f3a54e31c848ae50f247366ac56cba94c2a9,adware,1190527,4701,9424,9333,14034,9424
320,52845f3f96dc1cef7f74dd2852830193bdf2b225099d0756f8270970dee06b8a,adware,235190,967,1918,1901,2868,1918
321,53014a1777cd98756c01643c9f1f025676333ee691a1241b733ebe02ec3f9ff8,adware,737704,3076,5841,5966,9042,5841
322,5314953ec46cc7a78ed1de560293591c4736724c6c1b98f24a62f56777280e37,adware,198474,772,1664,1538,2310,1664
323,5315815900aa6fd0e45f9ebda60188b17cadb4d9116e71d5929492ba222087e2,adware,198863,738,1573,1721,2459,1573
324,53355e5bc8a7bde3a4161ce014169f22a177872f5f26a33988cc6b5eca1547d6,adware,233989,1052,1802,1941,2993,1802
325,5340ff51d1e73f6e2094ea2bcd9a449b07975fef464663df6028290445fe2f6c,adware,198313,730,1524,1677,2407,1524
326,5390ff7642009d52993095db18d060351e3bc0aa0ad950294913f00fb4c1b012,adware,223067,861,1890,1808,2669,1890
327,53a0cb479054f1026ae2ac0d40222f974612e928d0c35b034c8751ace865d2f2,adware,426506,1734,3337,3539,5273,3337
328,5456f64310de2c0be17fbdf3a6ad3adee9c5e6eaf4bf8b1277af9ea57021e30e,adware,233282,996,1800,1986,2982,1800
329,5496dfa70ee1afdd68be736d14736c3ea68bc554d545eb3ad48c1e28b0f24abb,adware,215901,861,1752,1719,2580,1752
330,54fe53a6e69c63201e5f935535e4cd81b303185f3a88be6d0df6ab3add0eb6b8,adware,630530,2556,4937,4928,7484,4937
331,55002a37b2d3ebfc834c52a470eae7c27b70bdb0c77c7f5c5333a67a3e12112a,adware,233552,971,1809,1905,2876,1809
332,5509217d3d81b2dfe0d3539d227a4a243bf8a69d4e1ba8f6d9556b7bb0073722,adware,736407,3044,5744,5934,8978,5744
333,5570d28129c99bc6e9c6195d2f8a4ef57c748473096964912c676cc967fa5086,adware,738006,3037,5919,5955,8992,5919
334,557b0fdbbba0c87474d6edc578681cd04073a0af5cdd1218e0ddce3b8dd737e2,adware,216685,851,1745,1696,2547,1745
335,5581e19ede90c465d72c88f92e5060bc19e29311a22b38c5fdf7358b8c50365e,adware,981267,3996,7687,7670,11666,7687
336,5598fde0cf7461c30aed5cd410e1930820308ac2d1d46ecf6481671243ce9799,adware,198800,852,1570,1683,2535,1570
337,56112f8d3cd85f621570e20f4860c73a8e6ccd069f4d1b5dd2c149033ccc8ae5,adware,219665,891,1757,1605,2496,1757
338,5616766b3f2abcbabe92969a3f30e407667d296cd64106bfb1781202adfd2dd9,adware,528580,2237,4316,4299,6536,4316
339,5674fc110b9013e18846cbc1a23bd5d0c9ab9535c084227e5fcb5ca36eb8ccd1,adware,198506,739,1517,1753,2492,1517
340,56c9a77958165ac3e34042b1ff85069d92f361fdcd0753f9e892796b764b5cfe,adware,207502,869,1629,1688,2557,1629
341,56f8e974852799a9c6e05d03a56e5c3b071f2e288a46f70de29f497fb9720a1f,adware,198650,762,1625,1662,2424,1625
342,5707d44190cf72718cd14ab4801b0bbb48b4517ace9ecb6e653565b2c42b79aa,adware,220880,846,1815,1816,2662,1815
343,570bef685e5bdd98e71869df46e91f1b14149e4629b719558c3203aca1ad1c99,adware,220033,844,1742,1830,2674,1742
344,57513e29dba8e62a92570ce36f8334ef20ff8a427a8558be1f0d4e5f4e9b4867,adware,223355,855,1739,1837,2692,1739
345,578169aa5313c12f63ab25898c7aaeac1bbeb774dc78fa431c009dc56c604213,adware,198388,794,1530,1561,2355,1530
346,5799ab64ac07174a865a96eda73c6d04d54bc5a64238f23d67582f17bda3db46,adware,232120,902,1836,1864,2766,1836
347,57caf93fc0107f9a171716d8afe76f10956e6a8bcd36377bb150e7318fae4c48,adware,465854,2019,3809,3754,5773,3809
348,57eb5ea3c788c82d46a50ef88a851ce6eaa4c876c7fff25784de6a7232012f85,adware,419581,1802,3337,3391,5193,3337
349,57fa58e7741e9399cd3559d3d18df588dc42a1b4ef153ef9c3f7ff25ee8000d7,adware,217443,842,1716,1683,2525,1716
350,5814876fd7f9cdbae41fdc6a54b67de3e285b03bea44c1953677af7b062a984e,adware,484323,1972,3868,3844,5816,3868
351,582bcf0010c3083a36515e602491da092fa396f95b065f735a387bb208156442,adware,222695,832,1780,1751,2583,1780
352,585f7b7a604f99bce0607d54b353630fe430292f56a5c6fa6c6972cb1e409934,adware,236029,1042,1929,1950,2992,1929
353,58b71112e9231d9ee8f33684b55f22bf97bd06b83e763782de1776caca29dd79,adware,221207,890,1678,1782,2672,1678
354,58f21ed4f6e1e2688db8ef0823869582338fbe416d1d0ef9e4da00d0ea996f59,adware,293236,1256,2351,2368,3624,2351
355,5919b5ed5364a39784e79a69679ed46e6cd697490d6e204268c601c746c87d5c,adware,215755,833,1710,1747,2580,1710
356,591b7ca6fe0060db27cfb95e65c7e6ab673d019ffb661e8f807fc84efb81a2a4,adware,232470,941,1923,1931,2872,1923
357,595d4473ead8f624fe0cb7f1f76613e46483b1cf8e64e8bcd57cec36b692aa92,adware,316767,1296,2542,2685,3981,2542
358,596050b0d0b523aa2e908a735e7f1da4d5a55bb7f8a9bfb3197ecf34e5629ccb,adware,231657,974,1829,1931,2905,1829
359,598cb383846cd05ea6dd9637016fcad5be351d47ab454148caa175433d25639e,adware,198525,774,1593,1614,2388,1593
360,59d2b2ac77a4acef6e20d6df80a816151d71554a1a8ca269c78cc3cf90524787,adware,27358,103,225,215,318,225
361,59d65141c877ec84be4d399706558e42cb128901cdd344b74ad4a75a1a8fa1bb,adware,192892,795,1512,1693,2488,1512
362,5a518479d72465629e87e7cd942bdd374ec063f8f1c28a8b5b5ec88a58d10d07,adware,235267,892,1883,1985,2877,1883
363,5a771b5948e5f2160b133168cb17c1747886302f69c4032e50bf9541dd517d1f,adware,632174,2485,5088,5154,7639,5088
364,5a8ab62dd131f822e40f1482a527725508b60a1a10a9abf3a58763be3154163e,adware,27454,98,246,212,310,246
365,5aadd0ffaf4a0433e99bf971c7d15f0889328b2abc7ea98e87b35b3a1e4624fd,adware,222241,857,1797,1833,2690,1797
366,5adf00880c4553cd38f3f64b21c72d301652d1225d29e04b0decac14faa39a99,adware,198562,829,1562,1648,2477,1562
367,5b0a1d88bd94bc15a5194ce1cd70711bff3df266f60a61048452cc831fcf3203,adware,194920,772,1586,1548,2320,1586
368,5b5106adfbc337b695f31d152bc1aae0a7f21784898a6c6591ce660977a5122c,adware,346229,1381,2654,2831,4212,2654
369,5baaa3b398880995dfb1691b6d6dc270c100b2c4c09ea6b3b51006b781302d1e,adware,198782,823,1556,1678,2501,1556
370,5bac11a7e6e1e0a5f01549d9f13214f0a5cec4079dcc6ebbfe95228fbfe51257,adware,198697,745,1499,1608,2353,1499
371,5bb561ef737e4440b8f5ecea45797741a212d604cceb115a2fee7b7c9826e3e1,adware,968948,3847,7514,7595,11442,7514
372,5bdf1f15731efaebe09d3717fc1baddaf944e9472271738d5c059820af1d13ba,adware,223564,874,1743,1812,2686,1743
373,5c44494f0996f6c7673bb9438f445e9a512b3e9ccf30eb71151654b888bf9c99,adware,466721,1870,3727,3793,5663,3727
374,5c7a3d804ed92026903ce199278d3aae6b220242e4a9a4ad3453a17e522b0b3a,adware,215705,812,1722,1677,2489,1722
375,5d0da20156f777e3ca2f0346deb7be40a3aa03cd07a513accc8505011b6663ff,adware,469663,2027,3601,3786,5813,3601
376,5d95d50d0d596ce82ae4c1ef63cb460dd4b1ebc5dad0e21f702babff2fbe29e4,adware,198373,772,1586,1699,2471,1586
377,5d980ce0ea5149eb0d996f78818636c605e8ba6bc2bb2b125db853b1339c6d9d,adware,469907,2045,3720,3804,5849,3720
378,5dc27e24a8a0eff0db65192ab159fd4ae94358bd0802c93d02bcaa8541bb6a95,adware,198052,805,1592,1618,2423,1592
379,5de5d46d8ac96d5be1765dd6176393c5d44fa4cb98a8a28c341dff27cd3be60b,adware,236010,997,1934,1922,2919,1934
380,5e27548e2a576ba13773cf498d19c3b2058ce135ebced68faef5ba411c3321b7,adware,1183972,4655,9394,9313,13968,9394
381,5e4eaa8b246d699e0cb05fd6a9698af06220478dc0d367dfe572b60d28c97a2c,adware,316551,1424,2476,2465,3889,2476
382,5f1db975681138b95120828c7e610e8fde13cae17df8cc0af605d039716e04c6,adware,198601,763,1561,1661,2424,1561
383,5f3ebcd372d39ed7fe1c08d305e8fddeb0eafd0ff0a8a5a3c7b931080e62552c,adware,618165,2788,4842,5222,8010,4842
384,5ff894b19ed520e4e79db127f9e562ee062487c2b18048812582375f24d64568,adware,198603,794,1583,1657,2451,1583
385,60511289efc68f39f35993f9637bf75a9b11e03a366defbca967152ed89a794b,adware,234371,888,1897,2010,2898,1897
386,60741e0c517b5e9b82df6199015214d169e6d3a110cec8d76b054c97df1aee7e,adware,234451,1017,1933,1934,2951,1933
387,6102f5eef22748f069bccc19c11913b9fc1ad7a3ec7d10375a1cd8d75bee6fef,adware,466748,1893,3620,3745,5638,3620
388,615553654482dfaa1f383d8b1a9a1bd6ae3674a19b87c400dc3972424862adc0,adware,236326,990,1846,1883,2873,1846
389,61a94b08f9dec0d3463c31761d98f64c1e2af09584ef91bf86e3ef8d2218ff47,adware,234095,989,1861,2031,3020,1861
390,61c77f5b755e570dffb5163d5723afd7127af1b814019ab2409a0d586a25b982,adware,533454,2281,4368,4294,6575,4368
391,61c9fd382000e2f2a386684f3fa17d5425c54f2c2fffb1c8433f17354f2e6d14,adware,216099,808,1734,1732,2540,1734
392,624b3f2fee705d8610151087fb4e4cebd1083cb468c890b213ad57cf9f63ee50,adware,205001,933,1559,1768,2701,1559
393,6259a46c51563782bd378f8976dec01f7c21f1ed9092e02c71211ce1ad3bdf3e,adware,221285,858,1722,1735,2593,1722
394,631983bcb3b2d09c9bf54076400fcbc651a67e921c8518596dc27470eb1ef305,adware,206931,820,1628,1798,2618,1628
395,634bbf97c155ae1b5502f094cf4bb16d4393772dd1d8e264543cc662a8a1cae9,adware,377866,1598,3044,3174,4772,3044
396,6374bb5eeea2525d02671ca600bf12bd34c2c46e8e317706fc723b6ac399a406,adware,454400,1792,3501,3749,5541,3501
397,638856a445db7e7dce5eebfb987505dd929ca23e059195681a408a5a576d58ae,adware,194456,720,1571,1534,2254,1571
398,63aa029fafc276d7761ca9a40d25b399e7bd20391a240b413bd7e2756633c0c3,adware,194324,765,1565,1531,2296,1565
399,63e64e5cd8d887e644f278d2f5db06530e5f8ad01b22342c3bdb7833aa5ac10c,adware,219235,891,1668,1710,2601,1668
400,6408cbf94bfb25d7d1b78c3984524a1ba7bf426cfcdc7745b49cf1d24791b05b,adware,223403,864,1739,1874,2738,1739
401,6508da8f4ea3dcda427172f1dac263ac6e8eb776eefe4d63a8c8bf6972cae4be,adware,236250,991,1817,1985,2976,1817
402,65158c9ab753d0465cb7aa507026a72df2f6bb85d0f7a4f11c1031f87d5eac4b,adware,216515,874,1681,1781,2655,1681
403,657e59316744c19d88e553ae52e86bfb0545f114cc5bb29cfb274095afb4bbef,adware,234178,981,1855,1855,2836,1855
404,65e37d3103eef86cec072e08ca6018abf082ac82c3c71967ccdcd487056fc4bc,adware,235114,943,1793,2014,2957,1793
405,665182be3868137d5cd9dde65372e8d2db241716255fc61b0cf1e2467da7bf0e,adware,233474,924,1883,1966,2890,1883
406,66734740a80190fe31706e39548199cf8b395e6d6a01697cdae10f441bb8902c,adware,205441,887,1667,1705,2592,1667
407,66bccf5fb157903a5b5c001183d3e54b1072808c12536f326f520b924eb2dfe8,adware,198590,798,1649,1607,2405,1649
408,66d922d8f834e9d4135710b27856b003e74a32482fc104fc1fae7f6ddd8c50a9,adware,612248,2595,4900,5068,7663,4900
409,66e14d55297d6a991f653b19b2b8533c9cab5269d425860795347843c0ed78fe,adware,792793,3306,6234,6300,9606,6234
410,66eac9d74b326bb7354d898fc936eee9c6d4fbefc9b3bd2713d73fc1dbb14d4d,adware,198685,771,1533,1550,2321,1533
411,66f4c1dbd28d4b9ccb3f205813c40b8442a8486e1c02f3e5f36fa54aa896a2db,adware,216785,897,1761,1669,2566,1761
412,675a49642f3055640e54b71f4bf41a26b7a83943f147f02828df8e2a3ce73773,adware,198764,784,1545,1661,2445,1545
413,6762471f2dec36c3af2401024ab06711c5b575dbbf0cda8feb6fa9e95f8ece0a,adware,235165,947,1872,1954,2901,1872
414,67932078b4f54fab3dc0fd99d7a202a08a2bd7225e31d3996763fc5841acfd8c,adware,223200,851,1750,1825,2676,1750
415,6868d85cda7a9ff9892d832bf44acab3175a6ee11381f4e54823035be35b049d,adware,198333,810,1578,1657,2467,1578
416,687ab7ac88cbf542da2f9ced6673bfff0ee065067a65feeef6a3eb9de8da47c8,adware,216238,860,1732,1693,2553,1732
417,68d74a9c04191d3e83ab5d22ae42f568a4ac86aa6ef87e5e8c99224fdd7bd2c9,adware,235658,1045,1830,1965,3010,1830
418,68ea619a906e385a777aef91e735c454cffa97beaf8a7cf4b29e2c43ee9d8d0c,adware,452154,1984,3535,3663,5647,3535
419,6900872745452082bb3a657ae0bcc385fda9cd428a207711aba62e071bc832e2,adware,233950,980,1865,1920,2900,1865
420,69549afb3412a6565a17925b6aa5e9b860d8b3e618d3c567d96fd8d8be43dc44,adware,222528,867,1783,1789,2656,1783
421,69a637793286368a894b384d0df66159b27c13562e5613aa16ec0263c0102930,adware,223767,866,1754,1778,2644,1754
422,69af0f5d14a67354fcec529113937e4f9ffa7b16d054a3a43b6dd931e89ac8ea,adware,546432,2135,4279,4355,6490,4279
423,69cbdf1cec8959080c8e0458b1e6ad7dccb1fdee9490c8983b5860d6eba50d9e,adware,206607,776,1628,1698,2474,1628
424,69f90dbdd693f578d463e3f0e6303207aa112e429b9a519fe79e9a64c14cc22f,adware,207635,808,1680,1726,2534,1680
425,6a1df88dd4169a7c6dc9685c69e8773e1cca0ce7db7180db4bf7bff2787dc6e0,adware,1023904,4148,8124,8217,12365,8124
426,6a2e61f24339c5d2fc4abcabec05385cc5ee1b77ff6fd5a5e21987a429009aba,adware,224066,793,1796,1801,2594,1796
427,6a392b8b3083b1c4ccb1a57a7c4a5263031e26fb82ed8ff16b747948549d3b51,adware,198016,795,1567,1611,2406,1567
428,6a6253fe98444026df984175737aa5478d591b132a8741ad359ad608ef4048da,adware,235131,936,1890,1895,2831,1890
429,6a7791e9b3ec9e4c61d95fa187f3f1745b85682aea11845d52b9bf040954ff8b,adware,1189715,4782,9272,9257,14039,9272
430,6aba4b0e9c12cced03cd9ae5853b5535dd857e17c2fbaf468c8d6cc00bdf1559,adware,222056,888,1701,1825,2713,1701
431,6ad1924f81d80f093d50a6e26abfddd541f3a6c287142bbe91d81105c7aa9e65,adware,198172,792,1571,1692,2484,1571
432,6ad35c720937b6f30b13e44fc4b2b9014e4fe68d05471c0d4f10a5e17f19f98f,adware,235512,963,1814,1938,2901,1814
433,6adfaa3e7ccbbd3b07cf96e34042073c7dbb9154dbe025600a53333782756aa8,adware,194187,727,1686,1555,2282,1686
434,6ae0ac66da4d84bcc38febf275fd62283fab23bcd966951b9066bf59fb37eeeb,adware,227022,871,1765,1802,2673,1765
435,6af3a341cb3801f832f07170d73ac1d48d824a9ccf8cdb5a752893e74b57423e,adware,220061,850,1744,1732,2582,1744
436,6b007bc2abf7df32f2a477a630b7a26cbec375a8b312c25ce0fdd070021caa8c,adware,216509,833,1715,1686,2519,1715
437,6b7133435584a18ae392cdb2ebed1c9eebe4011c33103c8ed6dc49bb9bd57208,adware,232932,937,1868,1880,2817,1868
438,6ba3b45733238081b9900d97fbdd4f1d75b16ed47cc4729aa87cb3fe8cdae828,adware,233775,936,1816,1883,2819,1816
439,6becc7e43e060749e797897f1d1735f9ebe276a7b340b14dd249b4d99d6d256f,adware,233667,942,1861,2000,2942,1861
440,6c274a6b03f816945faa1b7b7532a1d972e936f715ae84b073d3a2e86bdd2327,adware,978829,3738,7698,8028,11766,7698
441,6c2ed5e29cade9c336478dc69c909676f93e59127bee2bfc8eca5c15b40cae67,adware,215673,855,1680,1672,2527,1680
442,6c66d6cf65ac0fa312f844dbd364bbd801d6f533b9b88fdd84323a9a2fc082c8,adware,236577,1012,1940,1927,2939,1940
443,6c6adfa29a9e8becfd15643bdba70bf2dfdb01cd5958a8f6a39d868c773b151f,adware,364373,1567,2867,3002,4569,2867
444,6c6f7225017baa5644277f80fe92192d39251a5df8e24d3cb46fef00cf0f1dea,adware,223345,824,1729,1747,2571,1729
445,6cbf8d5807d2afcdf492b634d28f68b76f37a98554d3d33d3594e1c1c046b128,adware,193013,795,1446,1629,2424,1446
446,6ce022ef3d29390cae658628349d31f69cb7159f2bc5906524b1bd593f6c883f,adware,357481,1561,2812,3031,4592,2812
447,6cf0e12bec68a9746c54e26854ce9b0ce1eb817e2ae8e07e4c382f645c19df28,adware,235015,941,1772,1877,2818,1772
448,6d04d27924fdafedad5989679cc20515066cfc9028ad3389a5ae74c3cebf8f79,adware,651834,2842,5109,5512,8354,5109
449,6d2a986bcd78ff23c0b7a1e0eb324155025e8970f8fedbea3f7efa3227d986fb,adware,222457,843,1777,1825,2668,1777
450,6d46868127700f03cd7c3b34f7fdb9f1dd44c614fc1cd34cdc83a99261293446,adware,206168,869,1625,1686,2555,1625
451,6d691f638f31fc3b75aa92f687cdbc9fab6567441b5a512600000bd1283dd014,adware,198566,796,1644,1626,2422,1644
452,6dad069652a6918219ec5f814386d9682614321c14fcff9c1cd731954387f180,adware,224142,891,1744,1878,2769,1744
453,6dbb062763ad9635834a18d2980361ca012b03a82794c5551e307a6ef72aa48e,adware,230616,929,1803,1891,2820,1803
454,6df3a70cce8a55b5c96980c995cbaaede97fb6e2eff065e797b424aa88413b20,adware,208679,820,1631,1722,2542,1631
455,6e4c6175ff79b9568d04eaae87de7bb8b45e9eec8b8f20b6308240a0950beed0,adware,236544,980,1834,1819,2799,1834
456,6e6e158dcc893c984ce86aeaa74f11a3ca80ae507c125370530ea47716ace166,adware,208369,838,1744,1727,2565,1744
457,6e8018134e7e978b27be0f128b459a538308d941a9131a99154d436374decdac,adware,221300,870,1807,1794,2664,1807
458,6e902b0c0ae82211cce5a8854f8ff91b7235958b48d586c3359d59834a721818,adware,235355,952,1848,1924,2876,1848
459,6f0ff3f637a886ee19a68189d4c2a64b032ac0710d875e01dbba298ea762b7cb,adware,233310,906,1810,2002,2908,1810
460,6f2112f22be0d48188a78c6edaee35ac2395145a6f46584ed26f9694308fb062,adware,416347,1754,3314,3249,5003,3314
461,6f3065c35fd6fcbd948ca1bd5e5241cea6091a051584e0d70e020585871d12f3,adware,233623,972,1884,1944,2916,1884
462,6f939d5782436401b9d282a7b3107bbb8fe9341d4e35ace12da39de02e900fdd,adware,195346,796,1543,1573,2369,1543
463,6fdec075b057418d2ad25468b641d044862b948d1b23675ffc3d35cb44712d7d,adware,635663,2644,5079,5132,7776,5079
464,70a004efe1e10a73a7b15f4728e58cbd418090b0f837f48c1f356a9789514b6e,adware,224251,849,1828,1815,2664,1828
465,7174633024b9eaff8b13ca83f37569dfe95637e805fb333807bac82a583faa5b,adware,235812,978,1757,1912,2890,1757
466,7176a27845e1534cdedc90d181239ce220fac319c84f3a01431a04003d6e4db1,adware,206448,820,1615,1676,2496,1615
467,7185377a1b26669db25f6e3f83a83854dfd695901c30fa791771ebe8a6d82aab,adware,195319,765,1579,1619,2384,1579
468,71a8b3584b3db5d21d1884bf6d4606ec6c9c2e16d58817f00220680f6167698c,adware,419527,1665,3350,3448,5113,3350
469,71fcd0b37c355fe09e5763ebafdb5c02b0c41e1abdace5ba143f8e79115da0ae,adware,25912,81,220,234,315,220
470,72ac4b04b61091924f5d54ceaab765a00ceb21a72dbaaf0a359b775cd9bdba03,adware,236079,982,1794,1899,2881,1794
471,72de1b94a4b3916f07a0ee4a089a57c0c8dc252da1eb9df59951984cb701465e,adware,971176,3883,7702,7639,11522,7702
472,72ef05634d4cc7dcf6fd38c6f5f6e756f5c7e349099419d3ffbe1765308a7cdd,adware,235310,897,1910,1855,2752,1910
473,73532813d34add95f5feca6797ef29c14c64b7c2be07b8f86e54261d44dd48c8,adware,221292,877,1843,1780,2657,1843
474,737a2f63629ba7e690a29192f4f8141154c4c9435c5ef23048bcb1377ae3d8fc,adware,234826,1027,1911,1987,3014,1911
475,739a22c2c1c6229947733fbbc2fac4fd65f699fe0c03b203c3a4c4e3461fe5e1,adware,733826,3112,5754,5917,9029,5754
476,73bef72201237d811aed532120c5633ddd7d5d98ba86ca9d0524c5f19c336384,adware,234146,983,1843,1999,2982,1843
477,73f0ae1cf0d69ba0a2bfb7d582964a048ea2b31ae174847aa17d5b942da1055a,adware,205938,826,1726,1568,2394,1726
478,7427bc157b1bfdf375b5d75a7509f524582bd4f8a5aa9534840a2a5223e7e28e,adware,612905,2500,4863,5051,7551,4863
479,747c465698fb8141f3956a5db1052175344a515b31b37ce4f05529dc653a9173,adware,198519,775,1591,1637,2412,1591
480,74cdb63111c3778e219acc6cba712694d1465202ae5eb634645700e802eb164c,adware,236020,958,1841,1858,2816,1841
481,74e0f04eb1739d757e49f8bb2f242411aef0cbfefe36206bc6ffc110662ee1f1,adware,737653,2886,5989,5734,8620,5989
482,75135a36a9efa0e08a6f1e4086f201c8e1a484c998a2ca9c6dbac06e70717d89,adware,973634,3859,7784,7825,11684,7784
483,7518d155724567a2e246e485d450c3c0432aa97ec13b222a4b8c27ca0de92123,adware,222348,906,1697,1794,2700,1697
484,7535afc5b16ec05b57c0f9a7d48e6cdd050af3d4e64ca26c6335e9435076c098,adware,235075,1010,1794,1904,2914,1794
485,75520344df190266beded12ef7e3f067f49474eb27a38a9d4b95f379f6aa8bcf,adware,216152,883,1733,1743,2626,1733
486,7585cb9ff19cfdf605dcc4428884447b02140b36451c2a19e5e8056a6324d3ec,adware,193093,764,1569,1633,2397,1569
487,75c06fcf200db2d601fb32307047a8bb4396dd0ad79fbf62697402f689da56ab,adware,399206,1561,3220,3216,4777,3220
488,75c9a888f85228f6dfb90b509c1eaca9fcff040ea2cd41fe2dc2cff9d4346515,adware,965286,3805,7498,7737,11542,7498
489,75ebe04821a1196e76fb7cd2f521f9b2c8854cd27721cf992ef253c09d85c34e,adware,232576,902,1856,1940,2842,1856
490,760745dac731bd1983bbc96a1174c84a13655788d435c69fb2baa4587d1445d4,adware,234209,1008,1768,1976,2984,1768
491,76251e7b1ed655d560cb9d3e0792dc9eb05fceee99d66d049e3b99f5751f53d0,adware,222325,829,1780,1767,2596,1780
492,76ba2e33b54b441cb129fbd13e55fa2c145a3046c01a5ef7dbf4cc05fce9919a,adware,637420,2687,4978,4950,7637,4978
493,76cb6c1379a77b725bca933fd49b0b6af44d5033742d67cd251ab3e58a1da907,adware,974248,3925,7668,7561,11486,7668
494,77a89044dc3b928861abba573a9d16f58760b044d842264656aabef091a8dcee,adware,1193114,4613,9459,9571,14184,9459
495,77afb421f0ccf741d75bc36feb0881e749accf9dd24239754bee3b2bfb5d68c9,adware,633069,2649,4926,5135,7784,4926
496,77ba7c6e90ec751cd7c04436b54622112c992b5f323a71ce18e2374f9fc5dad7,adware,474589,1901,3736,3827,5728,3736
497,77fe4aab9a76c6110370bb72f17e2a96bc455ff1a73b2b3516293dfffba8cba1,adware,652458,2552,5191,5101,7653,5191
498,780e4c7c9739d6cec41f7b6450a800cf586f104ea84f76afeb93b2a9e992a7c6,adware,547804,2336,4346,4525,6861,4346
499,782890b84ac1e8daf4ecec513c9f3c0eca5c102bce2f3605f59ff55b6d5d849a,adware,198500,781,1605,1629,2410,1605
500,788e3ef025a171ac8467ee414b4c6331057226cbd62fbc7ea7987e81469bcf15,adware,235616,991,1814,1940,2931,1814
501,78ad5416daae1992e5160d10580aaf3ffd685d1a2fb63e5279194edd021d1ca9,adware,221114,846,1792,1774,2620,1792
502,78e979fc5ce12a1b23d09f33c5da4d5d4c452d2e68d8d860fa03e6a71ef4a0e0,adware,220140,875,1775,1832,2707,1775
503,78ef946370fbc3465d0a69118b1f9075b297c875a4007c6db5b837d954d3e129,adware,789029,3120,6240,6177,9297,6240
504,7917c487a34f66c83ff340750b6aef1dc53ebd7d0ca175e12464481f5e573349,adware,458005,1895,3665,3724,5619,3665
505,793f0db45a72e264f47ed4564ca9b7e71f16a944409104d3898bfd0f53485c43,adware,198721,779,1624,1625,2404,1624
506,7951de2351d9f2c684e5dcb398a7a9917f7622da9a5bdaaf79684427525f4593,adware,198508,780,1558,1647,2427,1558
507,7964c4fd4f297a02a0227833abd9c4d1a88c6b8824029401584bccac1619d5a2,adware,198873,804,1621,1645,2449,1621
508,796dbd609810d9c6521c11536f5a9a621a3de463b4f287d467c6275603799307,adware,221971,883,1705,1792,2675,1705
509,79718d841372c9ac95e4bb8dd73b9fefdc2cac1dc8654fc522ca663831a0ec47,adware,499987,2100,3879,3972,6072,3879
510,799529faedceef09b809cdbd6c96da514b15e2fa812b5b30f8a7fe69ad415995,adware,236090,979,1842,1886,2865,1842
511,79e66eb4aa12806ad67bec2a753bb8b631cb926c1e0a47fd1458cfd74c3d28d8,adware,233083,932,1886,1912,2844,1886
512,79e9c1830c7ac15bbd2795c2a0a70d14848e56d2f818802a980c654aba171968,adware,793602,3321,6264,6268,9589,6264
513,79fc43de2857fa48d46262dc8e2b4e467504f915665626057edd0a52377a9270,adware,222444,846,1784,1812,2658,1784
514,7a688c6ca0e73153219ef14d0c29079f596fd33b24ecc4283e91d59e043668f7,adware,198702,788,1524,1634,2422,1524
515,7af310c53aa66d8e77b0ce4889e14a8bcc0c540e2ee70f494bc98a344dd29646,adware,633601,2729,5076,4946,7675,5076
516,7c403862ec6da21201522931802e17060c99f539d28d640838e158dd12a0ea94,adware,195081,825,1528,1605,2430,1528
517,7cdcb4327c75f30d9ffcc276ad029455cfbecbb5ea81c4559ee45d084fef8fc4,adware,233637,969,1834,1902,2871,1834
518,7cf60fda13f32fb8a8f995cf26efb0f69c1d0625592d9616d16587dd2293f058,adware,234240,941,1825,2010,2951,1825
519,7cf70316034b79ba1cba92479e13ecadb98ebd8f7a3abd0a49a94dc18c9c929c,adware,974716,4044,7808,7660,11704,7808
520,7d08e364e7ff377e13ab53c7e1c206a419779cb1c95c21c2267a8dc46d0a4dbb,adware,222311,924,1760,1858,2782,1760
521,7d50921dac1bd433d8ca356c9f21b309199d4e05f716b6188c68ad78ba8fad2f,adware,207383,840,1658,1753,2593,1658
522,7db0724c9f241f5fbdedf57751c7e929cd9c32f798a0b3b6e40bd3ae639628a2,adware,588192,2569,4665,4864,7433,4665
523,7dd8f81dca579a9d2cbdd1e068074285fa06810e561a7666278f954c98830d41,adware,235042,998,1806,1967,2965,1806
524,7e2ca7d130a54da018498bf999845a6a184e6af39da2edf4cc0690716762f6b8,adware,969586,3895,7717,7775,11670,7717
525,7e49ab26bf079258d4a36c421586cbf1bae9199763e67ebcc347e9c41b9fa5d6,adware,236200,1005,1831,1986,2991,1831
526,7f659c7becb2bd185dcc7d4b3ab591851689c5de72fd4e8081e80ce152a34172,adware,192780,762,1587,1574,2336,1587
527,7f6f736328f34df919459f69b28640061b11eb3501decbd213d12b2f5e62305e,adware,198450,809,1621,1613,2422,1621
528,7fad55606dd4363f19f2246d2a6b8ee4e4ddb2060a89c13174ac1e876da4d271,adware,114149,498,923,942,1440,923
529,7fe80155bf3be53077be8842cd427c861e0bd3e4719e820fe31ab83e9eda02e8,adware,206327,824,1627,1601,2425,1627
530,8025965700f128c0e5f79ccb79e64f4bfc911afdd7c9f601f00afc543a2778e5,adware,234658,949,1755,1935,2884,1755
531,803e26d58ecd081f52be239faabaf1c93fcb8277f0a17971a6ede9a621377c30,adware,469767,1999,3638,3849,5848,3638
532,80bd8b54b2dd86cf000035db2c94b18725a54cc2877fa2ccba38546f8557c47d,adware,198337,742,1613,1657,2399,1613
533,80bd91a088f4f7788062b3188cd8f95f7a93632b402956088292895950264100,adware,1187791,4613,9394,9380,13993,9394
534,815ddf599876f776e785f5d8e1abc856eac409066a5214ea481a410849d9b29b,adware,198080,802,1684,1663,2465,1684
535,8179027b64b0fcf2086d1a5af60de63db00e9afaf9b2d21b3b2283172a8be668,adware,205885,836,1537,1696,2532,1537
536,81c22c9e8d9fa5918e19e5162ee4f4fc48825325cf360f4817f0c992652726c9,adware,236750,1006,1792,1953,2959,1792
537,82ea8decd0ca9e715f9472a686c6f81d69f57b3ec01e08006ad89db912d922e8,adware,220999,826,1770,1801,2627,1770
538,830f677a9204022d28312014cfcb613665b9005a082b9a3253dccc9f23e73430,adware,198263,803,1625,1580,2383,1625
539,83446820433a89d645accc090b14264b54b776ff4d7c52e5583468d174699ad9,adware,224512,865,1807,1839,2704,1807
540,8391fccb6c71e1de59e23e10cb75c91b101890a0f7326d9d21729be16063471a,adware,343981,1430,2693,2674,4104,2693
541,83eaa076e3b5112d2fbe66fe8971f93ceb50ac2ff93e579449b78d044498ce2b,adware,208086,858,1730,1694,2552,1730
542,83f79cd32c8a639d1c753951a08f708da65dcbcedc1793b953523c76b143304d,adware,731402,2980,5630,5997,8977,5630
543,84071ecc23b0b3a94bea35aa6342bf3c8bd50c7022e364d21e87bdcd5403ad90,adware,390018,1604,3075,3287,4891,3075
544,840fdf820b16f779fa716f20115078b553ba3da6918465b19c20843d065a8766,adware,205433,867,1726,1706,2573,1726
545,844c55f7861369cb46dfc5c60e0d3057bef0c4ce5b31bdbabc98a6d17f9d4f67,adware,1020652,4319,8045,8218,12537,8045
546,8460910d5042672e5d2569c923b692976590ae4a6e784678d8ad448090a56ea4,adware,221290,889,1752,1699,2588,1752
547,8492099e8ec1e38f38e2b037513360845832846ea2155d4baa5a9dcff0f7f017,adware,236208,1050,1875,1964,3014,1875
548,84bf5f706402507ed9b317a6fdb6b555b3af7f16d645954dd873fdc87a2fa578,adware,458936,1829,3641,3632,5461,3641
549,84dc8f36a464c324bbde8419dcc5996be2f58493ffabbfa3dfb5b31298c7e423,adware,234958,981,1802,1938,2919,1802
550,84e1eaa3552ad5fbbabd0f8fe2368ea2afee60feecfe4277ef25364f37072bd2,adware,27447,85,209,220,305,209
551,855132e20a05e7cd503e28c872377acab4db33485a649133cbb119480f0c3a96,adware,310923,1193,2484,2495,3688,2484
552,8595abfac21801b12f897bc61872a19495edc0d916bd88dd81818cf7324e2c88,adware,1191240,4755,9382,9728,14483,9382
553,861bef845491ea9ffb69c76ac2e0546461219a04d93781851c40bda69f1e0aa7,adware,220538,823,1707,1763,2586,1707
554,862d99dfa91549b469e49017a384d48410a137c4698f1aec6e73f5b3a288fa70,adware,594557,2501,4734,4744,7245,4734
555,8638f592d4602407428d1a2e55edcb97cea3aec00cbdcfa88edf1409c6a6c54d,adware,235910,905,1749,1889,2794,1749
556,86821f2b67861563c5c314641ec250760cdc4d0f768fb0d89f46601d65d2802b,adware,1186630,4717,9406,9422,14139,9406
557,87be0938a2988b5fc6fb50cddffc295a4eb42bff2f8d296f134f54354f6f9e1b,adware,194589,700,1562,1588,2288,1562
558,88041cc775ca783253e7a2e3194453daa54e34712654aab82c8266f49f5f5fd8,adware,192941,838,1487,1573,2411,1487
559,8853e333ec402ad311f7a1c52c38cd2e2391c5d3ebc6d52e7c344ee4e4644cae,adware,218787,856,1683,1842,2698,1683
560,890c9f99cbbe38a1dc8a56d953a7ff1c41cf6ca8ff00d392c9a1ee3d02fbcfb3,adware,329575,1334,2579,2575,3909,2579
561,893bb7bbee2da7de0548f1c7c046ed50df212b1c4fc26005c6b00f9434225454,adware,219093,919,1807,1769,2688,1807
562,893fb7302b14c5280bcceec4757ae38ddd24910cafd29ba8e4cdca7be6217b32,adware,205647,823,1663,1727,2550,1663
563,897ae4583035a9da0aeaaede70e2e5d87ab642a870d090584474f1fc96f7da50,adware,234986,1006,1836,1963,2969,1836
564,8abbdbe3e0cd6ce0c87d7cf5e45dfee01398beb366e23481c2d324d1476ac559,adware,232797,920,1835,1859,2779,1835
565,8b106e6a574209318ed71ad41ba54ccc8e59fdd6b94b945ab7f9d0030e7afd2f,adware,221929,853,1767,1861,2714,1767
566,8c29d37da066f3010b4403a05a26c23ce2976a2e89d6a40cd21a70cf7bfdd906,adware,215390,849,1730,1766,2615,1730
567,8c2a2331899f611dbba54e7f4e980cfb5250dab2a4a00f801bf622304621ebe3,adware,233651,961,1859,1960,2921,1859
568,8c980f21cbad7c96d352a2d2ce064a79f6955592f01b303db57fe5abe22ccc52,adware,235789,935,1772,1900,2835,1772
569,8ca19c09da87e1ad15e40d5dd117ab20fa8fb1539eed97a915c89575327b2cc9,adware,206807,824,1660,1773,2597,1660
570,8cc33e2e4c15d8d0f6dd1070edad8ffae6dde2b9b748bb6d7b87630cc9ad4820,adware,221963,852,1758,1804,2656,1758
571,8d1f69be59f05ebbf4c2502e1436feb0256b440aa1b4f9d9fe3d37d38ab22605,adware,791345,3393,6430,6361,9754,6430
572,8d6dbec1ea19de61f822a1d135c6ec974f4d234cd2e9a894b21cbd3752aa3d7b,adware,232976,912,1786,1959,2871,1786
573,8d7637091d103ab9595b07b10d0fdf168809f0aabaad5bf90c7e700eeff81311,adware,206823,796,1627,1712,2508,1627
574,8da56bcac1e02ec444f2203a1366a6f84f1dedcd819d29b07a0330b3f26108e6,adware,198737,776,1603,1670,2446,1603
575,8dc41f12e38d1c47e8cc4344cf2b3c52b25259fdd49d2bbad36a616f17f495bf,adware,206531,845,1674,1795,2640,1674
576,8e6f3a33ff240c8a4f8591a2f63a8bfe303df8047b3c896166b8af44929cb79f,adware,198769,726,1590,1601,2327,1590
577,8f080655eb410586047fd2d19312cdc55ef936baeb9d20b5809dcc0868f24750,adware,222933,876,1818,1826,2702,1818
578,8ff19a5b3c34cb93d03b4f3dabe08bdc189968cee6cc15ef4037a7b9a02f4ae6,adware,232243,968,1779,1956,2924,1779
579,905f7714e64df44bf531847db03bc77fd4c775dbc657ffacfae05632be54378d,adware,223271,821,1791,1857,2678,1791
580,906ee494aa6520cbf3565e9d32da57fcd6355ea96b56a310dafece387a7033da,adware,235172,989,1897,1977,2966,1897
581,9081a589a9d9750f24d0a033ef5f3166997bc9a403668ae9c933af795577e3e2,adware,220259,846,1665,1685,2531,1665
582,909832ef76cbe4032d34bf26cd4763d76540489589ddbae2a717dd7a7cae0926,adware,220544,831,1772,1815,2646,1772
583,909cf700995a21db2801bc82efa9046014bb00b1b617ddbf56f08f2ad4c9f383,adware,235080,1020,1781,1888,2908,1781
584,90c92f9e842f067081c8d4be17c3eddce1a08b179d2dac604ad91ebeaa4150eb,adware,223302,847,1803,1799,2646,1803
585,90e027b95afef30e1a46f9c084b05c78346cad91de5536afe99fabc615053b29,adware,736301,3177,5638,5945,9122,5638
586,90f3e3091b63b7876f9424bd25a197fcc299e5a3c5b901cc6a42ab29f20dba9b,adware,198790,749,1577,1602,2351,1577
587,91187af27bd19f2b8c91fd875c31e5b980f17bdd1a33234e6f7e9dfbecb89431,adware,233757,883,1825,1930,2813,1825
588,91a7a436c8e4735c1509e58daee52af66df5682dd8324561699088e1428d1854,adware,233725,911,1861,1980,2891,1861
589,91ef70bb229de377627ef16c11d0320296fcef51d4581c91e1fb637048a24970,adware,205442,903,1649,1697,2600,1649
590,91f76113b7a24cf47c6ddde6f70a93b879cdc011bff938b7ea7b6b00c28338ca,adware,221384,878,1787,1853,2731,1787
591,924a2e9d5841793f56f2acaec70edfbf3afea1bb1f379af675530fd848636239,adware,222594,852,1700,1750,2602,1700
592,929df7b5c4f45f3ea7787aa14f52dc68e08fe73e7840de52250a1cb67838a563,adware,198342,776,1610,1638,2414,1610
593,92ac3173b32c4ad1ac7788929bc21154c44be943256f33498fa14e4723c19f0d,adware,220973,823,1740,1757,2580,1740
594,9301c7f750c8e0aebf57edcb06008759c88c892725702ecf52017564d3e9e5e0,adware,215739,821,1702,1739,2560,1702
595,932a24f9b3939912075cf658dffac86f790e04673d7584881b4d0b2fb1a2f908,adware,232934,936,1837,1933,2869,1837
596,93661d5807441cf20939e4934370e2893f060a972f82e43576f406b07b6b3194,adware,550291,2185,4369,4353,6538,4369
597,936caabb8fdc363ebf1f9be55767e55007c134eefa7747df775efb269df9852b,adware,27368,99,237,222,321,237
598,939ee002cdfa45ecb60150d48b41f6c5dc171e2a2a73fd1f1087aeef0f912339,adware,216455,791,1751,1755,2546,1751
599,94a1dff965295fa26b6bfe81934034e644204ac129a9746bddf0707a4d34eb20,adware,234353,938,1868,1918,2856,1868
600,94a36d0d328b4f307b72e94b3a431fcb209dc02eec300606a71c7d55f2ad6cfd,adware,208410,870,1652,1782,2652,1652
601,95128b9582359abb3e5054e1d0920ee3b1582a8036fe4d2c0a29ed163604d260,adware,234648,874,1869,1930,2804,1869
602,952586fc72269fd35b09a7f1f006357d7d5567396d9930187645bb3c10dc7775,adware,236129,971,1879,1921,2892,1879
603,9530c510ad89920885f3668272da19071cc448b5bb69fb14f0f82f8921544944,adware,731338,3049,5762,5840,8889,5762
604,957ec16c917a2fead3168a1e5b3daafa66224839d020b73f2374410da7d92244,adware,198702,748,1585,1654,2402,1585
605,95a1356ec8210d8ebee2cf21b33c2be58e715290159b2e4b8762c392b9d702e9,adware,195318,765,1578,1619,2384,1578
606,95ae757d806a921fad0e6231e00b987c356488735ed985a6d51b6fcfbcfb7781,adware,222383,883,1707,1812,2695,1707
607,95af35654ee8b1644bc8f9fbe909da5c6bcc043198f9b904b1a109b45e22d42d,adware,234477,911,1842,1953,2864,1842
608,95dca0bc594a99f7937c240c790cb92cdbe0245a63bca67ccacfb4b9b3002018,adware,217218,879,1683,1703,2582,1683
609,9635109b9486b0fff2bbfc59fa98e5ed157df89693a29aa6be67ae54a0582698,adware,222429,867,1763,1802,2669,1763
610,9644da898eadc737fa5b8c264a7ab2c86fe65bb929b2427954a777712db32c2e,adware,221779,897,1764,1875,2772,1764
611,964ff5f60902e6e6db6222afd8a2ee91037978e90d77161f29b0e59a86ce9c75,adware,223960,932,1753,1814,2746,1753
612,966f6c001bbda850f49de91b51f4f989abe6da4f64b7ec3e27d2b5927b5eb532,adware,652873,2755,5043,5305,8060,5043
613,96b3dcedf478c12c63b9f363bda02ce9c4cbc447c64c152a85d7b3f2e60a5644,adware,234474,991,1906,1955,2946,1906
614,9733d2268a5208ae7848672d7d55ab0bc112241cacbe2d4888ce28a8a4d8cc8f,adware,198661,757,1528,1611,2368,1528
615,98093fe4e8c268496b48ebe3f877f98772cbfea20e55d79b4909b0d83f962f8a,adware,242785,961,1907,1986,2947,1907
616,985e1b0a4580f0fddc549051f4518ff97e19d184b6f0ccaa8ded1bcd47b379a0,adware,470143,2071,3605,3807,5878,3605
617,98776595c595266cf83a0fffbad6cabef582aa7e91e34008149e4b7fdf85ff42,adware,215926,856,1692,1698,2554,1692
618,98b47fe937dbd12b6da31ec661d6987d2004862228fe80f4083e4874073da700,adware,224832,909,1742,1763,2672,1742
619,99261d9cdaad4aaef856cce23fecb12dba9f552e0c20ac585b85cdaf10417d5d,adware,235527,1076,1890,1803,2879,1890
620,99411be8a485bc445d0554edc2e9781b40e3344eaa30173bd970428602ee40c7,adware,234534,952,1862,1944,2896,1862
621,9957cedede08f977ff5a58ed1afb2dcaa7461e3f4335b54860a47b5e8b3cf8d0,adware,234554,872,1850,1921,2793,1850
622,99fbfb3ca81f51f98e50ea9cf326c9332b2fea2ab685cbbc577f05fc467d98e1,adware,367350,1522,2987,2938,4460,2987
623,9a3e4bfab8d177e0b622662ad0fb0dc15713832f35e3bd0ed3530da4ec3e0ed5,adware,795367,3254,6418,6380,9634,6418
624,9a738de9531b60ea1d0c5bb3435b06b4ec98a1c637ff78e00141e295f5cfe59f,adware,312580,1183,2496,2546,3729,2496
625,9adc3dde5041a988cdc3a7ed8fd946203f5c64be6a33cfcb38542476847eb590,adware,222971,880,1805,1852,2732,1805
626,9b459e0d83a2225f28bcf502c8700eb7cdb915472f57f28dabe8d56f6f8e268c,adware,308738,1312,2470,2383,3695,2470
627,9b6c2088cd81aaa95d8a148ce2df7da9d5c62bcb1fa5e5165333acb5310ccdfa,adware,206773,823,1639,1672,2495,1639
628,9ba1822467270220b67aa563bf3dac29853a751b22681d5d2f9a3c9df66ebfeb,adware,645681,2649,5071,5390,8039,5071
629,9bd8620e91b8d950ea5f2f3b4dbe67eecce4954f2613135967ed92c4f1c09945,adware,235416,959,1913,1999,2958,1913
630,9be8d5508f600eca00da80b4fa69ec1eae9730688524638e43b43d01ddd955ee,adware,1541946,5736,12097,12474,18210,12097
631,9be9083e4572dc77ce547227954be2cfb13fa295b0aee89646baa04fd9813fe0,adware,1188387,4555,9471,9605,14160,9471
632,9c07790610d43e9714861f41d5d914e951ae4505fa7e0b7dfbaa6f3cdc32402a,adware,236139,956,1961,2079,3035,1961
633,9c1489ad219cf550ec9cac5c8749c18110502406cea077cce2290503be5f6f49,adware,222240,831,1843,1768,2599,1843
634,9c20a758f5d8ac9e8e40a3844c617c07d7258ee019da7f76212218e317e5959a,adware,234227,938,1839,1919,2857,1839
635,9c3f3edcb622c0a957f15fcccbc3d782e90b233d758dafc1c856383e51098c78,adware,233788,947,1866,1856,2803,1866
636,9d1859cc34b55801b5f4a87226f9509dfc224b510a80c7c236a98f737cb4d96a,adware,222993,875,1726,1807,2682,1726
637,9d5c84ee84bb478ca1cb8d028ca06dcc00f539945524c2aacdfe5525a1d3404e,adware,223013,841,1806,1888,2729,1806
638,9db86957ba94cda82abf6be7e2d1efc7c822806a2a5e35bc0fb3a32edbed01bb,adware,221542,801,1760,1763,2564,1760
639,9dd3bbd81941dac7d8b304b4d4d4e9bc763872983813bd7ce43111e7cbf718b9,adware,222934,843,1776,1825,2668,1776
640,9dfc20194932c24082b5ebb5a3bb94272daca44a9f4a516529c4e1243a041373,adware,220949,806,1724,1741,2547,1724
641,9e775f4be7671643251e5400c91ca85fd48c6d30a0a81e789c43bfe7316afebb,adware,235130,991,1787,1972,2963,1787
642,9ea992871f828c7f054837386068ae8927dd6cbda36f21a26669f60928055b47,adware,224811,866,1726,1828,2694,1726
643,9ebc56762b19e91097fd5ce8952e2cd482bab9a8f9e37fc590ff83aacaff18b2,adware,1184967,4642,9246,9378,14020,9246
644,9efd7b0a777e70281401a2cc0f3294dc743a7e308b287426fe1d455fd7c30dde,adware,968217,3916,7624,7862,11778,7624
645,9f0329d6a3117b6943dfbe5e342a36b00fa3c87fcbbb8ac317a0504b4560d338,adware,233836,938,1919,1966,2904,1919
646,9f0b643ae2976c34ff7f7eb1480e8eac66a3352edfe177fd61e6da2f9fbe6f93,adware,234112,915,1885,1920,2835,1885
647,9fb9805daed769fef3e3fdfda9fe083e04325d9309fd10ec5387ce103a12299c,adware,234118,942,1904,1913,2855,1904
648,9fc9576a0bcf0cfda65af32b2405d9a45f55940fbc6c4e03db552f44b2b5b5bf,adware,75020,344,645,627,971,645
649,a007613242b37ab89b2c99824c92b978137fd2d7cb5ab93c5634653090eedc5a,adware,193290,831,1546,1601,2432,1546
650,a0e83ca6861f441ad6700239e98e585636e0d0d54982d06106507d3789f3c6b1,adware,548733,2146,4267,4464,6610,4267
651,a0f4f94b02e93746e0ea46920e4e3228185f2c6290ef632ae6d90d2fe91df990,adware,234780,963,1875,1912,2875,1875
652,a10de6ca507dca804d37a99d67b4f69bfa2c8294eefe6a14df7a00b0810f6423,adware,795794,3333,6208,6444,9777,6208
653,a12671461ce6cea094e9ea3e77b68a45a1cc1fac3474c60b5a23928e3842b2dd,adware,194339,731,1596,1579,2310,1596
654,a184db181519f18b70b3c6503297b4c42c1138c8b2b436e7fc1b5cd4fce5355f,adware,199011,809,1592,1675,2484,1592
655,a219447d7d64fa0c21a2f42d58154da31c393605e59fafa71c953d172a5419d7,adware,235671,949,1841,1971,2920,1841
656,a2638905d7a1bb29f7f39ea51144012cb17dbd0f11aa47b6df21f85cb4c0171f,adware,198358,797,1502,1588,2385,1502
657,a281dbcf06c32a9e3e6bd5c2843f89ca37d20473c307680d9c517f731ee30bfc,adware,389194,1655,3068,3146,4801,3068
658,a28a9b3b90ec67f0fceb3350d28ba97d792323f7e51dddfb24a96b1b81faffe0,adware,234535,1004,1805,1918,2922,1805
659,a2ef7e400d2cbb41aa6e946bfc201f938faaf186f96db6d75359a33e3b805c7a,adware,198309,801,1549,1566,2367,1549
660,a304b372839cb3bd5b8bf14d111e01cdd2e6edce844badfb9c406d8bbd0ec97d,adware,198520,789,1559,1573,2362,1559
661,a350c833f05beb9d2ed6895653f1d3247eb2264c2040b60778b7a54e39c9d726,adware,611746,2501,4706,4975,7476,4706
662,a39458861df7708bf00f6d99666f0dc0fb9796b4520fa1d9a30600854336b1e5,adware,235643,1030,1856,1941,2971,1856
663,a4228a03a685a456c5344407b1e66f8629134cb95a88c45220b70a6bc2edccb5,adware,606396,2546,4804,4840,7386,4804
664,a428d689c7f2831cab36d6ae41a6e1e0e9077abdd2996824aba1d5d8c75ead71,adware,333855,1382,2681,2749,4131,2681
665,a43d41b301b444be4afc68f85eddba543529f572f552a9a2cb722ff711d2f6df,adware,198454,730,1585,1559,2289,1585
666,a4d5546dd45c4a8344f989b3f3990535ae44368bf2647dd4ed08bcdc1ab152e0,adware,221430,844,1700,1785,2629,1700
667,a4f8088e2484abf941bd738d556df5f320bf578176a72a149edd8b3acaae6e66,adware,422509,1799,3327,3471,5270,3327
668,a5df571fc6cfbe6a411fe7e7f084028a19fa9e02670d464cce5f0185356e1634,adware,233301,946,1852,2016,2962,1852
669,a60974a04909cb3b6914e94ab2fe009fa59267dcd323942c24cb99522751ce11,adware,235667,1041,1854,1913,2954,1854
670,a60bb4856644854e327fca248ccafbbaf4385ccc915c3d152b9ffe1fd592cc01,adware,215750,813,1725,1675,2488,1725
671,a64ced2890f43d53efa9b6dc87633f77d8be59551080ef311b221bf3ad51ff5e,adware,234271,924,1801,2002,2926,1801
672,a66bb40fafc3922c15411b4634ac954c6cb1f6fcda5dae31c1278f84c406b320,adware,921574,3708,7385,7181,10889,7385
673,a6d9a7c54b430a7c2f05c1a582c6a9ac60d306bd821b5a5e41830fb5096a2ecb,adware,27460,127,210,223,350,210
674,a6f590ad8a0d527bff62295e4351b7ed14701a3ee77399657344f1847f74b1a5,adware,223193,806,1850,1761,2567,1850
675,a70c9ac4e27d0d2cfd2935581f750f07a5d3a69ee7cf9d44ccbd7074ce36e997,adware,309338,1353,2494,2461,3814,2494
676,a73b61ae674bfc795d1a85f9263798f71cf992a26097f9ffa08c3e211d0310ad,adware,550681,2183,4223,4295,6478,4223
677,a759b555044a4b8d9b73ea67cc469fbfb493fe0a3f71c09c5d6df9032c1c652a,adware,193310,795,1555,1615,2410,1555
678,a7693808e5bf5a5f6336d05fa3f37f7e2caac547071ee074f8be0de8fa3af8b8,adware,198342,780,1512,1678,2458,1512
679,a783f6507bee2d50f37d9fc8375efbeb8251fdc7032c0200302c87e9859b376d,adware,389572,1553,3063,3208,4761,3063
680,a7a07123b3cbda0f4931e2e0d589957783d145273e2043dbacf6005f4bf213cb,adware,220820,835,1745,1798,2633,1745
681,a7d3288683b8e5477b1d9a7508415b08a452a79aba03e6023d36923647c6b0f8,adware,200268,775,1562,1632,2407,1562
682,a7fcb6ef1768c666423b059191a5148de073e684088ebd6da9aee337454cffc7,adware,198513,770,1635,1622,2392,1635
683,a809a07a23a123fa58ed4b49ac8229e73c4bbcd81b68a09c6c981873c8ef6998,adware,233712,1018,1802,1935,2953,1802
684,a8eb5bf9122ab0b1856279a4042ef2758a82caccec67a0a636b1d8bf214c3265,adware,192699,810,1568,1602,2412,1568
685,a8f1030ed4ba76dce7f056264e466170472a42ee040c4ebeac256c206cd1d747,adware,198316,793,1583,1568,2361,1583
686,a9116cd71ac80e55e96c9fbd23b51ef73f86374c788f16d23295c9bccd63f0bd,adware,222616,883,1744,1906,2789,1744
687,a9606c68938768be249d0b7a79e33fc2d0f38081cbeb7497f025e9f756943bdd,adware,198401,799,1592,1646,2445,1592
688,a96195b462aa8a623be291ae01765f83b2118ac812bdb4cd322bc17745fd3d82,adware,198510,790,1585,1605,2395,1585
689,a9a70fbad21d600d4001b1e971fb1fea30b55a18b4a6c59a39a696e84635e745,adware,219658,814,1721,1622,2436,1721
690,a9ee382bc3c69652e3591e8003c7db2cdd60d5c79b0f0f9d1003c5a0bd95a559,adware,794205,3303,6112,6241,9544,6112
691,aa29e736de1b834f9f387c7e0a214e633cc38d2a659949e8e9f7046a6ade698e,adware,195388,725,1623,1628,2353,1623
692,aa60cb155d188fe11462c10a6c604b33713aa2c5f62bbf393f856b7e69e0436f,adware,235137,989,1904,1977,2966,1904
693,aada25456ba4456a23bf5ff8e784620462b23e1a5b28ef8967110ed3e490082d,adware,221268,814,1771,1711,2525,1771
694,ab03a18ffebcae9b8ad55ddde4c6286b948060a01aea36a3fac2b41b7f2a42de,adware,198828,740,1543,1585,2325,1543
695,ab16cf6168d28027c842501a9d06dc8f9d45eb9002f5e35e517470497a7640ae,adware,968091,3894,7528,7734,11628,7528
696,aba9a2655cdd920e4a953c9aab7521e719791f5d3f7152f9279e08b2ce39bdb2,adware,978821,3925,7818,7701,11626,7818
697,abaff1d369b46dc686154395475d6a0f13ceff4765fab0fdcf743cd4e2a772ec,adware,235526,1018,1907,2076,3094,1907
698,abf6c4c2a48e0360663539043046ee543de132a205f29dfdb51bf5e41788dd19,adware,222910,925,1767,1834,2759,1767
699,ac33267891fa6b77df6c32da32b67d6d894a72b6f73a9669f6c2d08cb3ac331d,adware,198486,802,1585,1573,2375,1585
700,ac699429949d9bf6b2608dfd8043aa249cf469f50c50192a650956cc70f6860b,adware,198423,747,1543,1583,2330,1543
701,ace2da62e228ed65fa3407e9ecbba1f37d6232d9f05acf43f34d93ab56e445fe,adware,261131,1033,2076,2111,3144,2076
702,aceec9d6536a0e0c98166c0bceca47e5f90cf3d770bccf087764de8e6caa6a6e,adware,232584,997,1866,1940,2937,1866
703,ad2573f014fc79d546270ab66cd19d7036167c0925c52fc71c843e810a6345ee,adware,221931,864,1713,1813,2677,1713
704,ad5ff4c89c88007f604ef0f98ec6e4da37acabd3fb5a5809290087c112b22e6e,adware,221570,810,1794,1792,2602,1794
705,ad61c5640b8ecbe2d41b19233e02e1c9004ea85b626b15610c4d899eaa650300,adware,332498,1370,2694,2692,4062,2694
706,ad6d6a9ef1686e45cfc973c2fbe8a6141ed8fa5fcdf44d3d710f7d57a69def26,adware,333895,1373,2661,2703,4076,2661
707,ae0c3cdb8e956847438c75b839ee76fef70e9a308f92521207a552cf8ab9fff1,adware,198387,785,1574,1577,2362,1574
708,ae5cf93bcb7f2f067cf2a372969a22e7086c4e78ad2ebb573c7a5b5c2a51a011,adware,977432,3847,7594,7834,11681,7594
709,ae7994c758a5122b0c03fe7d064944cfff5737f1c960de508d6f71c2b4b489f6,adware,192740,769,1515,1564,2333,1515
710,aeb56eb654ff68714c20aa2f0ea3e60423a65f871a9451718aaea05939f2138f,adware,629018,2541,4959,5089,7630,4959
711,aebcf9f6572b63da7ac3425ea8610d474b64be1830e277b661d8859a97f03272,adware,550644,2178,4349,4341,6519,4349
712,aecfced7e4cd8776b020f513a669d0f11f45434af5ab2161228432822ed53c41,adware,980480,3934,7830,7937,11871,7830
713,aed3180f3fcf7f0c74b82bdb9b03c85eb81a01daf2597506e938594770b6c2c4,adware,198582,770,1558,1559,2329,1558
714,af0900d2baa7160d0e2554a1bf42441926ebda4d9c3e940941173f851b9392a5,adware,179650,689,1365,1362,2051,1365
715,af388d04756d9386e24ff9abe3fa967c40c857ff2b69567c4ada42dd443bf107,adware,460728,1837,3603,3643,5480,3603
716,af885968d54af544d4652c38aa7e8432406f67673f46d1c2c701b4782092e7f8,adware,736857,3111,5671,5899,9010,5671
717,afd0cf7388bc1a49005b1ad1a4de1a49cd1e990b676ae9489f8ab082e69835fd,adware,222630,908,1833,1861,2769,1833
718,b02d9d91c51667c728a51a7ee9e0639be6af8b65d4a05f4c43f943800ac173a8,adware,215701,890,1822,1765,2655,1822
719,b1163eee6013aadc422a643e115704888f2b15f0df8f659c39be209ab43895a3,adware,192645,815,1484,1569,2384,1484
720,b28ebadc559253c73f94d9ca2d8777349939505cd01a60aadd7745b0f9433d6b,adware,206958,825,1691,1806,2631,1691
721,b2dcda637065dd85da950dd47afe3fb6de8175197c5dc8c2e684cf439ecf21d6,adware,362581,1537,2975,3042,4579,2975
722,b34665da3e9529b6673de12561283dd901350764a389c169d0f1966f98dd452d,adware,231199,989,1823,1866,2855,1823
723,b3506b12601ed171c1beb622294b1db16bd37246c90d1f8b3d0a40e743e05cce,adware,233609,987,1840,1846,2833,1840
724,b3e00cfb4e60e3e170e5e8cfeb87c9c8f4410ceadb8ec753faf0d526e33556e6,adware,222469,873,1823,1825,2698,1823
725,b4bbd0f685ce8d2c5e367c8555a9914e17a456e99e8c930f4448197d67c14a16,adware,198768,716,1611,1618,2334,1611
726,b4d562958c6d21dd684dc9529b0069a2ab94f4249933d333b905013213963985,adware,734473,3162,5814,5879,9041,5814
727,b512d42ddbfcbb6179ec9d71c2b93029b65da66e05c903bf41a0bc2e39bf96c5,adware,234527,958,1779,1968,2926,1779
728,b53b80582a10f631e38070cf7c5d2abce41d73e1c5d080990d25bc2b547a81d1,adware,234481,985,1784,1900,2885,1784
729,b56dc75087cc0750452c488f6129097b5e6e3d90b255a25e3d37be95ed23250e,adware,198373,745,1611,1603,2348,1611
730,b7948ebea08f51ce760b7d7173f6e51c491ea812b1e00a55bbc1c33a0f68c848,adware,233542,971,1859,2000,2971,1859
731,b870473976d2cde6faf51807052a3f7c0e8744c7f43e1f849ca5793d256364e7,adware,231600,909,1915,1857,2766,1915
732,b8e94ea139b6e1601d1de8a6f46ae2c2c8ea7806ac1d4bb834ec103f5715c94e,adware,198762,744,1532,1620,2364,1532
733,b92cb9ce89877d702b3970d793638f93126ce657be3dbbaea9186d4f9212ee14,adware,610884,2587,4798,5196,7783,4798
734,b99ed4a5b08f224a6db582c7b4f89c509d48dcfa705552ba81574c6d3921c518,adware,221197,848,1793,1753,2601,1793
735,b9e490304d92d599ac5b3103dfed31690774a93630e893664629c5341c1ff24a,adware,222409,817,1742,1794,2611,1742
736,b9f5a46aeed50f7b354dbd989febc2e74294056d0754ba28a23bcc02bd92fe3a,adware,234957,943,1771,1892,2835,1771
737,ba190a1701c6b914083d6f9bb6818e12c3cd19804d65cca92dadee224e1a25d4,adware,222712,883,1678,1859,2742,1678
738,ba54d60ecdcfcd5b3efdf1808da909a2dc8ac1cf4b10468fe29ce809ec664603,adware,227004,922,1789,1880,2802,1789
739,ba6506d1132719ecdae64fba5c49237c9fb2265a808ea3ac3b56746d40370fd7,adware,221562,851,1713,1717,2568,1713
740,badfb1c60951d511930268f9884d4cdd35ec26f99d03b06d1282935740e9d707,adware,205755,823,1687,1675,2498,1687
741,baf536976b4d1250bf255da42d435d1f25c23a9f2eb0c4536735e70d702bcb32,adware,221130,908,1748,1842,2750,1748
742,bb3054eff889bfc0d9dc3712a3c690a84b43c73a9f2b588d53c24bd2ce81eff5,adware,232042,1004,1907,2020,3024,1907
743,bb57a99705cd278609916400a8b80ad8dc8423534105f433be4b5c3badb91b96,adware,656619,2827,5251,5384,8211,5251
744,bb68e746e94d242096fca8efecc52955d15fa5c83599405adeb9c4f91557367e,adware,233988,1004,1932,1911,2915,1932
745,bb8dca96ff41a2460cd62c9e1652e9c6282e7fe50ec295a3ab25e12f5d64a0f4,adware,198611,761,1560,1676,2437,1560
746,bc0c04ee0ffed2ad853f7f0f476da0ce6dd2c51157a031fb128d59574faef368,adware,198603,772,1552,1606,2378,1552
747,bc8608726b00af5447ef9ac2e029639c6d0dba774d29472c0adfc2ec5779b2d1,adware,1185224,4657,9325,9221,13878,9325
748,bcc05c2d8d8942da87cb134827e710a9db41f53ca85219a83547a84e8ee49047,adware,308805,1318,2452,2457,3775,2452
749,bcc7b1de1a3a631b95bf0d413cfe6a9c5531440ce17e3be9dc6b79730bff44fe,adware,234594,965,1982,1900,2865,1982
750,bd61033e0d915f6c445ccd020984501c5e46ad37c55b9a6ede844feaa4db9869,adware,565176,2402,4486,4829,7231,4486
751,bd622acc4c0e7478a56e2f5de1cc05ffc868461ba8efb9e0a75e96323fe6860a,adware,234907,983,1884,1923,2906,1884
752,bd92cafe8b32d4a5954c9bcaa9411fa1bd306401fa075d2aa3e29ffe8a25616d,adware,222365,837,1732,1722,2559,1732
753,bddcbf3a4c741028c62403fdbe6a42e9bf68affe9631ddee898c79c39f870a69,adware,198397,816,1584,1722,2538,1584
754,bde84a20b1650845c733c5f66f384be1cb66a41c17be641eae7a7ce4fd5e2500,adware,237224,1067,1838,1954,3021,1838
755,be45062a6a3edefe307c43e5e94e81fc29192bf2e922ca7ee455f518ada5bcef,adware,198470,779,1580,1659,2438,1580
756,be9ae6a7afaafe9763076b88546cd8e109e498eea09133f153a174d8259efe31,adware,235578,942,1916,1976,2918,1916
757,bedd817a72aa50e42b7eb06c472e0feb8c83bebc7cb866dd6159f8f97c5f5399,adware,205846,813,1684,1740,2553,1684
758,bf70e349e6a547f60bdd5c3cac933ac4f3fad6d1cecf523ccad66a42046a3b55,adware,310890,1301,2529,2494,3795,2529
759,bf94fc5b4f1daf3015d0649f4498184f531b98291d5664d408fa50142155d8e1,adware,232099,945,1768,2000,2945,1768
760,bfc95bf6df0f8f256454c446308cb320d3066a243d00b7252746f877d3ddaebf,adware,223586,864,1811,1812,2676,1811
761,c0573b5b0a8ea4312eaebadd62b565c78713efdda7fb89e6e17b3c87bf269e31,adware,206635,876,1559,1758,2634,1559
762,c0a9f8f9d08e969e902eb24f074ec7244a4e485712e8b2a1d81219a69ff82081,adware,232342,896,1854,1988,2884,1854
763,c0aab3f96f14d58c3eb4d835df73a76e53f2ed16773b8c692d8e5b2a1817ce9f,adware,198350,777,1534,1636,2413,1534
764,c0de1a6d471ec6d0c4c882b7b80d7a825bb10594222ff0359e3e210028cfc490,adware,548840,2216,4258,4321,6537,4258
765,c0ee0d4885dfc5bdc58c430e68206abab97399fa1c2ecd5b6d3a29ee5790e9a7,adware,218077,863,1665,1832,2695,1665
766,c13da8587729dede2ef906f7fc57b673ecb6465c80c729ac879bde95c9e5a9ac,adware,1183238,4691,9163,9448,14139,9163
767,c190c1c2b23c1d4b7ac079400b06524e2d9913a25022eb77b8d7d60af462e5f3,adware,220788,867,1792,1790,2657,1792
768,c1be2ad7da069d57e1bc1f5d8725e4552737384bfc8b68eeeda73479550a18a5,adware,194540,742,1580,1590,2332,1580
769,c21c73b18c1c1d0544b9b40989c74cf49e2511924b24d2a7a327d54ce9966674,adware,733568,3122,5807,5921,9043,5807
770,c23dd6986e050009be33559ab9d45fada3dd27b7e170e101379cb081bd4f590d,adware,232934,957,1868,1977,2934,1868
771,c2e4e1c7975f0498ba6a0abd3d9ce4bbb64a80f29ddad68d1b5a04080a63a88a,adware,25928,106,228,215,321,228
772,c2ea89d98405802b37c8c2fc959012680d87fe8dc23b5501027e269e3bb9df17,adware,234298,927,1843,1934,2861,1843
773,c32274a16306f43f7aeaa4c804f101c4153dfd8a907ba03e7807304176bf09c1,adware,222375,874,1787,1808,2682,1787
774,c35c51d5d53555dc71c97f6472373b2f24324a372461b8c98ca79552834bc455,adware,358054,1518,2873,3027,4545,2873
775,c3947fd21ff1a53b48295049543bdc06aa0613c95a8556b5616a9337e7e16312,adware,198144,795,1590,1552,2347,1590
776,c433a6bc5789249d819e80a08cf4beb0c7ae15cbab32115e0e564aa9f1de4c04,adware,198660,777,1631,1604,2381,1631
777,c465aa757261f381cba7c43d6b0ac9892244879ab84a1c7c8965669d6bd26bc4,adware,329814,1401,2621,2613,4014,2621
778,c46dfc582f04ff0367812da189e06b20dc1fac32bb23b5514bd28b8c423e14c5,adware,235256,1037,1862,1949,2986,1862
779,c4bc041fffeb7dfa0d0da094c8d468cf8d67ccc7610c7c9b4dddae3a8d3eb0e6,adware,198625,786,1559,1665,2451,1559
780,c4cac9b7f194455433dbe2ebd37b112f2f3b06c65bba2be020715f6b1d679fd5,adware,233137,920,1869,1978,2898,1869
781,c541af3ed90f11bb2ed66150368025067dd7b17cd7598caedc7d0c7cc599cd2a,adware,233208,994,1797,1959,2953,1797
782,c55270206b824410b197f26a9e607d292394ef81fb656d650be1308f4dfe10fd,adware,214788,902,1683,1804,2706,1683
783,c5a7069c106c1e18fd9d4fe8eaeb465c179eadc9f20dc6f97ee1903574885807,adware,198308,769,1592,1623,2392,1592
784,c5c2196672790bfec4c2e59971bb616b09090f1377a75a3ab4c68de650f46327,adware,234318,958,1921,1950,2908,1921
785,c5dfeee78dd23e58953f1875b12c0f0be52d0d7bd5bf39263edd4816add909b5,adware,328870,1465,2532,2544,4009,2532
786,c5ecf3403988ce6805498909769b84b3eafb004b59dc7e0ee05347ed2be811b3,adware,972098,3885,7571,7610,11495,7571
787,c626c82be619918fd721e541c5ac055038eb4584624b724cffd3ef2ed8851899,adware,975731,4004,7674,7751,11755,7674
788,c7724c7a528e53f1c3f4635398a4ec3d0207778fa8c20a7d69d58b3afe00eee3,adware,236363,935,1910,2007,2942,1910
789,c7ae00dcd0918f176a02f888662fc370e581e2291d777f8eb855ba7b7f3cdc9b,adware,477436,1917,3712,3851,5768,3712
790,c7f3cdea45a593403074cf72d5f77ec11dab95be9b60bb0dbc20befe3d090c02,adware,206523,834,1620,1721,2555,1620
791,c81bb7a43aa098bfbb2ba5eaddadc8b445e94cfc892466638bb4f01a4a1a2d0c,adware,419894,1746,3227,3209,4955,3227
792,c849610744e3c683df48ee82883de450e11cb36d7ada57157dde43b5a5be1c6e,adware,205816,826,1603,1730,2556,1603
793,c867e98ac95d181f0c2b1de8281cd9be42f7bf31f5a32a716e5842495fb1fd23,adware,234515,919,1817,1923,2842,1817
794,c87f081a9081396b186f07d9a44ed1dcc04c26fa2befd5bd371c343138159e3c,adware,237032,1015,1910,1964,2979,1910
795,c908043e66c701a752a84c88732433036affd409691fddba91f9e3f8445c67f1,adware,233567,933,1843,1974,2907,1843
796,c918bc4f353cc3381ab5f6f73e10663c23d1f01c06c9db81ed2ccc759f1b1295,adware,198277,707,1533,1653,2360,1533
797,c949f06262c061f2f9c97a849560e42a08397dee60e591bd94bea6b0d2bb65ea,adware,222560,866,1748,1755,2621,1748
798,c95ae2125d2913cf71f617200aa95b4b7310ba176e5c686165a1f21983c3993a,adware,219590,837,1754,1756,2593,1754
799,c968c7e156f2d08e2110f1cd2881f8eeed48a60341fb1b03ea53666d73d72937,adware,437234,1736,3450,3471,5207,3450
800,ca2ec8f244d9020fc87d11c7116198b2b99b9f20a7c3795a7553615fd704cbc9,adware,198409,727,1612,1704,2431,1612
801,ca6c2d4d9bf485a99986ee0b4ee66e5bb885369962909a76b9a3d9df72d365d6,adware,978070,3970,7768,7763,11733,7768
802,ca8ff221d22d366e3e1e8c49b77e10494a35417979b143adee49ae03d9c972ce,adware,367779,1500,2819,3110,4610,2819
803,caed24118d27bc71db0cdd5e029c3cf8b83f2d86abf106a22cce964bbfe165d6,adware,206223,867,1652,1661,2528,1652
804,cb4102519bfb6c413c4a978ac8781c08bcc143959cb1798c83705da70b524312,adware,980077,3923,7734,7785,11708,7734
805,cb5bdb70441b68ee25c2470ee9b21fba011c4ddcb5778885ad2c2819e8cadddd,adware,586502,2532,4663,4717,7249,4663
806,cb8fe5aebdf09e39fa4777c127d3cccdeae8fc4fd8570aef9458e7aeeb3b9120,adware,235198,1004,1837,2043,3047,1837
807,cbf338be5d25a5c4d3e1abe95f5368d8563af603ff6326544807705eacb5166d,adware,737553,3151,5641,5955,9106,5641
808,ccaeb603b8f790c3780da07ffcfd0f853f3179c1e7ade0a16bba4ee09beb65bd,adware,198520,792,1555,1673,2465,1555
809,cd58ebcaf234cc01bdcf023d51b17ee7321013ed919356dabe4ce250dfd006e5,adware,198563,784,1599,1617,2401,1599
810,ce0c67923e12efe1405db6e3c67b351d4e8cc98019e5c140ed17be8f0db40ec2,adware,198788,723,1549,1575,2298,1549
811,ce3cf046ccb6b3ce6426b6a72c95b9a435416f038c358f0334312b0b1b502ac1,adware,236065,1006,1827,1971,2977,1827
812,ce80347a04e4aeb96e90b792a655db0ae834320da59ad06db2389e59713c01b9,adware,198582,726,1591,1623,2349,1591
813,ceb293a3d6dff9c64e21413b86d718bd35a236fa22f7893a1c97d5fe8c29d608,adware,234675,934,1794,1944,2878,1794
814,cedf6c9553c2791d5dc7d732df873b516c42d03ae89b78c6615de0b25c4eba94,adware,216263,805,1759,1715,2520,1759
815,cf47ec5fb8e70a9010190b9a4f653c8689bc5ff2bceb5d49ff06f4f0a32d1684,adware,216628,816,1771,1717,2533,1771
816,cf6d66d7b8b3e3680ef6d7c3062ab80e29f22b9f86904f92396b6c541de2a926,adware,798566,3238,6346,6496,9734,6346
817,cfa6166963f885390fd481d901f8787a4c52a6822003fcb39013e626d39813a7,adware,206501,865,1631,1741,2606,1631
818,cfe489d5def4cc1c2d1c8f8f1a610ef3dce0e7b074e62efb7bf76a7bee17fdaf,adware,198370,860,1583,1640,2500,1583
819,d0988e33dcdfef90ee1ddd53cbd11904f1db3cba60c797e3f02c3aabe901bc2a,adware,198432,813,1502,1569,2382,1502
820,d0e623fa6629f05ba6435427af4bdd79068675e1f7763ac059b3c1cee31dff02,adware,344413,1404,2680,2726,4130,2680
821,d100694efd3e08f2990f2616e6d38ec297a18d6357b7ae9c25b56a000597dc7e,adware,551267,2229,4332,4239,6468,4332
822,d11a38b8ed642f21ede470a9d60ff2e30c231f219c50ac330deb865cafcd1f39,adware,198794,748,1608,1558,2306,1608
823,d1280ded9e1ec451bc18882f8be8c638293f6740e11aa474ff738de7cf370278,adware,1019524,4095,8224,8197,12292,8224
824,d14f69055324e3342a00c673a09e5e370fd68e84818d4b4b29a40cfbc00b2580,adware,234356,936,1866,1928,2864,1866
825,d189ac0c9ec0e9e2189751c1449b00f207df8fe832a9a320a2a0f3effa72c11c,adware,223017,808,1814,1834,2642,1814
826,d1aee219c6ef94d3cf4e6c88cd23f1fdc10f49f616f16e2f7d4c94efe9c8da4d,adware,27475,111,225,191,302,225
827,d206002473433288ee63aebcfd6fb1b68ae1892debcfdbc1a6960f355f8ec6a3,adware,334323,1343,2645,2769,4112,2645
828,d2310062b6fe8e0927a2086144ba0ee9fd375a73e8d072d057f02219108a57a7,adware,198584,747,1595,1670,2417,1595
829,d238ad649da4d7a4dceed8d2cd399d038ec9e25e792f29db514a5eb8ae66370b,adware,234520,931,1791,1908,2839,1791
830,d266ed4f86b8f0ae2b7805d5b0518c9eb6b23ae77b709f56ed83c678d593431c,adware,654840,2851,5175,5558,8409,5175
831,d2d6221af1f816ed2e38931d7555782bc45261ad5f6746a35c23fb454ee9fd2c,adware,223797,830,1798,1798,2628,1798
832,d39df8790fa576fa7b247575262dcfb410f481bba017320577fb854b56b9f8f0,adware,225023,888,1797,1788,2676,1797
833,d3a8aa123d113134a90cece56bc4aa15c7327a88e035b06a636de1df39c1fd68,adware,802020,3236,6344,6333,9569,6344
834,d3b8c32ea9fb756c4e4e9e87d9d0d5cb421513d37ccbc716e1531bb7e04d0fca,adware,234306,1029,1892,1928,2957,1892
835,d3f043e4560686bab1125bf1fcd98462baccde927da20316860803d4567a07bf,adware,231928,997,1858,1960,2957,1858
836,d3ff0361f4d24760942242551696d7af6f0d1ed9638c0ca75d42f052e8415ded,adware,380324,1626,3020,3159,4785,3020
837,d4d02920e7cb2b3e701f497ef9cd0ce35f0956741efb8815321d958cbfb6fc16,adware,921020,3747,7281,7474,11221,7281
838,d51ce1bb700ddc341782d077355ea5b96dedc2b8c02fb2f91a32f8a3f9814a53,adware,310762,1179,2543,2447,3626,2543
839,d55ece146511250f4c31a45e35da3e7a03e06d501100955849b328b9f005beaa,adware,223255,798,1800,1772,2570,1800
840,d562043699597820d63436dfa1a26eca91f00b252a1b2fd85ed95ccf7909f1af,adware,222663,891,1755,1802,2693,1755
841,d573ae2eb36efe8541c5354fc2c9d6f04e3cbdfc4bbc9a2621fa31f9b9a6216f,adware,220776,830,1785,1837,2667,1785
842,d5867f52da33c628fc49db191e95a9686d1c57d585acbe7f805aa0b6de58a187,adware,234436,934,1930,1923,2857,1930
843,d59c33b7642f6fa4f25a19eddc3eb859d47fa51b95b0bfa9e9342d24006883bb,adware,215695,868,1760,1721,2589,1760
844,d5a94b6f64033277c03a6cd8f3c22bcd8033e83c569d6144c1b36e682bfc8a55,adware,223340,857,1756,1849,2706,1756
845,d684403620d988e8ca6a1e39680790fbe17b8b1925f86e563a94bbcb98c5ca30,adware,218837,943,1744,1750,2693,1744
846,d68e7352e0587147eec6a22e6197bb3ed5638239d9f644d9b896732c8e97b5c7,adware,220531,878,1771,1795,2673,1771
847,d6b03614b01a316ec7a7507b2daa53112389b3fc2ebed1cc16ceeddee7e96c37,adware,232957,948,1827,1931,2879,1827
848,d7238c825c6e203e6c547ac8c9283fc7a579a3ee0f35f40633c9f4db8380826e,adware,234921,949,1918,2047,2996,1918
849,d7363d5fb6622cfcee5da86d2560b8ad8900abfeaaaddc134fcf2ee9bfec01b4,adware,1183242,4579,9461,9405,13984,9461
850,d7566c41a14164182db3dcb1366c4c0bfb03816005784f3514da5cd953523459,adware,232718,924,1796,1914,2838,1796
851,d76d55fd2b8287667ae7dc8274820055aea7032f7d957c627184c9aa3b0c931a,adware,215837,832,1719,1692,2524,1719
852,d7a5e64b21848c3916e6477d88427a8e1b3fffeb83566485a83b31686762a585,adware,207108,763,1695,1820,2583,1695
853,d7a680ee345f1f55a80477b0d0fa163a10adf9691c1f85ff9f8004d19648290d,adware,626192,2607,4980,5227,7834,4980
854,d7c800e3e75033335f062db754fde8fce64aac42c1af17ab26913845d587151c,adware,234238,1008,1860,1946,2954,1860
855,d7ebc94eeca1c5f0b55b1240a7ca8e42a9bc0f477676fada66e30966f1423830,adware,975256,3812,7760,7876,11688,7760
856,d7fa5dd1182a5b71fcd41ba5623dc34eb4282365a1c86feea34dd7243d2f601e,adware,220549,835,1814,1783,2618,1814
857,d80095bc85142eaadf38ebe58f660e7878403c83eccc9c7b8baefb48313c33be,adware,222019,848,1674,1841,2689,1674
858,d8450602658a1d8fcd198922dd895cffa54bedbaba3c1d923553fbae8eceb51a,adware,973790,3934,7728,7663,11597,7728
859,d864334acf58925cbca15a3bdc0c20216c9a92d8e4069209241097a95f58bacb,adware,443592,1769,3538,3445,5214,3538
860,d8b3ec6107b72b8af36e27102bf9b04bf29a908de2c51c0d3cc679a1a1bc28cd,adware,198591,761,1529,1598,2359,1529
861,d98fb2df295b9597b71741b9e68aa38e205d920df1384eaec753d400b63160c0,adware,235691,963,1891,1945,2908,1891
862,d9c6ba316d90c95fe9962dfdea147a692e31d1ffb5263447701d096b88545b08,adware,216220,795,1753,1753,2548,1753
863,d9c7b75dbf374d14b37d3ee65b2cea832ef347660a6ac9cd8cdfecbaeed21b7e,adware,206540,911,1639,1766,2677,1639
864,d9f0c86c44dec7178f9a8717057ad8cf2a2d1f22749390fab2e357e611fed83e,adware,207083,801,1717,1741,2542,1717
865,d9f570e1bb776f50638b1bcaed5f0c67ce483024835c57955c7ca0a22e04fdaa,adware,547726,2331,4252,4543,6874,4252
866,da779be3997d9f18b61e1a926d342386c1cc23e1faf700065541adfdaff7e0f3,adware,207379,813,1710,1675,2488,1710
867,da98374bb712b6f7ed765fdb872ad522ccfb183e94edb4a5cb8c5301ef2e9a8f,adware,236184,979,1809,1960,2939,1809
868,da9e354aa85145cdc74ca589d85b44269be0e6fd5abe7ea900850c29f633b2e4,adware,336452,1423,2677,2670,4093,2677
869,db6f3343dfee63d027eed52a088eb70bd2afbe5c54dde4af7e787f5a4931a392,adware,27402,101,220,223,324,220
870,dbaac6f770900c49afbda2da7e900bfdfcc678f69b664041b82b3bef50cffcb3,adware,198168,767,1503,1648,2415,1503
871,dbd7c5dc626151be779c9fe2acf50058eaccee51589f8efc079576471fc7d6a5,adware,978860,3934,7746,7861,11795,7746
872,dbf999fe36620c3553d3269f9cf6e7ef1d088039b4707366d65135a3b60902e3,adware,198868,736,1566,1653,2389,1566
873,dc185e3f03b96a0007a1f7ac1ae837e3c4e940293aaeb6ef3dd385faee3fc4ff,adware,233618,968,1852,1999,2967,1852
874,dc3fa693247f5a62fa3a9480df0c90defe3982fad84faeb55d9c2ace9bd2aba1,adware,25918,99,234,221,320,234
875,dc451732278aa331778fcd34e0690ca6e9cbb1d18a968637f4503bceddd3af98,adware,235328,1024,1770,1894,2918,1770
876,dc5db7c02d8fbff74c3d21104e2ffae15341c3789ff47e447346a18df75847f8,adware,426223,1701,3326,3431,5132,3326
877,dc9ef6c48d402fbc75f6d2cdc2b905e6867e6ba2c4532b9fe0b02b6c72f5e983,adware,220920,807,1842,1705,2512,1842
878,dce9437838b0ff27c6c0647f75c46fa97679435c953fbedd280d7fe1bb638eaf,adware,198763,840,1532,1651,2491,1532
879,dd0774c9d2cacf71fde93d22b8d13e154c8ed9ebbb6c6a5ec6f4ac65a7c0f24a,adware,220146,834,1681,1771,2605,1681
880,dd7dd28358891617005b6db86dd0e6b3acbe86d8e77629c0f2f98b32fd181176,adware,234303,911,1850,1920,2831,1850
881,dd9486915a73d585b23289eca86761fdb070fa6fc0e532c9dfdd67440208fe42,adware,233895,985,1814,1991,2976,1814
882,de820b8b381ca1ae135ea466631e74a5327f473b1c1788fc6cb933b7c073660c,adware,234540,985,1802,1909,2894,1802
883,de9369a98956b9bfa261246689ada1cfd75f6473c2e50af6d7f6741c81076e91,adware,614096,2418,4818,4922,7340,4818
884,de96422d00c2ee2fecfbd0e5c70089043e4d40069c32721b0b70585547ea3429,adware,234933,951,1823,1888,2839,1823
885,dea88f2435ce5ba02589c6b19ebe4b3e79d564efc0766b58a51031a9bb97b77d,adware,192695,793,1513,1592,2385,1513
886,def8d97b05803ec16529e379865bb0c111761c46169e5e1a56d727f99b6466c8,adware,232508,960,1832,1905,2865,1832
887,e00f2586a5b44167641fe1db46135bdc5c54f0406217f434bbda72c3453b8490,adware,222293,932,1833,1866,2798,1833
888,e02735a1ea733d1b5c5041e049c59af57f321c945d5e6c068d6c53e27e8d1465,adware,235188,947,1859,1919,2866,1859
889,e04cf084f1a8f217bff68f5e9137f2f49c0100ff538d3e4c509314180b946ff8,adware,611530,2575,4803,5090,7665,4803
890,e1873660763dc861afe9285f9eebfe3767af1903fb7ce989caef9b8dbb33d6c3,adware,221197,841,1805,1820,2661,1805
891,e1a154d181b462f3e01d59b915a327bdea54133b0cb9fec57dc7e5fe740912cd,adware,221321,899,1752,1798,2697,1752
892,e20085337c27f3cb697ea5ccfee9eb7993a6ac614eb7397609ac5b3991455574,adware,235914,942,1785,1920,2862,1785
893,e2f867e96663b9d6af9d879a84ae18c7766090debd69341e28f9d191884e3965,adware,198537,755,1563,1569,2324,1563
894,e3189abc07461106f319ff80be57a672d682f7a37ea70647ed5c36d3d124b95e,adware,207324,835,1706,1763,2598,1706
895,e37406dd23819419dd57a590f29336b4176041e413db642f161f34d4e757b374,adware,1184972,4738,9490,9071,13809,9490
896,e3de9b454c2b9fec4aa36ab3a0bd6efe2e7af19ed741951856c289c6025a001e,adware,221674,870,1701,1791,2661,1701
897,e42fb6f446fddac53863fd941ab6488136499f72787fea448f4681aed4c00556,adware,376434,1648,3053,3205,4853,3053
898,e44a8e3f111403647b60ee3bd86a1cd7bc539ce524706564b471acff04201540,adware,206577,821,1661,1728,2549,1661
899,e45947e3985246f6d450f5f69e1312929b39ac1f36aa358c2748849141a0d461,adware,441741,1830,3436,3484,5314,3436
900,e46a793e07149a1a598a62ff9a27f0904ac47bbb0c23e3cc400f98fa8b23ffd7,adware,309525,1345,2394,2475,3820,2394
901,e4d3fa5408f801a6820392edaa0fa5e5ee562ca166805b9fee247f9a78e05626,adware,533195,2154,4259,4326,6480,4259
902,e513cc7d48932044031cc97513575017557b3c09c5db7bd2cf33e34f71bb5442,adware,221865,866,1726,1861,2727,1726
903,e540b6081b4dbbb529120944db43849fec167a79b4a59e9cb7da3427e618c9ea,adware,553473,2420,4387,4598,7018,4387
904,e58472c79d262fcb70c7239db95b9a99ef8d56f5b760826030d544522b1d94c4,adware,233352,985,1882,1921,2906,1882
905,e59b666943fcb347bc88f38311b46dc2b9ebb7f8938823eea9d0ca82f28491f3,adware,232427,922,1848,1898,2820,1848
906,e6c79fdc8a2958af832a7a14b6fdacef4b13da4d23799ccb877ce6bfba5891da,adware,222215,956,1755,1804,2760,1755
907,e6e318ad412fe858f3599f743c6201c42c3fd65311f476dd040acf6b460d0c74,adware,198762,832,1536,1566,2398,1536
908,e6e5d88b6eb9ee4b3ec16e381de5584ef2f51ab960b13b88e26941a4637c3035,adware,223567,827,1712,1840,2667,1712
909,e6fec1a921669271f416cf881581552720b56ebdf967fde1888b80b20d9dc501,adware,27411,94,214,242,336,214
910,e777031819207e4ebe1b60424e53eb2f288de17f98b56817ed64ed7b66dc3a6f,adware,224687,837,1798,1799,2636,1798
911,e7ac176c746d9f6c1dcc2a2b30ac72f1fb16be73e3aa0692bd49862fc2f38d1c,adware,221049,879,1824,1755,2634,1824
912,e7f633d6655c14240db3495995f10b3818af39bae7244570533b98d59e196e82,adware,978859,3900,7756,7718,11618,7756
913,e86744a42775d90194ab64bda15fe264b3991e0e0281499ae3c96e37ccce6c5e,adware,232835,927,1783,1969,2896,1783
914,e8a550b790c1f721ba74344433ebc89e769f67b100778e66e85690514a697299,adware,235366,1046,1861,1948,2994,1861
915,e9141c3bd1cdb851227af259f234473485b1238e63a8df9902f7ab88fbbfc880,adware,235495,1000,1794,1983,2983,1794
916,e984550e40a60c714204d11c947f667f53873e61425e3918f5826d860eb36085,adware,206937,814,1682,1697,2511,1682
917,e9876b123062f289159802b1249583f4acc2f0f87490d2256cadb59eef5cca03,adware,234978,952,1783,1960,2912,1783
918,e99bbf60a1623b7a15a8b900d798e14856ea0a897a857d76c9efd67fdfe6ac70,adware,316889,1320,2543,2502,3822,2543
919,e9be1bd5f29756b8ca2b37467fdbc16f106f102210016758ff4b4c58095a4c7d,adware,308362,1325,2416,2566,3891,2416
920,e9f6e1faa6c6ddd4a62edafa4818b0ec90d4711ca3c04fa45c0bf3723b664f87,adware,234940,980,1833,1993,2973,1833
921,ea13c6dd71048e658c10b2d28654e64eb5fcb4cf38bd468cf07ce625ff034243,adware,605439,2413,4868,4994,7407,4868
922,ea2421306cf1e53dfc7aaf10a9df135a2569478c42238e264649eab8a0cfa06c,adware,830541,3467,6610,6616,10083,6610
923,eb41c4cacad6222439a03e30bd10f062ad20924a47da8b0437b867f3caed93d9,adware,1008813,4095,7993,8354,12449,7993
924,eb55b0a834b47d84bde099a2f8dbe97c25cced3a86222ff13e792499bfbc82f7,adware,222239,850,1795,1759,2609,1795
925,ebd967d0638c92c4b48e3b229e2bd28e05c7f38809b31c8ff7444dcf33409410,adware,206715,780,1701,1680,2460,1701
926,ebe5d470569948e3815da261279604e6d4cc1fc0f305c01a6dfc78a602f594d3,adware,27367,100,232,239,339,232
927,ec2d9d2f643a31f795fe6d0b6605c95de44f73ceebd929e033b4217b9e9f5e42,adware,198494,741,1570,1703,2444,1570
928,ec65e1517fa18a4a417c27c6e88a355e004f4254bed70353776699ca9e2a82a8,adware,235272,984,1930,1964,2948,1930
929,eca5d97b9f0eee304d86a19007caf3c1ab728f83623b05a48ead857c18e87fa2,adware,192881,803,1519,1571,2374,1519
930,ecfed6ffbb7f4f14ae24d768f86e8fd1c549ebe3d03625ec48f83cd78b3fdde0,adware,198514,779,1601,1596,2375,1601
931,ed466c967ab159d696dc736e0c9bb00bac6e76246398f3c40b4b0e55eb010f2e,adware,280320,1013,2236,2229,3242,2236
932,ed778e9c69d4bcc6fbe3d1430ed3c9c1f79f8945e382283807aa49a8e6a02013,adware,293537,1237,2280,2447,3684,2280
933,ed89e561e730f24fc3b469e0374dfce8b1837ff7778ae3418209d8ec483991d4,adware,198483,786,1599,1596,2382,1599
934,edcdda735c28f73834055405e0df4d4dbf02d389434c38b14f5f5a887fea0bbc,adware,611493,2554,4720,4905,7459,4720
935,ee610665bddd7ccf8c0858a8458132da06b1ed62b3542181cce03325b004fff5,adware,655859,2692,5232,5266,7958,5232
936,ee94c7061b802de1a389e9a21b826b0d77992171aa3397a201150a091c2c50d4,adware,731199,3029,5699,5802,8831,5699
937,ee9b2260a59199d22725b419a407ff2b4dbf3b8384b1721bd342f089ba5762d2,adware,205759,951,1658,1673,2624,1658
938,ef712681d2e3a9219f02c31aa47317985eb2c70bda44083e820c3b5253d75bf5,adware,195301,768,1580,1494,2262,1580
939,efadb2f29eddc1920dd4ff4a571a13ad013216e9162d0c812825542ec385a872,adware,235844,987,1847,1959,2946,1847
940,f042ff63e633b0601c73f289298b37381de793627f0c02937f1f6447aa8220a7,adware,235190,1008,1862,1912,2920,1862
941,f13405cc1551fc1e957a25c90511fbea1a4f6111726c6fb7d27b329551d54634,adware,198543,808,1586,1619,2427,1586
942,f18460363632a87d822c54552f63a8fc28ef6f0d52b052da3ff51f9bc342e601,adware,609667,2419,4834,4914,7333,4834
943,f1eaf0e8cb88709d394b572386344f49701b279dec6301578136b1a61112ea02,adware,968476,3870,7680,7771,11641,7680
944,f22ed8818a19df041f2f30f41cfe506beeb32bcf5676d98b1ac35fe256dce9ad,adware,220583,813,1723,1778,2591,1723
945,f2d26acb09504d86902668cb76f94acd7b01bdc969a0e971858c516c431eb130,adware,206432,861,1607,1688,2549,1607
946,f2e0438921c44d6456cdab5901b16af83f89c6e38547c24d658eceb7a9b6a2cc,adware,234670,946,1862,1963,2909,1862
947,f2f186cbbc92d094b5ffd8139a45585721843a13e9c985902261e4cd7bd1b395,adware,506611,2125,3996,3956,6081,3996
948,f3115fd3563ade413ad518445791ace15890c6c319b77a75b80eac0529e219e9,adware,207915,784,1669,1684,2468,1669
949,f318e2252e23ec8d22f35b4a4581cf167971f1cbc8f12aa40a43aba45391e5de,adware,215949,798,1684,1713,2511,1684
950,f34fbce2b6a1491c933e5744b399378eb9fd0924ef44bba1c68a7c5bdeee4485,adware,234014,930,1852,1910,2840,1852
951,f48db6eb0c298bb87495287f8760d1a1fc6e35120d29842924654a21e81e6955,adware,234997,954,1838,1941,2895,1838
952,f4ebe7868764b5f8c209afb24fb10cbdf817d2c5eb40de703acae670a60fc731,adware,502058,2103,3967,3947,6050,3967
953,f5272c004cd555d1badae61cd8e80145ebd4697f268a61a212c94729ad0d43fe,adware,235358,1021,1861,1912,2933,1861
954,f52a2af2a88b1e486dca63bf2689c32a5590219da39beafb15cb1e843a9c748b,adware,629051,2529,5060,5014,7543,5060
955,f54f2cd9a8b204857af2ae291f2bc817292db098f79141af333681db483c61dd,adware,216395,856,1711,1701,2557,1711
956,f5779c66fac9c93acf8c2149e8d80705b4fc8b3019d81a35f372c941a0f99eeb,adware,235908,946,1896,1855,2801,1896
957,f57d822de6a232b00f26102f6d541b5cbe770ae35674c12527951117dab302eb,adware,198349,793,1565,1600,2393,1565
958,f5b1b7b398d02a680204c8ed90a7be25ff16f12363f453b1b5a0188d39394173,adware,223603,842,1692,1956,2798,1692
959,f616bbeff4c601b9187eb825453555bdd44bb06c3c3d3318dc9c4cb2d724e9aa,adware,469340,2040,3743,3771,5811,3743
960,f652cdc65c992b51123d34d51906feb209037584438dcad2a3db4198a5f8db26,adware,564263,2448,4493,4474,6922,4493
961,f677a95001f7d87566a76b24e482cd17529e00747f3a0d9f672519f5023fde83,adware,215583,882,1699,1765,2647,1699
962,f69c187d687c1929dd68e4e38039a41271a036525be45e54eec87cf0923f62cc,adware,690042,2964,5430,5498,8462,5430
963,f6c8d283b6f7cf106194a9e66c3b2558569d7ca239ee0ba445bcce2beef7eb4a,adware,358021,1510,2850,2992,4502,2850
964,f6ccfe97c8e109798cd707ec5c15e3dd505b7a3203ceef9a5075f31c0608b0c0,adware,222827,903,1850,1777,2680,1850
965,f71ec22fff25f7cdb6c09f38a373fc838cd01db8f2c58597cf164e9165a95d9d,adware,198131,776,1606,1573,2349,1606
966,f7a0a1a374a8ccd48e4c5d6b78f0a3a7a08fcce72a4a5cb82971238adfe5c410,adware,741175,3065,5933,5861,8926,5933
967,f7b0b39ab6366ea2208783a3513c31fb58c712437fe54b4dca15a082d2ad487d,adware,198325,773,1598,1590,2363,1598
968,f8321436d94f33e78e67c2bed405a9a9b59fd9434ab0a06db6996d6d714752ae,adware,222135,916,1774,1744,2660,1774
969,f853039b84053559dbc9f89794fe1ac43b3f89c298750b84052e18e8552a23a6,adware,233389,953,1852,1893,2846,1852
970,f863eb6c2b11c9786cd7c7e15e79d97d3662bc7c8c2ca8f3219534d368978ae1,adware,198786,733,1566,1648,2381,1566
971,f86b8168941147c36d8d4919943479123dd0a3526aaaa47c70b2207975630912,adware,233147,898,1864,1892,2790,1864
972,f9302b35217ea8351ea633f557e27b4f3ac0e6292358f00b08ed8e24da880335,adware,735484,2982,5733,5837,8819,5733
973,f937eb55bcc59bbde7899e397cc19a7ef3d2f67ec3bf27470df4a424a6e58091,adware,198218,768,1528,1697,2465,1528
974,f97dc86f031d92c1f68a395a6b3272b1b6cfcadfe526c3fc4003a651a95d6b78,adware,216684,873,1713,1693,2566,1713
975,f98d16e0da8a72ae789421ea008604dac0ed96b4e88f726d07c9ead4cb24651f,adware,465386,1969,3671,3714,5683,3671
976,fa0ffb2cbf154cf1c0f0a6410afcb30be94c65dc5f6efdcd27f3edc3e1f630e2,adware,198564,767,1604,1613,2380,1604
977,faeeba393a564fec8dd04939b49a5a5bceeb12f505875c2fafe2e6ff5a9701cd,adware,214789,920,1656,1842,2762,1656
978,faef45e3406bc9359e94961de9460ad99469d89aa7f2c3dfc4858f0884745ca8,adware,214721,845,1739,1693,2538,1739
979,fb8c9c535eb8deae472d20ab9d578c993541a2a4ffd0ce56ee739fd2e5bbbd01,adware,222354,906,1751,1879,2785,1751
980,fba7c79d23901e62ea827d45e0d98b0a1e65c9b1277f8ec9573f018eb4e67fa6,adware,234821,937,1858,1931,2868,1858
981,fbb446292d62a0d04730126704b97d700907f6e641b52101823b4d51d71c7dcf,adware,223422,832,1764,1832,2664,1764
982,fbce784829ec471638f28595e7cfcc2146213a11e83df5086eb0350eeb92312c,adware,634189,2534,4922,5008,7542,4922
983,fbed631627c1ea5e49a2b1dd09a99417a0b2aa563fe58a3e68606d92e039f7c3,adware,192894,782,1462,1605,2387,1462
984,fc5739d6525acecba3c3e2b71210feaf1b0de86b2d53b9db53f469fb4285316c,adware,235638,988,1797,1924,2912,1797
985,fc75126362eaba2d235cf30fdd47dc27377f3a7e8b63aab79dc532e17b9561da,adware,233948,1019,1838,1944,2963,1838
986,fcbb77ef8df33123a8429f49a0f07a697dd2dc8d976c1e2d5e51a3aba97c472d,adware,224285,887,1744,1757,2644,1744
987,fcc285b973116721b39f6079ddf25133f79a7370c105ba33240242cdffb25298,adware,232642,959,1878,1867,2826,1878
988,fcec045d9ba4d5c4c79ee8334498c628663bd633c20ce078b1e2d030b6be9f2e,adware,504863,2073,3956,4166,6239,3956
989,fd48fa085b1c8d781adfa796a916b4ecb73d50ed5771c626b03670cebc930d5d,adware,207258,819,1630,1726,2545,1630
990,fe07288b3a84212811ece91b4157c28efc164b9e98878cfe70617e606b3206d7,adware,198832,772,1604,1640,2412,1604
991,fe0f1f933189ecf398c7fef1ce827057268be73ca9d26122a8d9f55856f5d244,adware,507047,2038,3961,4036,6074,3961
992,fe28caa0bc1fe0e2fea14df38ecdf60da2ade8ee3543b81dfd3e580aefc17045,adware,234251,889,1802,1975,2864,1802
993,fedbe0e9062e97b2e173b70bcef96ce819237ca489a0ea341aafda53a9f9a217,adware,222076,885,1755,1722,2607,1755
994,ff152235c561cf719ad84adacbe834864d7579d3542ad3b2971527f77757932c,adware,1185697,4729,9265,9539,14268,9265
995,ff3f5664c7e0efc0a347150734621188707a58bf0cb790d6c4ea9b60555d49c2,adware,198272,717,1561,1659,2376,1561
996,ff5696d93f433ef0344dd2bd182463a761afee734ca3563c31038ac0ec89f161,adware,234337,914,1899,1983,2897,1899
997,0080573f758273e1dd11f7fea116e10576204abef2b288a926fc1e2f5c233ed3,crypto_miner,1255771,4989,10150,10289,15278,10150
998,00e060892160c3a08dcc3665fbbc2b2a722b78f6ac7d5d3d4f49481bd7746d5a,crypto_miner,1250777,5196,10159,10487,15683,10159
999,016f4fec9b9f7e04727c61d3bd14e533acf8bef4874f5b6b3621c7374199a3e5,crypto_miner,1255769,4995,10136,10298,15293,10136
1000,01b8b754363f3f1b739c3effad313098afc6b306112989609e2685fc84afbec5,crypto_miner,1250769,5190,10177,10465,15655,10177
1001,01dbbe89a8e5af15ae0468cb8b9d3e9f1a3e9ff4913202ffdc922d382ed30681,crypto_miner,1255770,5007,10136,10296,15303,10136
1002,02411581d90b772d5f260bbc21784a45de6c01be96b68902a072d6af1755c02d,crypto_miner,1250767,5192,10178,10458,15650,10178
1003,02a30e760da6f274168ef0213b92ac9757eb948ea2e544f491aaa309ec553570,crypto_miner,1255769,5004,10146,10277,15281,10146
1004,0320760aa04ea45205b282badbe618ddcc1145ad60bc09d545bb87ea4f7b7699,crypto_miner,653073,2581,4997,5349,7930,4997
1005,032be9b1e0e65cef452a4d7b8096464ada8b9d392d43ebc3ba7d0e9c3121b413,crypto_miner,653040,2518,4993,5360,7878,4993
1006,0491b58de4f816554a4a13fe26ca8abb8d00308938e5ec0bc13e7647db738310,crypto_miner,653061,2598,5006,5275,7873,5006
1007,0529e2c437b78b8e119e0756fd87a117f2a63fab0badf3d5371f27c54b4a1791,crypto_miner,653067,2593,5056,5323,7916,5056
1008,057476e804f47b3704604722222dcd3e979e633fc82d15f944d47c54e7198a69,crypto_miner,1255774,5008,10162,10266,15274,10162
1009,062f3e704af107e3adae1a8c04843c3147fdc9f3273408387b8d300ff0322886,crypto_miner,1255771,4997,10145,10255,15252,10145
1010,06b886c4e726434fa4d03791754255665e3aabbc2392e7b76454dab13a788eb1,crypto_miner,1255772,4995,10155,10295,15290,10155
1011,06c6525e0ff1cb949f359571bab971e6646b6f0d94d3f6a814f050c2b92f4126,crypto_miner,1255770,4992,10160,10271,15263,10160
1012,06d675493d453e58a74382a6d0f60feedd909bee72808ad0353bdec15426dc01,crypto_miner,1255772,5010,10167,10305,15315,10167
1013,0704906ec06edfaaacf44ec5651101969e3edee509d1b7f63fd4f59f4d3cd4e2,crypto_miner,1255767,4992,10162,10288,15280,10162
1014,081c98be1f44b018c1d10fc293dca63838a0250273bbc3e7c23e61a1e943cd52,crypto_miner,1250769,5195,10149,10478,15673,10149
1015,085de865e9171ceeec5b17269243d472b91b649c517c01a56ea8fa27fab57c8b,crypto_miner,1255773,5000,10154,10279,15279,10154
1016,087bd14f50be2664292bc8f92dff10830dcffb10ca78a01ef2a8714ca842fc01,crypto_miner,653044,2648,4974,5238,7886,4974
1017,094fa02050923d54e743efc5bb923cf95d46224f46bdb34db022b0eb34106699,crypto_miner,653046,2537,5021,5413,7950,5021
1018,09b0755e8b26471f1c53c433c276e8a56cf956f8b811be6eb6f862fe31466069,crypto_miner,653069,2511,5084,5255,7766,5084
1019,0aba01e1dc0c6d1435c22089cfe3bd1cd6ec7d1cea73d34fb871b6c4e8135be1,crypto_miner,1403260,5477,11038,11583,17060,11038
1020,0b04aa352fdec1e601df6ffcbb08ccc7587c73fba5ada448a6b219b0a74f82c9,crypto_miner,1255769,4980,10157,10273,15253,10157
1021,0bf59e174e1d117d44e945e4262364b46b22372c3043aa5b40d479caf651f1d1,crypto_miner,1255772,4999,10141,10283,15282,10141
1022,0c0a2112559ff9e8db92b36d648655f7d7ae0bd3ac4c32edece7cbb16aece21d,crypto_miner,1255770,4985,10174,10247,15232,10174
1023,0c2cd9103254728e3519ac9d23471002e5a7230426c4ba6e7a51bf74d6fcc734,crypto_miner,653080,2564,4982,5327,7891,4982
1024,0c69d2744eb1283e06a3e8b1aae9f02a767edce0f1e6110952bdf1ec4709c7fe,crypto_miner,1255772,5002,10146,10287,15289,10146
1025,0cbfbeed4ff48c765e4d76d8e84a81043f108cc467a198a84064c80ace6a1e10,crypto_miner,1250770,5185,10163,10452,15637,10163
1026,0d1c7a92b20651fdc8782d692f0f7ff9f1d7cd2197a967bf3d8d5435feb8afb3,crypto_miner,653070,2516,5076,5307,7823,5076
1027,0d7125683c072fd2f0bb390b13cc1c487f481b2114f5b54f86b7aaad4e5d2f73,crypto_miner,653109,2557,5032,5349,7906,5032
1028,0e18f8148fe025d6e8ee6959298b615db777df26fa61455751b46dfa71453887,crypto_miner,1255770,4990,10163,10278,15268,10163
1029,0e2c9fe27e45168d32515e30deefb1877855a91855b27ecf7b44b415cb39b849,crypto_miner,1250771,5198,10183,10450,15648,10183
1030,0ebd82a9d6028b91310f2cbb66850e0b1aef956ef8c2b414e843b91b3a0f482b,crypto_miner,1777977,7291,14258,14326,21617,14258
1031,0f23d6ec1ce91e747762abfc07ef5d2ce1f8a9a24c150e84497c114aca36b187,crypto_miner,653091,2503,5073,5367,7870,5073
1032,0f307c8fca1455deca4295150920a6f8b66ff69a686bd93fca3aaa054dd0f8d5,crypto_miner,1250774,5199,10159,10471,15670,10159
1033,0f45b32bcc9a3195f92b2329aaebe3c11b59cdd5b60e2d21ad6be0d1b33a96b4,crypto_miner,1602858,6414,12486,12945,19359,12486
1034,0f8dd7b38e8703934ac421d1d1746ceafa3b09f2af348bb0b91b0bff7ff054a8,crypto_miner,624093,2450,4872,4967,7417,4872
1035,0fdd2c843bcdec0923a6ebef34e05e2a50af6fcef2f6b5344292f4e2dd1cdcb5,crypto_miner,1255768,5001,10156,10281,15282,10156
1036,1001c176434c3a79eb3ddadb041591af5bb37f41f3fbb74b0c9673fccc9f93b3,crypto_miner,653062,2573,5135,5254,7827,5135
1037,10282a38df0b0679a35b71b597075b460f9d11fde1b915b0e846393aa3a8ded1,crypto_miner,1255773,4982,10141,10295,15277,10141
1038,103a2e2733be6e6b16cafa0130b5b5c5c56a3f2025510e3a800d6145637409ce,crypto_miner,630085,2422,4922,4851,7273,4922
1039,10740d66732f7cc48b619db2c26756e0238b6ab5e85cd6901906635ecc30af13,crypto_miner,412169,1705,3215,3228,4933,3215
1040,10aa192f3f46e1f98a690d6ccd129893c2299d43f0be4c8abeede6f321a7ee81,crypto_miner,1250776,5202,10159,10461,15663,10159
1041,10b5207fb73c7ecc324abbd4e74771da3fb8fd30627f8f73fef5f21324d1d756,crypto_miner,1255769,5007,10156,10270,15277,10156
1042,10ca6270353dae341156eda9fa17f95626a7f4369cd5991b13b933c9019b3a46,crypto_miner,1250161,5413,10286,10607,16020,10286
1043,10f9dbd459b02063f3d057822dd67fc07e7e28b59cebd90327772ca6e55c9b7e,crypto_miner,908160,3650,7191,7162,10812,7191
1044,112b5e21f34b0c87280b2713821881c0bc4e3629c7d0f8a321ef6119705d3f88,crypto_miner,428185,1850,3454,3417,5267,3454
1045,1136243fd46d9776b7fddced6f629db991b6c2de3fc06a8f823ea073ddb6b93d,crypto_miner,1250165,5402,10296,10604,16006,10296
1046,11a423f62697443bcbff953cab85481e4bb6203776dea66395128b292ac6b43d,crypto_miner,1255772,4996,10154,10281,15277,10154
1047,11c7dc699956999cf89728c913b27ca1f8539bcbee258cf6ed677f816361034d,crypto_miner,344919,1471,2867,2769,4240,2867
1048,121c9683e16c98683a70b5ca5dd7edcd01ab716e5cee9d209982934db9b1e259,crypto_miner,1255774,4990,10184,10266,15256,10184
1049,12238f41bc684db5c764c208473a1a560738d727cb85c5aaf97b658b4ea8398f,crypto_miner,653105,2564,5101,5367,7931,5101
1050,122ab88c4daeb7eee5de36465a0414e79cbb7ae9b8faed98c206eb8dd86a3eab,crypto_miner,649652,2627,5154,5051,7678,5154
1051,126761ae4d8d01d0fa4db504a8606c5c491b2d0c39df2f1bf4171181c7004d2e,crypto_miner,653096,2580,5027,5292,7872,5027
1052,127d639ae8a399fae7bc34c8bc76e31b838c6e4c1bd721b9e2e4c462506fa4d8,crypto_miner,1255772,4987,10168,10261,15248,10168
1053,12c10aa8e2a1452999ae9d446ddb013ec3b59e0f548b4dbba31a9ba8df4cd273,crypto_miner,1255770,5005,10149,10271,15276,10149
1054,12c35d9679ea71afc33105bf0f3ab3b20e84ffb8359b1345f264315c5453423d,crypto_miner,1255767,4983,10156,10260,15243,10156
1055,134cc5b9d802783d316eed06c687b3f5852a2c725b18a98ab7e6df9c124358b1,crypto_miner,1405649,5315,11222,11431,16746,11222
1056,1385c7286a7d731a8fb49d5a39d96282a0f9b374a0ca952be21d6bdeb4959f19,crypto_miner,1255769,4991,10148,10280,15271,10148
1057,139f60a517d4dd6ee4d47acdeee21e77bd401d9fea38f8bb0d96ef9085ae42d1,crypto_miner,4079161,15992,31810,32320,48312,31810
1058,142ca7ef403ca7856fe03e41ca671f4e2ca4da0ee4c4cdae786d0230cffb1c16,crypto_miner,1255773,4989,10171,10284,15273,10171
1059,1480df8247a5c518ddd9bdb3401fe50344c97753bcfb795bce7ec64418ece7d3,crypto_miner,1250768,5195,10187,10467,15662,10187
1060,148a64cf58a8770c896917d68b9d0678f9151d38f38688a8e62af991e1ac5eee,crypto_miner,321654,1258,2612,2627,3885,2612
1061,148a84976b21d33b7b52b4b83ab348ea6aca44bdde25b01f32074e699e847f82,crypto_miner,653110,2522,5044,5481,8003,5044
1062,14eb413fdd5b01654254b28a12678baaca822023b2aa77338cf4633fd9a99b80,crypto_miner,1255420,4999,10138,10276,15275,10138
1063,15b3f627d6ca5778a1423ecff5cb67beb997730ea14954f2a99b3b0ee2f8dbda,crypto_miner,1255769,5000,10157,10294,15294,10157
1064,160ecaa45630ff913478a0b1238128a14d2f7b005178f03a52ab379a0369d7e7,crypto_miner,1255767,5008,10166,10278,15286,10166
1065,1667475daf00fa6af6bf04bab7a10bd486633697a2ccb1217b7dcedc8ee1480b,crypto_miner,1774525,7153,14242,14159,21312,14242
1066,169d75568bc067f3071824e326cf2a43fb8d96247528b8923b7b7fe1c2571502,crypto_miner,1255769,5011,10142,10273,15284,10142
1067,16d9ced74f50f4adb2fcbaafe7ed00e4d7e8c3e28b2ea11327cf92a20d1013e1,crypto_miner,649626,2647,5036,5156,7803,5036
1068,1770c3b6f0265ebef4d0fabf0893ec5c499901df0aba3df451998bb5d8ea2680,crypto_miner,1255769,4996,10170,10274,15270,10170
1069,178b5f097daf31e1c17629dd2176d3679ae554f8a5b45beacaf6512196482f0d,crypto_miner,1255773,4995,10160,10265,15260,10160
1070,17e8222a69fd6ec22c5bfa2852e02166397c34c1b892a29a86c042a760a57d05,crypto_miner,4334597,17071,33704,34432,51503,33704
1071,17ff4570a03e11ba9dd95dd34143baf311d978fce561af17bb25121147d81920,crypto_miner,3590430,14244,28187,28940,43184,28187
1072,18534a42f16fec9b4589c0e9ba9f60eafca9171830f44ada63fe707056e61bd4,crypto_miner,652968,2634,5014,5306,7940,5014
1073,189c050731632fb90d1277891250f346759b34b0e14703229e37f6d81b6f174d,crypto_miner,1255767,4990,10150,10273,15263,10150
1074,18c9dbf17fe5123cbbc39aaa30d10bc30a0559169ff759dcd9cf17abc7b59aff,crypto_miner,1255772,5008,10151,10271,15279,10151
1075,199a72198645a87cc9484b71317fcf99712a2963f1b8da67c6e3223156729e5f,crypto_miner,649610,2708,5118,5296,8004,5118
1076,19e83d668a70efca03c4551a489bca325632f676b718367482cf59ba5209ed39,crypto_miner,1255770,5007,10158,10281,15288,10158
1077,1aad9c4fcf42cb7ee54f3f0d5d3348ba3801cce9313bb8221bc02ca893dc81bb,crypto_miner,1255770,4984,10166,10294,15278,10166
1078,1abca62045a5943d3c2ae02c636aea6668d160cc1e214100b3ba5f233bf43207,crypto_miner,1255774,4997,10171,10293,15290,10171
1079,1b6387e91997632de7aa49279f93a653e2f778800e63f5051fa77c7bc1bd0aea,crypto_miner,1255771,5020,10176,10263,15283,10176
1080,1b65ad718d46b903c17df8c5be48403c49aeaa7aa109b754d14c9e45d0726b7f,crypto_miner,1250773,5193,10175,10457,15650,10175
1081,1c1e131e4c44b8be0ba9784f4014a537e46f1923eacec5bbe2b0b8f0dc423d80,crypto_miner,1255772,4991,10147,10296,15287,10147
1082,1c64d3a942c7435c8dc456dfcccb451b8568e980b2417b97e3eed5c5499c3499,crypto_miner,624200,2511,4835,4944,7455,4835
1083,1cc9cd1de9c78e3f0d86472c8dc59d4a162e2b1bfdc19f20a0f87b0ae59d9240,crypto_miner,653070,2547,5070,5327,7874,5070
1084,1cf30ee31cce6743035e025818404f365ef671f803ee0a658fcb667d6435e757,crypto_miner,1255773,4998,10162,10285,15283,10162
1085,1d3f1d58bbacf9cb908ac5c37840692296b67a6554b3e4235a9ce113b92e891d,crypto_miner,653038,2570,5018,5480,8050,5018
1086,1d89e6c205d81e710244757688738b97eaedbd982134b5c397e1359b3ebaebbb,crypto_miner,653046,2533,5019,5312,7845,5019
1087,1e7a3b48756d943052a9f9602e78c435d6702d8322896c6669bc3e3e0bce2fa8,crypto_miner,439029,1931,3446,3537,5468,3446
1088,1e926061ad8607ed6faf337f0133ed071aa64b1ebb4dfb30498be2172bf5e540,crypto_miner,1255767,5007,10163,10283,15290,10163
1089,1ec2d87ce1de2a01689a2fda20c16985f4f1f7d92b670fceed76081d3c0753f9,crypto_miner,1255770,4998,10147,10269,15267,10147
1090,1f2009a876930d193cdad1f534deb74a34c67296761b843ec01326b8c367d259,crypto_miner,1255771,4989,10152,10325,15314,10152
1091,1f203a1f105b7e0080fe7336dbea230bbcec65f20d0ce429d7306b90a2b07bd9,crypto_miner,1255771,4992,10175,10276,15268,10175
1092,1f7ace389009b0cb13d048bedbbecccdd3ddd723892fd2e2f6f3032d999224dc,crypto_miner,1544245,6016,12296,12546,18562,12296
1093,1f8ddd7f9f1993149e1892c49a58df98782483b269d22b9fce29f40a60ef15b7,crypto_miner,1250773,5199,10154,10459,15658,10154
1094,1fc7f0158ffdcedfd75bc0ba3c6be27e6d44f1eb6ffdd5ef01f0d4cab8020eb4,crypto_miner,1255769,4991,10148,10274,15265,10148
1095,20170ea465d3b2e29f12e8d0a66d2f972a50a5a35bc691e093356a6dd2adab2d,crypto_miner,1255671,5012,10168,10266,15278,10168
1096,2024ca7890ba3326238d3f3a341f561b72784ad9bccee6fb0765a2b7c0446e17,crypto_miner,1255771,4990,10148,10296,15286,10148
1097,20cb3195595c92ef2d530ca375cfa165be32b4cddbc447800c574cb10b95966b,crypto_miner,1255771,5003,10168,10288,15291,10168
1098,21032e099de5eeb351e7b077a1fd72ae4645a0a93371350aa84e315c255205ba,crypto_miner,1255770,4998,10144,10295,15293,10144
1099,21054468cd343b51f63259885e7333b0259bc138bea3b91f4731ce1f2bdd257d,crypto_miner,1255767,4993,10159,10271,15264,10159
1100,21102705f2b1182338898946635c058fdeed70ecd2cdbf505970406c55413bff,crypto_miner,1250782,5199,10174,10454,15653,10174
1101,212dab4c05b302c6d520ab83c640d73e42f62196249a554fe17df96cb33ed4b9,crypto_miner,1255770,4988,10157,10273,15261,10157
1102,213df9c3c15642cf4777dc48a403605c07a9134d86dd20a2ef04d0dd34c34025,crypto_miner,306394,1312,2425,2619,3931,2425
1103,214ef98f76b80a2ee3eef32c56d79d985ddcec8dd556f8f433fbb22f05643979,crypto_miner,652764,2481,5072,5369,7850,5072
1104,22e3e4acb889b320da958d64e13fad2f1f6956a58f8b3053a193c35f4cfc9ecd,crypto_miner,1242249,4965,9612,9941,14906,9612
1105,23d699df9f799f0b8529005e46ee690dc914176ed03d2a38d11f8c648849963a,crypto_miner,1255768,4990,10162,10286,15276,10162
1106,24f7a1c1b89b4feeaa6130e10b5444b80048a937aa6bf833b1a055c9e786661f,crypto_miner,624165,2434,4889,5152,7586,4889
1107,2522d70d569177829f0f74cd39b88278ae313d4a8a7094a2fefb24bd89befac4,crypto_miner,1255770,4987,10155,10277,15264,10155
1108,2588be2a8e12db896ee4cc090ffe7b44fbd8cc320dd3c1f9ef2603385fa5254e,crypto_miner,1255768,4992,10173,10278,15270,10173
1109,25dded986cd6f42d7d187d264d56c157959a63e71b84c71be7047eab6bc98139,crypto_miner,1255764,4999,10155,10282,15281,10155
1110,26150bc4d32b08cfc65253dadad1214ed7e5377593e53444aa6c405ab7c2d4c1,crypto_miner,1250773,5202,10153,10452,15654,10153
1111,263c720e6c17c1c9c8b2873de17cff1fabf4741883d8d62efddf956b4cd38ce2,crypto_miner,1255769,5010,10173,10285,15295,10173
1112,264047b6fc0290a2ea8bbe4ff6852d8f812291ac877355a29aed4c6463de6d24,crypto_miner,623554,2379,4781,5010,7389,4781
1113,266e25bbdb9f457b5866a59d64d8ce6097daebc9c7061ce509dc4a9a2618d164,crypto_miner,1255775,5007,10176,10268,15275,10176
1114,268264cac45d6526895f66237adb5aed7b2073585872d2bdbe7586f5f2a1ac39,crypto_miner,653065,2617,5203,5311,7928,5203
1115,26e3ce258decd5f9df6278d985366d051b424c6199d9da552d7c70ee9482fa57,crypto_miner,1255771,5000,10158,10288,15288,10158
1116,27040c8b4b0689668609d1493f51e9b3b2e74e4ca9bff95ba4f2d89f3f5b921c,crypto_miner,653057,2548,4953,5339,7887,4953
1117,2720fa7c3d48ef6db24ba25570e961b9a8f8fb6cab9815a30d1284c17c59db58,crypto_miner,1255766,4996,10136,10290,15286,10136
1118,27c4a0dc3c4bd67252d203a87a7520f65292a817036c7143788b57600ed95e88,crypto_miner,1250161,5409,10286,10599,16008,10286
1119,282e1ab220f6477849da2abe2679341dba7d2ebe5b18475c42c75fda635ba033,crypto_miner,1250769,5198,10181,10468,15666,10181
1120,284309d07f08261af19c937ece6d2031910d9124a7359c207ded65890b2d7c5f,crypto_miner,412250,1723,3355,3335,5058,3355
1121,28451982b2c7a654b4e97d6ef1c08d32b61a10a33d957e7c11ea19d49cc3c3d2,crypto_miner,1250736,5192,10158,10481,15673,10158
1122,28559b598d6e9188dd7cf3c21891a1e8a6aecbb2f9e012862f19cd6f1507a734,crypto_miner,1255768,4998,10160,10288,15286,10160
1123,286fdac65c87a9ef6f1a04ff3e6c552ee540b6e2188c57d5bef6b16ff9f58f3d,crypto_miner,306393,1314,2424,2619,3933,2424
1124,28ec6db0be40ad871aa690e9d16d4e5838d5fb3c2ded65a8d5502b6bd1fa4dbf,crypto_miner,1255768,4996,10157,10284,15280,10157
1125,29187a6ecedfbb7cc961f38332b1da94187003752e0647d9e802d5f8dd06e732,crypto_miner,1255765,4992,10153,10279,15271,10153
1126,295f60bd3f85a97286551fdda1c0b63beaeee9e4cc6b137240584b97d279e4b9,crypto_miner,1255773,4986,10167,10281,15267,10167
1127,296ba0bce2c774ae1f34fed49104f9b1225cc5cce00ff0fe92f8d19eb45d9401,crypto_miner,1255768,5005,10164,10297,15302,10164
1128,298c2c9865c762a720925357235a30e370c77f8593d0294610f0cde084150f96,crypto_miner,653069,2493,5178,5337,7830,5178
1129,29af15fbb81f42159c11155192ef9b55d2cae07299760d20551fff7193ac9c09,crypto_miner,1255768,4993,10135,10277,15270,10135
1130,2a6d28ee8fdaf9f491cd5fc64b91e4feddecfa4ce09f60efb24c553f6a2ea8ed,crypto_miner,1255776,5003,10140,10282,15285,10140
1131,2aa08cf930f39e89713020a2a016e738477f44b2dffaa171b5db0eeee0ba1e96,crypto_miner,653081,2603,5208,5286,7889,5208
1132,2aab76bce804e39ff0dd817f4c3120b75017ad57d8f32773a30d1e0d8f295d9b,crypto_miner,1255769,4994,10175,10285,15279,10175
1133,2b660c15fa12a6a7b57402262c4d88b21aaf19c816505d0932676503ad13d3f5,crypto_miner,1255767,4988,10179,10255,15243,10179
1134,2b82e22e0812df97b24f7efde6a891630026324fc6f3a6ebf3554335a0d718ac,crypto_miner,1255595,5011,10147,10261,15272,10147
1135,2ba342706af63406b07c4e3328ab591179821a30c1b4400953ceb374a64d6414,crypto_miner,653052,2641,5075,5277,7918,5075
1136,2bc7c7493b7aee80156e25d514cf61bd0f87ee37ef874afb14e2f8ea30e6df48,crypto_miner,1255771,4998,10168,10282,15280,10168
1137,2bc870a5bf99e4375ed4f853488e3cc959a552c5954af184c2ee46d1e3d5a96c,crypto_miner,3180791,12530,24966,24913,37443,24966
1138,2c782da417239481413765a1128277bcf5673a53b6b912743e991b7d1df86b71,crypto_miner,653065,2585,5150,5258,7843,5150
1139,2d55fad33ffdaca8563ab884522b043552c5a5a39f806b1c537bca696ebf64ce,crypto_miner,1255769,4987,10140,10268,15255,10140
1140,2d7e641c87e23a401b3600f68c75227805975cae84aeafbd282ab4712b5ebbec,crypto_miner,653044,2584,5048,5350,7934,5048
1141,2dd86d1b17320c9113423b635b93f4fdebc97d227ecfc9730513bdb48782bb0c,crypto_miner,652853,2593,5201,5304,7897,5201
1142,2e54e7f6cd34455c16c2639c46e2d902d09755eef3bd06c7970b76e0156466aa,crypto_miner,1250773,5178,10158,10462,15640,10158
1143,2e58ca03b1bf17dc0a46794f719506ede88c57fa6c719a29619568f2ea1e3ee8,crypto_miner,1255774,4992,10147,10274,15266,10147
1144,2e62e7c9846d39fd34e6b3f7a75d20a50858fae632f6c7e05a00f2b358eddd27,crypto_miner,653069,2573,5117,5337,7910,5117
1145,2ebcba1300cee72ad6a1137f070794c56c17f0d103d11cb1e62a99e5b847205d,crypto_miner,1255769,4980,10161,10257,15237,10161
1146,2f7f0b7847656840fb8e344a05a1c9af6a0d7d173eedd4740d2638a909fe2529,crypto_miner,243166,1025,1938,2131,3156,1938
1147,2fb928e9dbace935387d44cdb106a52950cad778c87240d8d6cb09010cc2513a,crypto_miner,463170,1967,3623,3727,5694,3623
1148,2fbf7c70151c8aa9deb87740d655c7c913070599dc228037d74092e2bcf56538,crypto_miner,425628,1792,3409,3395,5187,3409
1149,301451ff6bf92cf0519511585f48078cf1feeeb57b666c5ce574400126411d95,crypto_miner,1255771,4990,10178,10281,15271,10178
1150,30210b8b914d98ef7bc98a90685e89cdae1f1350d36894476e1fd611f5e0ba9e,crypto_miner,1255772,5008,10153,10237,15245,10153
1151,3040acbc12ffb33bcd4097d5684d70859c74daed653d582eede2acdfb2eea65b,crypto_miner,1255771,4995,10139,10274,15269,10139
1152,304b84993595160523e4cdacb52b4631ea7db9143c2f50112c6a6b112c71f61c,crypto_miner,653064,2623,5147,5416,8039,5147
1153,305943d3cb0da130ad0ed492c582819dca02c63d2a46eed6a755236298019238,crypto_miner,1250770,5191,10165,10459,15650,10165
1154,305e97913e484fc85822775b21290d88c6517842c62553f17fae59a8c1f5f91a,crypto_miner,653073,2463,5073,5192,7655,5073
1155,308b3435bf8577620ca852d603b615c0176d3ef528c5d8d1e1c58a302c30a0ad,crypto_miner,1255701,5007,10165,10284,15291,10165
1156,3096efa7715b1c016e97f27f389fe43041a0e479240c62f415756d389343790d,crypto_miner,653074,2588,5176,5215,7803,5176
1157,30a42d9700d736abd85532969dc2f5bc2e1fc1695d526cda9d5906c684c0d9c1,crypto_miner,1255769,5004,10169,10292,15296,10169
1158,30af5a9a4f6912fa7c42cd3427bd6360bd041409689dc2bb79a4753e537d645b,crypto_miner,624039,2454,4826,4980,7434,4826
1159,30cf0c33c447fdee24a287aa73685a0905a1a8ffb8d51083e5a1bd14f29a56d9,crypto_miner,1255771,4994,10150,10280,15274,10150
1160,30d296509ea08031ee908f3c7aebd46ccd1b0b1b92a80cbe1d904d84082f209a,crypto_miner,1250778,5204,10158,10467,15671,10158
1161,30d3f43a54ca5234b932590f28b7a25d77ceb4ece1544aa1c13f5443deff0f0d,crypto_miner,649627,2567,5094,5182,7749,5094
1162,310df49a1e33e9e407c0940d7e24fdcd355d4c957be26966fbb9c896f1ed1242,crypto_miner,1250773,5201,10168,10450,15651,10168
1163,31148e6be3433a06cd2884b85b1c1329a077134a8302803be941a07b35df525e,crypto_miner,1255771,4988,10171,10277,15265,10171
1164,318be38f5f71a697213f1ca49954b0b16a347909366e0f8d2d0289451c70e85b,crypto_miner,1255769,5000,10144,10279,15279,10144
1165,31d9715845399b93ef894287ad779c22095300fd02697180c689bb1af455e75f,crypto_miner,66117883,266834,526586,531952,798786,526586
1166,32baf1963755365e4521a59922544e526ee43d8c1c4d73583061143851fbaa1a,crypto_miner,4169733,16393,32521,32384,48777,32521
1167,32bc8ae73863784493bbfa91ee7549883b4cd7e3e70e379b804e887e5251ab50,crypto_miner,508106,2065,3948,4053,6118,3948
1168,32e67795b88dd1867d3fedfa1699eb7af0497cc55ee1d6ee91b50f08bb50bf24,crypto_miner,653072,2608,5154,5314,7922,5154
1169,33498d6148a2bccc82bb4922699a444376fba92a4015258b213345479d52c784,crypto_miner,1255770,4999,10164,10280,15279,10164
1170,335cf81e769e8e583526e159826b9053f464f45b8414ad97ddbc056617646bc5,crypto_miner,306202,1233,2512,2563,3796,2512
1171,335d32c2151c2adfdd4cfc4a396ef4ff50bf01aaafbf625785d7ad41c2f4f91d,crypto_miner,794576,3228,6294,6450,9678,6294
1172,3422dc3077431c6db281e350f4fdc9399480aa13b552256cb7bf809b82f95c07,crypto_miner,1255770,5004,10154,10259,15263,10154
1173,3466baf596f91ea2cc076439ece52145e164d831e22c9aacf70937aef25da2fb,crypto_miner,1255772,4994,10169,10291,15285,10169
1174,349bcc2ad387577c1ae1c80f68df19681f09e3c1d57a219da7eac8700ed95d91,crypto_miner,1255770,5011,10175,10270,15281,10175
1175,35198287ac517e3bb2feaf8da9c599bc944645f8b906038fbd02d00ebea17660,crypto_miner,652982,2698,5052,5383,8081,5052
1176,355a41fb136de23fa83db6791dc571c43cdb2602dbf4d1ed07312ec310a15095,crypto_miner,1250772,5210,10171,10455,15665,10171
1177,358ec480d5aff36776a0de5d44fff3003f2c662f74d69a40a6282779a50c6f40,crypto_miner,1255767,4990,10157,10292,15282,10157
1178,359b7aaf98352ce751bbba7925bb02955cffd6505df89128d04f5f89a202b913,crypto_miner,1255773,4993,10141,10288,15281,10141
1179,35c44dc246f7d1d7faa662c7d565d7d46b82697328cebf3548a7d9842f0735e0,crypto_miner,652765,2622,5162,5283,7905,5162
1180,35c761fff15e363befb9c8368828e8168197be5caf0d388fc3781886dde967aa,crypto_miner,1255768,4994,10166,10276,15270,10166
1181,35e7e445ca2fb924a254bffcc56276cdc4165541b69e2ad5036ea63a15906894,crypto_miner,1255773,5005,10159,10275,15280,10159
1182,367ae3e530efb13660059b543812425dd9406f0338d63fa37679125d9dc85d46,crypto_miner,1255769,4991,10167,10264,15255,10167
1183,36c6bef969d3d40c3323d5c1333aaea54ff1682d9dfe7a905c5fd3769c15b8b6,crypto_miner,1255770,4994,10189,10272,15266,10189
1184,36c831dbc6863293ac5201443c464ca7b06d6ea516ea5d57079cf8b6fe84e68e,crypto_miner,1255773,5007,10167,10283,15290,10167
1185,36ddbbcbe179f612010271620a9603a2c4cf9ef6a9605147cf6d14cc3e43179d,crypto_miner,653079,2509,5203,5381,7890,5203
1186,37a7921ceb75f322e8eccd8678ce1a35d222756f40f55600d977b2156293dee0,crypto_miner,1255770,4988,10162,10246,15234,10162
1187,37cb3b7ddb2fccdaa76ac2c7b867ade0350732cfa7fe933dec82f7800d812763,crypto_miner,1255769,5006,10159,10253,15259,10159
1188,37d968084f5abaf43425ef90fe80c887d53fc2e2ef42bc153ebf9578258b0b57,crypto_miner,1255770,5004,10150,10275,15279,10150
1189,3800302f5f3f06ca0567942ca8003b7cdd7127f8a4ffe6c2fddff01d907dd06e,crypto_miner,652961,2627,5061,5259,7886,5061
1190,380eb55e45f9f215f4295ace1d6633151026784ab71eac9d1f83b92e7d4f9f55,crypto_miner,653051,2618,5011,5274,7892,5011
1191,384058b57190f758e3efaef95e40c4b2d1c5ae739b70d370f85abec539ef6b19,crypto_miner,1255770,5002,10168,10302,15304,10168
1192,3860cd372fbd184d717776f6def36d065cba79ff91d8698f37f5d274cc3557e7,crypto_miner,1255768,4996,10129,10281,15277,10129
1193,3885eb52a19ce481b8e08ebc09060173fbc2d98f08a5d172d7dae100a5202177,crypto_miner,3018234,11850,23317,24561,36411,23317
1194,39393837e51755687cb7edc380aa1262741b994a01ea4c974b7977a6749495cd,crypto_miner,653109,2557,5041,5213,7770,5041
1195,39397f83d23059796b7c24b252865a12f28740e5bbfa31d36d13bc9f60f48446,crypto_miner,6899647,26955,53777,54217,81172,53777
1196,39cb0f3dca95a5ea71605f004f93a8c938b8a56b9029d55d32082e16b34e7db6,crypto_miner,653059,2578,5108,5281,7859,5108
1197,39ff8e57f169772b0543596911bfbf541acae2394ee85ad525b69437592a8fe8,crypto_miner,433319,1888,3360,3499,5387,3360
1198,3a3282eeddb9c448deb16f030b39aa58a63ee1ce3f0d67e0f5cdbe90c3244bb5,crypto_miner,1255769,5005,10169,10270,15275,10169
1199,3ab43b40a6543c98f98791dfa3506de09e1742199a936b3b58079f22d35b0ab0,crypto_miner,1255768,5009,10169,10272,15281,10169
1200,3af0dc1d3e69facb693b22652b3401f36532d8970153f35438d56d13df39a943,crypto_miner,1250170,5411,10286,10611,16022,10286
1201,3b13cbe521a3f7ae5b02405d0c3f2f1e14d70a7cff016187f3b3e14825ee0a4c,crypto_miner,653095,2595,4935,5403,7998,4935
1202,3b6ea2b15e8abe1433854a4624330ae86aaad8f2db01b17a193a352cc4c83380,crypto_miner,1255771,5000,10150,10278,15278,10150
1203,3cb3b080fbec2049769b56b88c2f1c946417001ff9ed14e749d36aae8b95f01c,crypto_miner,1255769,5014,10158,10276,15290,10158
1204,3cc2d1336025dc2d7dc403eaf394a49f8799f5989567898c80a75c215753b694,crypto_miner,653157,2593,5170,5378,7971,5170
1205,3d11e2439f0702e93f483c3100f4fb48ab49ee3b9524b8db96a9ac1244ebb1eb,crypto_miner,350726,1486,2824,2785,4271,2824
1206,3d2ac2b857753e36bb04656a0249d961bc7899ff46ef558d8cc98b0912af969d,crypto_miner,653051,2524,5070,5482,8006,5070
1207,3daa03db9fec8843e1511d467a6e3665e225d973863d0988fc7e70f0e7caf68a,crypto_miner,1255770,4992,10170,10291,15283,10170
1208,3dfa02ee8b8bcba2457ce67907c5263c0b7aa4354cff95013dd2f7ca9fe108f2,crypto_miner,653050,2498,5235,5453,7951,5235
1209,3e15575836d67c11a69a7d0fdf7ca625829a9fdd76a87628c49b6bcb3fc4c368,crypto_miner,1255770,4998,10172,10271,15269,10172
1210,3e278b0850c097c873a3ef84bd72b9a2c28821baaf818d2e88c399042093740f,crypto_miner,652723,2571,5149,5195,7766,5149
1211,3e290625031fe0159673fde602ae1451f6e3fe006ae94c1f5f32e57225943bad,crypto_miner,1255769,4999,10162,10256,15255,10162
1212,3e4835e11ff6797d72cb3b8b1e86bb34ac8013f24e500cbf71bb6b4080399398,crypto_miner,653047,2596,5126,5286,7882,5126
1213,3e4aa178a8f265fc846cce85851a60218c430a9fe6ca6569371cf53a09d22969,crypto_miner,496315,1880,4093,3926,5806,4093
1214,3e5ad0818dfad9a501637beb5dc4b1f4d27025f4fe7bb32a8d062886bc5f7319,crypto_miner,351120,1623,2710,2758,4381,2710
1215,3e7eb5c895319a5962460e83bbd1a6afdab60199176fea5c1274eeb67303cd00,crypto_miner,1255767,5000,10147,10295,15295,10147
1216,3eb6c4da77270e825a35f7395a566a792fd1c6b7db3ff38cd2e6ee31145bf120,crypto_miner,653090,2578,5012,5308,7886,5012
1217,3ee9398253a1b00a29a81e24f7ab154d37f55e6366f7033c3dbecd5ae399b864,crypto_miner,1602442,6844,12645,12769,19613,12645
1218,3ef919bb0d6d5a96fb0ed7146f64ce88adee8fa75780f0c0ee76bd28f2fd0280,crypto_miner,1255770,5009,10159,10264,15273,10159
1219,3f38babc0926b0710049a84cfa31e99133cc07223d033acfcfeaa6eb870d264a,crypto_miner,1250761,5196,10199,10465,15661,10199
1220,3f3dfb777ee13d40821cd117489dd3484ee93f2b539b78032db8b58afce22b1c,crypto_miner,1255756,5003,10142,10290,15293,10142
1221,3f8f0b47fd9b07b1d216e2cd36cd43b1dbc6df7644a2cb279b9888edf1d3fadf,crypto_miner,2193221,8570,17370,17254,25824,17370
1222,40185ebe9012eb9b79f61449134419a0c8d7171056e6c917795ef12cffcea417,crypto_miner,653061,2484,5001,5279,7763,5001
1223,403a491c21c9bbe932b56cb9eaedd87e491046e6d8f53807a44e52049894a63a,crypto_miner,744947,2861,5886,5844,8705,5886
1224,410612119117070db2efa15fa69086f3f1ea88d98976bab8f4c9fe92a1bd8385,crypto_miner,411248,1699,3321,3317,5016,3321
1225,410db1c1e8bc4566175c4b626c0b398c72494815a006092835d803a8d768c3e1,crypto_miner,1255771,4984,10145,10268,15252,10145
1226,411b40e0e86640942bb9ee389299d9c371b83deb5b63d872a10d0e2407f5fab0,crypto_miner,1250767,5197,10148,10463,15660,10148
1227,41f6f958d4c65d2a4844b851bc33e17f552e181024f9e26be769aacd3c3d04c2,crypto_miner,1255773,4980,10162,10271,15251,10162
1228,4206a8786bf2f74e577a542f8e004ef148dac941a8adc260a1cb8dbb4adcc490,crypto_miner,653085,2622,4938,5475,8097,4938
1229,42362a8ccdc552ceac55dca96265e48782b2a46d3009e79f6bf27b204f3bad6d,crypto_miner,935480,3795,7452,7317,11112,7452
1230,425e6222a9152bfeeae82088472bf0344b5e1d048e30bf1674a8d50a5883c4e1,crypto_miner,204647,799,1447,1450,2249,1447
1231,4297ffd959055f0242ca38524b687587d74f5cce965ed34fd95ab7bc144c1d6d,crypto_miner,1255770,4997,10167,10279,15276,10167
1232,42b5f2fe89e8ef6076295c373a49925070533e2fe2444ada29e0533230b09e5b,crypto_miner,1255776,4999,10145,10274,15273,10145
1233,43259367073892f8e6abc1bd956b552ed94a24b76a1ae3ad528055e394ffce85,crypto_miner,1250161,5416,10275,10610,16026,10275
1234,4359e4445a45e125206f6eaf52c835bf81a180f5023005f02079f88460cec70c,crypto_miner,1255776,5001,10139,10280,15281,10139
1235,438e5eaf0974b0d92b7698ecadf1caf16baca98fbd1d9db20d728dda612f5bcb,crypto_miner,435580,1801,3429,3574,5375,3429
1236,438ff1b82356213262fb32ed1b8cfa00b5744664d6b05f991b23746b68933943,crypto_miner,655416,2663,5278,5225,7888,5278
1237,439c6e4cde5cca6dcff44eea6c6d378cbf8646010bb380863e279acbe9b24c1f,crypto_miner,1250766,5191,10159,10473,15664,10159
1238,43bc8004d5845cb8411e99a8170589a7e3ba991646409b0593658b812aa185f1,crypto_miner,652921,2525,4948,5339,7864,4948
1239,43c854a5600946ce424700258966dbabc0b10d5f3ca8826c28bfa41be8e6001d,crypto_miner,1250773,5189,10160,10455,15644,10160
1240,4431cdfc0de37b28cf6ef30d5c14e1b86df658f76c1658f016386423709f12ca,crypto_miner,404361,1530,3136,3201,4731,3136
1241,449d995145920bc71c3b1d9eb76983cc287c87ccf8cc0618ba4bbd7d9aafcd10,crypto_miner,653062,2613,5007,5214,7827,5007
1242,44fd88536eceab4b35870b1f0d04df35fd1492002d46efb27fc69cf8cf3053b8,crypto_miner,1255770,4995,10179,10270,15265,10179
1243,4531bb849e743348a814a032db464d16b4bddb70eb047e836d8346c2c64a3e02,crypto_miner,1671330,6727,12897,13329,20056,12897
1244,455d60d86ffcb532b49df399bbfab504858311b384c41486a68240336a1499f7,crypto_miner,1255771,4996,10159,10278,15274,10159
1245,4588c456735c83d71047593c907a54bac95d397fa1383fc6cbd668ac0f17e2f3,crypto_miner,1255768,4990,10152,10302,15292,10152
1246,45a820ffe393d87955bea5dc83f97ff97d7ef6180335973f0104d878071ce3f8,crypto_miner,2196178,8539,17079,17058,25597,17079
1247,45b92d9cb59502395c268533fd7eefb01d62c86f3cfef257091d9a6c3818cfa9,crypto_miner,1255771,4981,10151,10253,15234,10151
1248,4602c82126567687055edc0cf2b0c738d036ef514d072c4eaafa3a872cc417b4,crypto_miner,1255772,5021,10165,10264,15285,10165
1249,46d0599148e6e67030006d157a7e6450af380d3ac4604f52e2663ff9acfad875,crypto_miner,746802,2788,5771,5818,8606,5771
1250,46f9ac3c3dc6bfc5712c726f6bb3d6236edfa2d4841b45b68396b800306ce705,crypto_miner,515573,2054,4132,4119,6173,4132
1251,47108accc11b1afdd804b04f614035ab2570ad0866021db4b73e0b270f9483aa,crypto_miner,455087,1872,3717,3636,5508,3717
1252,4737dc4c8948036e1e0af119267bba36f6b9494df7a0c0223f61655d93cc8408,crypto_miner,1255767,4992,10166,10284,15276,10166
1253,473ee6fc1503d9cb6ad1d3ff3e44f8b842f7abdbc27f71b9529f4c694413064a,crypto_miner,439405,1782,3497,3462,5244,3497
1254,47400a0533cfc114798b5f6ef2985a4323429a664e4c074e99b8081fa71ce536,crypto_miner,1255770,5005,10158,10283,15288,10158
1255,485a3b25db6c9aa85d7bbb6d9cbce429173f572aa876100b8ce5d84b956a7a39,crypto_miner,1250772,5193,10157,10464,15657,10157
1256,489c64b4fa549cd9b20815a916d95f622e2948151b859c295d30bc002947645e,crypto_miner,1255766,4994,10134,10297,15291,10134
1257,48a315195d6941fe316b5268f9e6f4452792ff880aff944576cac8389008d866,crypto_miner,649647,2604,5201,5165,7769,5201
1258,48d0abb2d9412613c419288ac4366a11719098ea3bfd6ab3ca23b364545a1fff,crypto_miner,653096,2630,5128,5473,8103,5128
1259,491ba9afeb806cbdd379824474c40c5edb2e380c199ca4a1f9a2c9323fc37aca,crypto_miner,1255770,5019,10155,10287,15306,10155
1260,496b9c7706db6d6b2e3cef8c0b7a084d22056559ca0fc819f72d465aeaf992cf,crypto_miner,713032,2925,5575,5736,8661,5575
1261,497298c77b959f1f8f63a6f8c747990c93953729169a01af5ac2ea2fac86a157,crypto_miner,1255767,4994,10154,10291,15285,10154
1262,4a152244779fa2f79d87f97b36b616491201e82fbe7ac0a592ffb478a7295232,crypto_miner,1255772,5004,10174,10277,15281,10174
1263,4a2fc1dbe4a70256314b6b28c0dd040b6d2246400784b7da1e3d7d70be79224c,crypto_miner,1250769,5185,10175,10448,15633,10175
1264,4a556fc15666b29c896b885eb0cca2ca1b81a345b2b67bcbbc3e17db44a0ceb5,crypto_miner,653054,2626,5126,5330,7956,5126
1265,4a8c968259798cf36e42a7e7b9577def942ef95212eca6a0863c7b4e063b1465,crypto_miner,1255767,5005,10172,10281,15286,10172
1266,4acc4136c1b92d9341779faf8b4253f8215d398dba7424f7e7daf692f97a605f,crypto_miner,1334908,5243,10762,10424,15667,10762
1267,4b0e58a70e672dfc395566b806863efe8f43f3e2906ad68e606d03608d85a6ec,crypto_miner,1250774,5187,10144,10468,15655,10144
1268,4b0fe4bd112869c3cb28184b6ace8660a19145212f67b8d7899d8e9e59c0d661,crypto_miner,1255769,4999,10169,10266,15265,10169
1269,4c07c0f027f0c28b0bbdce0bac52817762c368dad47e94d5133a54ba42c9c73e,crypto_miner,653072,2664,5140,5394,8058,5140
1270,4c3203db1c532ecc62df30ade9074ed47d5043f426da1b2b39eaf628eb41664a,crypto_miner,1255769,4981,10162,10274,15255,10162
1271,4c4c5ed126e18a579fd60380f358099466be8761db4fd7c66f8a1d8e47b5fb2b,crypto_miner,1250775,5188,10166,10446,15634,10166
1272,4cc7b6164b682100682dc6453a3658fd838c5330d6a9046e130a41e516da884e,crypto_miner,1255764,5014,10152,10282,15296,10152
1273,4d132462441f63bb2404da3511222ae1f96840dcceaf11c7ce50b02b55bffc76,crypto_miner,1255770,4999,10150,10283,15282,10150
1274,4d61300b635fc9b77361521a7457abfced2ead8c2e649e369c52e36d746fb2a0,crypto_miner,653039,2566,5125,5201,7767,5125
1275,4d7623416820d8a7a1ba0be4c6100d9501ef85ec6e27c58327e9e13e5ccfc307,crypto_miner,1416199,5569,11222,11550,17119,11222
1276,4d954302585ac3d53b9bbe7e13105fec0ae403aefbea03e9c8381e9b17d05918,crypto_miner,1255771,4993,10167,10274,15267,10167
1277,4de5d7d4ec5e2b6f5c5f3900693f64e3327a1d2bab821a5042766f939dbd3985,crypto_miner,653044,2546,5059,5412,7958,5059
1278,4e2e694b19a97fec19ba922c464615763cc7352f7fe5a6ca2184f7ad51a5c505,crypto_miner,1255776,4995,10154,10290,15285,10154
1279,4e393e26c4beda0361e69c1a530ff61ed4e06aaf906b0b11f1e3e05cd5cda809,crypto_miner,509076,2030,4092,4172,6202,4092
1280,4e397893de30d045486345d7fa00be879edab1496731770c2af5ca55e218bdd2,crypto_miner,1255770,4986,10170,10285,15271,10170
1281,4e698150c0156e1a0ee55f0672f8ec92ec11606500a53dcdf3ae2b3c2e6f335a,crypto_miner,1250768,5196,10175,10467,15663,10175
1282,4ea6f62389c62b92c57da38d3158575ed487e0b2e3618e07e8b7871874369c7d,crypto_miner,1255771,4994,10183,10299,15293,10183
1283,4fb475157aa3ed0243663387793231733dffbb7028e40c1926846fb2a9381005,crypto_miner,1743443,7345,13665,13999,21344,13665
1284,5079d5d79635b018c1cd72857ee93551a6d257cbdd5b60061e1f20a3beaad67d,crypto_miner,1255770,5001,10148,10277,15278,10148
1285,50850a8bf93fa98dec4effdd45994e5e829f94baa12516212310f2ab84d7ce94,crypto_miner,1255773,4998,10130,10288,15286,10130
1286,50b13221cc3adfe2cf9f46e4a0975433a0c4b29a0452ac82a4282a102dee9e75,crypto_miner,1250770,5207,10146,10474,15681,10146
1287,5145669cb9ee2e6e891b1f7a66efb4483be8823108f7041be3e4542c757c1085,crypto_miner,1255767,5003,10177,10274,15277,10177
1288,5197ae6ad01a46a1ddb1d3757265729296a6dfd8889fe6e0b9b9f0fc242fd9c9,crypto_miner,1250778,5195,10166,10465,15660,10166
1289,51d4a7df4a12755951a0f2091e66cf8362a0f39e0412bd32ce8ebc6f81402c39,crypto_miner,1255772,4995,10164,10276,15271,10164
1290,5274f47d7751e53ce816733abb52d0014cfa9f8b4bcc54cd8a24d558d7048c39,crypto_miner,653084,2555,5166,5410,7965,5166
1291,52bfae4e4723e7c46a925140f5b1dd2c66d83c719a8c70645b06232801539617,crypto_miner,1382679,5458,10800,10891,16349,10800
1292,52ec84fe83d0179bdafdd4f82ae80d5ad7cc5f2e9fdca43453a06e2b393dbe1e,crypto_miner,1658766,6606,13163,13509,20115,13163
1293,52f9e4ff8c2ebe4b090129be659c60e07211e1e7fdd77541d0f8fd25c6753b8d,crypto_miner,1255770,5001,10172,10307,15308,10172
1294,53658dfb871eee5137771ca0a9709f473c62bd5e7338b9915ff80361a0f594ba,crypto_miner,242349,1017,2027,2074,3091,2027
1295,536630850140c397c378a44e2d214dee56cb68135323e58282612e2f7b715f8c,crypto_miner,653081,2571,5071,5316,7887,5071
1296,53ddb1e8a89139dc73c1ddf3942fba7482afb5fd5a3c0b684e215b5184a248a6,crypto_miner,882978,3555,7178,7160,10715,7178
1297,540aa4dd6a2efc8fd0647de5fda777344c1d7d7159c43fa28a94b4e61f1b04e3,crypto_miner,1250773,5191,10171,10484,15675,10171
1298,541aa0149b6ff7cff9c6b37121c059547f1805778395c5e90152eea66f4091a3,crypto_miner,653075,2505,4999,5257,7762,4999
1299,542caee4ba2fb9659b071b56c41f89e64b051709539a276394d34125f326b968,crypto_miner,144937,568,1130,1167,1735,1130
1300,55d9ca5588c0d299fdff4b157ef31379f3dba1e64faf0491aaafd6f0baebf86c,crypto_miner,1255772,4983,10161,10285,15268,10161
1301,55e08860575a25357521f740417dda1bdfbcb8dd14b1ce344d46d6f8f27de0b5,crypto_miner,1255774,4991,10160,10286,15277,10160
1302,55f548ac98fb733fb801c66110d732f3a2d4be735c4ca8f6397b539c9edff1ed,crypto_miner,653091,2575,5124,5391,7966,5124
1303,563a58cf579b081eb8b2250c2bece8bdbc24cad075b905fc1e9215d6b9276acb,crypto_miner,653070,2577,5259,5255,7832,5259
1304,567488c386aa9139be49ed83985fb52396e4f4f9dcb248a9fb5362c174710d3a,crypto_miner,1250775,5190,10176,10452,15642,10176
1305,567b3c8e3ab0a172ec3c0c20273a1ffb446b9e30b6c58bcc04e2eb6591aa4205,crypto_miner,1250768,5215,10154,10438,15653,10154
1306,56b05af59b617ed941f4bf3e4563278a945df7f714f283806be33941ffc7afb6,crypto_miner,1255773,5007,10177,10283,15290,10177
1307,57617f611808e2e3994843f758c3c505f9f2b33237a2a046df930261854430f3,crypto_miner,1250777,5197,10165,10464,15661,10165
1308,57861e1ba391ed94d46ac5bc2110aca96441595661e0c5cdbdc2decc059215db,crypto_miner,363005,1582,2887,2780,4362,2887
1309,581bd3539b91a74f582c60392c1dc243987a155739fe5edf4305c5d022d2f823,crypto_miner,4334598,17170,33956,34355,51525,33956
1310,58875f4497c0a82d0ce6b522b16387179732e49eb1fa777a1e62900b8c09c3f2,crypto_miner,653053,2617,5032,5344,7961,5032
1311,5897d1fc16439b168c556e49adaf98b463bb796333c3e09663e1e50c2f5ad966,crypto_miner,181113,753,1396,1457,2210,1396
1312,58b8461492d0a3fd9b49d0b9685b7d66ef35acb8606d6a627ec5e997a9ff3f64,crypto_miner,1255767,4978,10139,10281,15259,10139
1313,58c00907052fab3ee3d07c53067b84faab476397f8d6a5c3ee867df13a0713fd,crypto_miner,1702332,6696,13476,13819,20515,13476
1314,58e35a041940ccb0d38fe3c136f2ecd162012e096db5e2d70de86681a3dd9ec2,crypto_miner,306201,1229,2521,2551,3780,2521
1315,58fe4ea6417d96e5ade9e01913c40938e79aaf917ab17e8f3031a1d58172e993,crypto_miner,1255768,4995,10161,10272,15267,10161
1316,597bf841d231da5336a8a9393c5d9c6564567ca5d7e3aeccfb12d12a842a3d63,crypto_miner,1255766,4992,10130,10308,15300,10130
1317,59900e6419aad400f126a1e9020ca307d0a68cb5fc853c3645e14d20d3d856c7,crypto_miner,1255764,4979,10152,10272,15251,10152
1318,599f925a14f86a0762e4ba023c455f6c97ef81311afbb6db7d7e2b95c1dba382,crypto_miner,1255678,4997,10153,10250,15247,10153
1319,59dc3a0cfefbebffc44557ba11bc2b79b0971fddf1372bd406677872f49046ec,crypto_miner,1255766,4989,10163,10267,15256,10163
1320,59ff71655de6ef571ce8440972ba33782bab6f236197e5076e026ccc27139d34,crypto_miner,1255705,4999,10145,10288,15287,10145
1321,5a48de80ebdc2cdaf82b099f4e4a97d17993610661513128162dfa1884d2a5b3,crypto_miner,653017,2458,5187,5311,7769,5187
1322,5a62ecbe1ba06b02ca7511a685d8f45df5d41102e441f55926d2c8d8bbe5949d,crypto_miner,1702919,6818,13260,13764,20582,13260
1323,5ace8d15eb6a48dcd0eaaa6cabaf6d4a255cc3d6ea429bd2500cc8f0fcff0918,crypto_miner,649540,2563,5120,5208,7771,5120
1324,5b6f0ec511bc87f5d1bdd32ec0a658232a5b4ae84132268c830ecba3e6323ee4,crypto_miner,371932,1504,2947,3056,4560,2947
1325,5bb658209c683af7b4a0cdd6d9ff4cf1b4264361b6e8cf2c4b9a84cc4968580d,crypto_miner,652848,2530,5134,5358,7888,5134
1326,5bcc336823845506375c12ac1db18ba4d1cf644ea834421e1102c368f5a62be8,crypto_miner,653028,2597,5103,5338,7935,5103
1327,5c565f0dd4371a8d49b8560bc75c35d574083c48090552a414b219b948480d60,crypto_miner,1250771,5199,10175,10471,15670,10175
1328,5c63d68bab5e9ca168d2e754c6dfaf02ca6b7769c09c07d037d1a2073fd9cc56,crypto_miner,1250773,5196,10190,10458,15654,10190
1329,5c78aa6d9ece6ecaac05529651d18f3cd05c2d415eed05a7c2b68b1ec885b285,crypto_miner,1255768,4993,10161,10281,15274,10161
1330,5e46e8e40464b7a1add16308245a050913ce246544a00e9de093f1fbdfe5424a,crypto_miner,808341,3269,6273,6516,9785,6273
1331,5eb791ebc09dbc0e95ef83948411b9711cef50ba3049e415e2b2f5e570cbeb7c,crypto_miner,1250774,5203,10171,10463,15666,10171
1332,5ee31f527051110840a7e847bcc2de4baacac35ae0ea9c1002b6b7530f71f8cd,crypto_miner,1255768,5002,10142,10293,15295,10142
1333,5f27184592ab3ae5b163bfb5495a7e7ad6241236db8859a08067900c0607325f,crypto_miner,1250767,5198,10173,10442,15640,10173
1334,5f2a219864819a67b0d5f8ecfd53ed38f6996e3f42fe3707bdfb6d981a47dd94,crypto_miner,1255766,4990,10144,10296,15286,10144
1335,5f4b41092313839210a7fc3918cf6ab38fe203b719924c4cb379a59c36419e81,crypto_miner,4867708,19523,38433,39128,58651,38433
1336,5fa7573c74131c9bba48233222ca12ab1eae7e618fb264f123b697a4c3a419fa,crypto_miner,1250163,5407,10290,10625,16032,10290
1337,5fd9a3c588706e84185720a3e640163ef861fb032ea8ce5c0f69295b398513d5,crypto_miner,1255772,4988,10151,10273,15261,10151
1338,60313aca834590b3fe3da608ac7df31f7ce526990c3c05e7fd3b161872264082,crypto_miner,1255772,5000,10167,10281,15281,10167
1339,603f3eee8fb99965b95dc46cf57f7aa273fa58dc51d01bf998845789fb9e9a76,crypto_miner,1250714,5190,10137,10465,15655,10137
1340,60a2009205ce0c2ae8ffbd22758a71accbc590bdeb0e25e836c20cd2108556ce,crypto_miner,653125,2525,5106,5183,7708,5106
1341,60a80e1890d23b8e658ff6859a5bd11d58fdb792f2aa1892dc3435383bb64695,crypto_miner,1255769,5002,10176,10280,15282,10176
1342,61925995f9367d132c09a700c10978f7128e41ad5cceef47a4064536b5e64e0c,crypto_miner,1255768,4996,10153,10282,15278,10153
1343,627e8715401f5b5246ced9cf9d3f36fe67a21f4d3c529c75318390292aa3eb2a,crypto_miner,1255768,4998,10143,10284,15282,10143
1344,6355b359c968294e9cb7f3574374198431377fc8398821c7cf91dbf81c3dda86,crypto_miner,1255765,4989,10139,10254,15243,10139
1345,639b5636adff58946162b35dffeb4a670645b5123b9a814ebbd62ab280c1b7dc,crypto_miner,1255768,5001,10129,10260,15261,10129
1346,63d128d68dc18c77fd85e41f54df03169bb4ecf3b99468891c989c85ed23e316,crypto_miner,508108,2073,3949,4047,6120,3949
1347,644980a21f56149a21331d2763f444ff7783b52756320c598a07b7bee518d2d9,crypto_miner,217073,917,1714,1793,2710,1714
1348,64a33f7794632400ea509cc2a17ce3ddc34fa39c9f5fcf01eb39d9e53bf31fd9,crypto_miner,1255769,4993,10161,10270,15263,10161
1349,64a8f80af1ff04e3194e68c059b0c869c17dc30d661b391f4328153aa009e186,crypto_miner,1255770,5007,10151,10281,15288,10151
1350,64b3d5f699c63f2cd3cecaadfb5b7c549b64d097d0528c4df21c4314c72501c1,crypto_miner,1250719,5204,10170,10456,15660,10170
1351,64b41dd7eae13bf1bbdcac3e8dd7b7351abfc22d92f52c0625e21468ed4a33d7,crypto_miner,1255768,4991,10150,10302,15293,10150
1352,64d33ea4245763569f7a3239e9f1dfb8fadb55abbaa22dda276d7d6f7b6ff9b9,crypto_miner,1255772,5000,10159,10293,15293,10159
1353,64dfb8318f328196245f5c0d4d1e81dcaf1d02fe05f0beb0e4e807954d3cb9dc,crypto_miner,1255772,4996,10172,10271,15267,10172
1354,6500f359a7756fe461e65c8db102ddcbe7a57dc3d891de639c0733585efe103a,crypto_miner,1255766,4999,10158,10291,15290,10158
1355,653e7daf24172902e6578940757a67918e92101e3b13c2d5c34237af47ac4f13,crypto_miner,1250772,5208,10136,10481,15689,10136
1356,6545917dea8245e71441fb39c5260180306d2272a3148c616898a94a2d93342d,crypto_miner,653035,2599,5167,5485,8084,5167
1357,65e2669c8b6cd317a2d66fb14acf9d9d22d198f50adc4d129efaee8f557acf56,crypto_miner,1255770,4999,10156,10273,15272,10156
1358,664b51e19f0a83a428f47040b8e2341469169d61cf4e97400175f99ce1c612b9,crypto_miner,1250776,5192,10184,10478,15670,10184
1359,66bcca764acc915c1a9653c7d6ac2ce7c3f87604f8f9f348cc0634b97c5ac2af,crypto_miner,653006,2605,5181,5327,7932,5181
1360,670e4dd24d6888d9698a457ebf481ae37545dd5a16f6e2bef3ffc31c2824b802,crypto_miner,617902,2515,4851,5033,7548,4851
1361,67246d2ccaf2bd697b36aa3b20fad8c6c381873c53e6f85467b479642c5bb2ad,crypto_miner,535654,2160,4238,4299,6459,4238
1362,675c761574244fbb325a8aad3b635ecc87f85fda9ea9881dc2a8a0fa0a8c41ff,crypto_miner,1255762,4982,10178,10264,15246,10178
1363,675f101b6b8ef8580e7f76ba50fa214f7a69279b2b18c8b11442556260fd5992,crypto_miner,653106,2654,4881,5368,8022,4881
1364,67a40c9439b0f44426eccbcfa86496561d9c290211254529e0868df5a270975e,crypto_miner,653063,2598,5034,5417,8015,5034
1365,67c4461b26c5a6ffdd5a9cd9c9b193b7061d7ade10ae85ec39c2f994ffb82eb1,crypto_miner,1255772,4990,10183,10270,15260,10183
1366,67c721500eb5a73513d746bd3df5381dcc176c003a743f3229996ef198cc4d27,crypto_miner,1250773,5192,10154,10459,15651,10154
1367,68639b59e1b8515d78242e4f5f3ed7b3ed940962fc03b745583b0c451541f80a,crypto_miner,1133801,4560,8762,9088,13648,8762
1368,6867b8831057145979b61843f77428796ec1eb93bbe3c48660e9890313a0c1c4,crypto_miner,1250771,5203,10139,10452,15655,10139
1369,686ce86fa389b409c7ac545e2f549f8c860f3243e9fa6031a6915bf48bd24564,crypto_miner,1255769,4978,10163,10274,15252,10163
1370,68a89d019876cf2a3ebcb6e33a02b94f4b1764d7c502dc60760a3d8e78f75c3b,crypto_miner,1255770,4995,10165,10269,15264,10165
1371,68a9ae34c110a3b451789df184fb1164e19a5db2d010ba9f8e5efc5dc7c09836,crypto_miner,1255769,5013,10154,10280,15293,10154
1372,68b41c313f2d88ae30e92c3dc7895d935cdf7259a045f4ab59738d52f5839487,crypto_miner,1255772,4987,10169,10297,15284,10169
1373,6970c34fe5707e7fbc6eab1b025d73218ae4e33d2449e5df09ef11a7b715e1fe,crypto_miner,653013,2620,5299,5182,7802,5299
1374,69c32b6c968d0646725e77b53516b6b6d2e213ab1970cf1ff44b2598f6dfbff3,crypto_miner,1416411,5612,11145,11547,17159,11145
1375,69d11b6d7f21ad57bcff7cfe67ceb4207f5c7e670bddc5dedd79b1d413225022,crypto_miner,1255770,5007,10145,10289,15296,10145
1376,6a0d196b4212e691499883adcc28440f42d93ff66c1e64322a83cab70b1f9210,crypto_miner,653087,2640,5025,5313,7953,5025
1377,6a744f5becf36bc7deba991a9f1af90a894ee81a54d239c8972a6e55f22d5599,crypto_miner,1255769,4990,10170,10281,15271,10170
1378,6a7764812a3b9704d01a20b53b9a4b0f4075913aebc1e307d985fa0cdf272b4b,crypto_miner,443913,1986,3541,3534,5520,3541
1379,6a77b6682e10e299952a7553dc1b792ab4a05309235d32e10720c62ae1c3fc91,crypto_miner,1250733,5189,10177,10468,15657,10177
1380,6b140980122a7cbe1439b4e2d251b2c665fc9a598b7914f7c58427f31aa7320c,crypto_miner,653070,2592,5229,5374,7966,5229
1381,6b5be0bf7965eff2b1ab23e15c0aa8b9a08f68a702b615f14df628630b65e75b,crypto_miner,653048,2552,5116,5289,7841,5116
1382,6bf1f0a924510240c7df821d2f37b4e15280134ff30aeec62fd6897668897231,crypto_miner,1255767,4987,10155,10271,15258,10155
1383,6c10afab8ab0af70080700e788507563636266147ec4540e122398c8845731fe,crypto_miner,653120,2548,4921,5087,7635,4921
1384,6c22ad300096098c4944fdd56cce58ace9fe22e5b1bb893a23c19515370a7c73,crypto_miner,1255765,5010,10152,10281,15291,10152
1385,6c6e30bce1df5d4342870c0850fc7d575d92aa2f15059f0709978527bb3024f7,crypto_miner,1255769,4999,10183,10268,15267,10183
1386,6cb2df96aa075769d6cb7bebb39b925c51e69fefafb94034f88b388bfa024e11,crypto_miner,1255770,5000,10154,10266,15266,10154
1387,6cc4309bd7919696cc9423b72c31039d3ecac16e489463fec210d5bcdc9e65f9,crypto_miner,1255769,4998,10163,10261,15259,10163
1388,6d4477880ffbfaebd24263d95a2664e9336b8cc2b220c32a5d8dafe55bf0bd87,crypto_miner,1255766,4992,10153,10282,15274,10153
1389,6d9bf1e2fff1983f5af4c73b243d14ae1e9ac244f143d8b0c32246f8ffcbd878,crypto_miner,4170646,16587,32467,33223,49810,32467
1390,6dac585e134c21b4681aa5b31b9857043eaa8785b7654d37e6b12061a74d7872,crypto_miner,653105,2525,5078,5470,7995,5078
1391,6dec408606ed4190b45c8eeb6cf0737903d27e4ee2480dffd98440622360de40,crypto_miner,653130,2502,5003,5323,7825,5003
1392,6e153846283a64f6461d7884700f70ba870374ab7608f3e12f8c855b6f95203c,crypto_miner,653106,2593,5129,5228,7821,5129
1393,6e6f8920bc73eff739fd4ce5ebbbee6d4dfc6d636be800962abc1655a7047ac1,crypto_miner,653079,2505,4996,5273,7778,4996
1394,6ed95ac83b7bdcea2432afd0ceea9da11c0e61746abc733b37c768665ee6d693,crypto_miner,1255771,4984,10164,10261,15245,10164
1395,6ee1ed440c2672f67c151340deaa4b64594b23b87d82e3669c85c1f3c27a0279,crypto_miner,653042,2563,5086,5310,7873,5086
1396,6efaaec6b302273a4802a921ba3f62433692eee6aaa89c2f45ae25babed20ac0,crypto_miner,653083,2569,5072,5412,7981,5072
1397,6f987e486f6dc8ef791ae6534b9788634617925c0b9bb735dafc6b2537ced3d2,crypto_miner,1250769,5192,10161,10480,15672,10161
1398,6fd704257635cfc14aafa1c60241bfb4a323bce074734c0963b78229e30dc62f,crypto_miner,652819,2564,5099,5349,7913,5099
1399,6fe92acf02269f3c600bbaeab3b11c9f68af3942d0aca608eecf0f945e35e837,crypto_miner,1255768,4994,10158,10270,15264,10158
1400,70175fea7d93f2e69895356f88f312b415a0b5b6132310a389105649a309ca55,crypto_miner,653025,2604,5196,5304,7908,5196
1401,7166d6787977f1ea41f83c96c7b91d81106874e3848f0cabd29536080f9c12e7,crypto_miner,653047,2471,5130,5413,7884,5130
1402,716966c233a785e9f85f5c45be37f3f1342d7b6064f53378e13a4c8670e969cb,crypto_miner,393291,1498,3056,3070,4568,3056
1403,71871cf129bf23990eac2ad9c70e23e1750dd9655e41ef1f17ed457a2b68afa7,crypto_miner,1250776,5192,10185,10468,15660,10185
1404,719eee6679b3677c3645fca3b348ced0f3bb983956f2ff35611e9ae2dc3c8f4c,crypto_miner,1255770,5000,10147,10309,15309,10147
1405,72279ea7e155d71d487ef813066f9c53edf4574539f8827e90fe3dbfe9051601,crypto_miner,653088,2463,5184,5447,7910,5184
1406,7248bea7bca25b2e02ad1ef5aaeccb99046a347fdcb052ddc8dcf55d6963f0de,crypto_miner,1255766,4989,10172,10275,15264,10172
1407,725486704f9b88cbde21ca35ff30f3332d628ff4803e3112ecce614b37ecd4f2,crypto_miner,1255768,4992,10151,10283,15275,10151
1408,726cbcdfa3812daa9f59e371916cab5a1dcb09e3fd01feaa0d2ec5f126963977,crypto_miner,1255749,4985,10142,10297,15282,10142
1409,72ac3bd83a73d927bea6065cde09ddcfac28545aece6f88c44d645de21bf45dc,crypto_miner,652373,2682,5181,5375,8057,5181
1410,72f9b10958fb07dd1e60eb8f5ab201395b9783a008adf8a6cb54e3b3cb7fb574,crypto_miner,1255768,5001,10162,10285,15286,10162
1411,72ff092cb488e39990d8457ac691d1a68a06677421676b28e821c4d47167fc34,crypto_miner,1250773,5207,10150,10494,15701,10150
1412,730cdb953c91d712e50c52947c92562bc8b9aceed4c19e548664b4f45faf02eb,crypto_miner,1255768,4996,10166,10282,15278,10166
1413,731ef61b9f31b07f7bdeb4fff2c5c06bc7f1ca7fd509fe593461f8e700af222e,crypto_miner,1250776,5203,10168,10435,15638,10168
1414,732668d9cdc957fdc59cc083b2049970cb3a94c3d01bfcf244f2b0cfd8b892e8,crypto_miner,653021,2502,5024,5267,7769,5024
1415,73541326ef0f2609042bb71c29f051501262d4ceb3f3fcd55800e86cd943335b,crypto_miner,1255770,4991,10132,10283,15274,10132
1416,73791faccf74592bcf300476d9cc35ead7c9589bcac8d040464b4aeacc33113f,crypto_miner,1255767,4990,10156,10274,15264,10156
1417,73929981e1972241183dba40ec7fab3d1f07af106e76cde87defb90f42b883a1,crypto_miner,1250164,5407,10274,10632,16039,10274
1418,739cc7d28e590eb2798884383a3f53bc9cff4f45c35ac87710a35487d1bf68fe,crypto_miner,653051,2633,5183,5318,7951,5183
1419,73f69b25da635888bc687ab5422638a6b4b4986bd40d48f9d895415825b67ff3,crypto_miner,624171,2457,4900,5010,7467,4900
1420,7496905f44b0412e15d4cb07ff2f2e94774796d002d2d11178fbf792c407b76c,crypto_miner,653045,2579,5185,5354,7933,5185
1421,7509e0db1627ba4bee49ff2ef4e9e7c6acd3953d35f521b50347c52153dc4af2,crypto_miner,653010,2618,5053,5348,7966,5053
1422,7515ecc5596f40227d1f0f4bf451bbb795881a7f10494d3484c0f073f03a8ec9,crypto_miner,653094,2555,5119,5344,7899,5119
1423,7553b72ff5f9970dfbd81fdd4e48459f9d9eab4b8ac40796cd8cd130dbf52cc9,crypto_miner,306393,1312,2424,2620,3932,2424
1424,7580eeaf72bb4735d6b3434ed0aae4adfed458f5346a9e0190cd170ee59a4336,crypto_miner,1250779,5201,10180,10472,15673,10180
1425,75c818e8467df8ba4fe65d55758c3528f8cbf8bc6426afd3fb56716082e1d942,crypto_miner,1255770,4995,10191,10290,15285,10191
1426,763a8693b335992db31e60b29cca9e48603db3ea1ad50e6e5946e0604c39ce2e,crypto_miner,1250773,5193,10192,10482,15675,10192
1427,76b225bd39ae03f0b3c36d027e5575a3eadb1d5fe7a3bb90d900e5bcc30ad455,crypto_miner,1255770,5004,10146,10273,15277,10146
1428,76d18354fa584d84d22bf9902e6040e07ea39cc30368e158a31d1bc4807c2ec4,crypto_miner,1255767,4979,10142,10253,15232,10142
1429,772218f1aca3cf84870feb85ef1b627e5a13d12177e8c246a79ee1902573d74d,crypto_miner,1255769,5001,10159,10260,15261,10159
1430,772f99fb698547bfd5dca53f413a4e698194b47c470961ebd8d8873d51727276,crypto_miner,1255769,4987,10171,10282,15269,10171
1431,774b3ebbefdf06cc41a7381510b889b23817bc8c1a30ef52745d1f080ea8f74d,crypto_miner,653041,2475,5120,5390,7865,5120
1432,779c558c72b20011b0921d9a212aa461b4caf2e21bddd6d45132c3c2bbb87afa,crypto_miner,653093,2617,5165,5396,8013,5165
1433,78583a25803087fbda187b77d2b6df07eb1cd8fbffc7f9ef2dc9447f1bfa7ffa,crypto_miner,1255774,5000,10161,10274,15274,10161
1434,785f3e78beeff80606dee441fa36486db153d70c9df4bcd217b91865d349f0fa,crypto_miner,1255769,4997,10167,10302,15299,10167
1435,78af78e1aad2fbc81c3ebe29d7281ef87369bdded1348b0877c0d8e767080a4a,crypto_miner,1255771,5003,10159,10289,15292,10159
1436,79be87d1611e3dd4e21fe8a11711d3aedb4f1d049d514d42898ce5cc8ba9804d,crypto_miner,653044,2535,5137,5255,7790,5137
1437,79c554f53258b8e9b4af59586eb9ba5abd35f1f6d927e0fb0eda23e544a20877,crypto_miner,653037,2611,4914,5343,7954,4914
1438,7a6a6b6d077c4c1d2aef7245bb4f84226167d72a10cc2c598c8c75baabd34244,crypto_miner,1250768,5184,10182,10460,15644,10182
1439,7b28d5f02fbb48c28ccb1ad40c62013c8629defea581e3b1e9d0c0596113d30a,crypto_miner,477886,2113,3785,3822,5935,3785
1440,7b3c711394fb395ef54582b1a5034be3a9875cf90f8d6013e9e85634faa4d40e,crypto_miner,653078,2528,5193,5462,7990,5193
1441,7b6463152b884bc774f57177e21787c8c6e08fabbc4e3fdafd2106405c089ce7,crypto_miner,1255772,4995,10128,10284,15279,10128
1442,7c0f73e8706d224861e1ab2f2bf822639c7ca362147cd069472e884c6bdc0502,crypto_miner,8846398,34761,69597,70254,105015,69597
1443,7c41750fafa8d03b17aa52d8796060c2aeadef490504e37870f5874568b1cabb,crypto_miner,653041,2536,5107,5237,7773,5107
1444,7c9e95343bfbb16cf97fa3675a1ca045e2539430e6d4c7185d5df36b8457eebe,crypto_miner,1250776,5192,10174,10450,15642,10174
1445,7cc848a6c15e01d01ff31ece13c52d5738acc0696d6957845179e229ad8bbefd,crypto_miner,882977,3547,7169,7162,10709,7169
1446,7ce60f1dd3fa7c2a6da6a2de0e67281db5cdea4cb5ac2108b27be2b28f33bd70,crypto_miner,1255771,4995,10157,10278,15273,10157
1447,7d427762d8aee5aa7137a53aedbb3155893e928266f69a51f242dedf6d7bff02,crypto_miner,1255768,5002,10147,10269,15271,10147
1448,7d519634fc6f42364944d3c0c3166d93000da6a838e3627da9fed5c48167e4c5,crypto_miner,1255770,4982,10175,10279,15261,10175
1449,7db18167138ddaf437c16aae5343f338641047a7f25b3ad3cd378741ce8a2088,crypto_miner,306392,1315,2445,2606,3921,2445
1450,7dbfe640190ca0523db7ca435096991d5e489f34dfb8c810243765e1cfa37953,crypto_miner,2807431,11147,22129,22278,33425,22129
1451,7df3226fcfcaeb7310a4f3f8ddaeaaec9dee8c827f46cb7392d4e0efb939a44a,crypto_miner,1255769,5001,10141,10290,15291,10141
1452,7dfc94ab68d05ffe42dd80b491ebe8365b32fc1b51d091bc9a2bb809495b8f0a,crypto_miner,623880,2585,4870,4948,7533,4870
1453,7f01eac61646dc1f70ad4ca1d05e0e110e0557693a0e018fe754f8e981beaac0,crypto_miner,1250770,5195,10145,10468,15663,10145
1454,7f023f5962eaaaa6996391cee5285ec2956d8d7a5aaa8b479c88b207559d4c09,crypto_miner,652395,2586,5043,5282,7868,5043
1455,7f421c7941f576c6319041bfaef85c865953c75d31fbdcb97027d526c44cb1cb,crypto_miner,653091,2580,5162,5439,8019,5162
1456,7f811862868e96e95510dff904da12e17050c74b573cbaa2ea08f2293ab216ce,crypto_miner,1255773,4999,10160,10282,15281,10160
1457,7f820bc5685fd646a9c47058a856a8ab4aa36e8fd97a4d26101a91fe17383e73,crypto_miner,375111,1557,2984,3075,4632,2984
1458,80371635f1f0fd3a0dc3273b27dd4f1217d0aef25f65cd14c4601ab9a58bbe97,crypto_miner,1255767,5001,10142,10272,15273,10142
1459,80d21ecc4c034a1e47eaccde815039c97c2aea6a5e7fcbd5cb480317d89b9b8d,crypto_miner,653073,2531,5238,5232,7763,5238
1460,80ebcf20d74c9378918c7ffc108d188fa2f7792d004d08eb4d511a4d4ba0d2e1,crypto_miner,1250772,5204,10171,10455,15659,10171
1461,8149e1a7b9edc7d9437832bd3fda2a5e397a45b41c36f2627b22d1ed84e4138b,crypto_miner,1255771,4996,10143,10313,15309,10143
1462,81599faac365a894b9a1961753277578aee7b7e7133c7d36f71b751134f9a323,crypto_miner,1255764,4994,10154,10262,15256,10154
1463,8174363a669f96b659930f2841d7614c9b4dce2a58a22513cfdc679f6bd18196,crypto_miner,1255773,5002,10159,10300,15302,10159
1464,818de3b514a346040899991563c1d4b0c81b46b6349af3bbf4a4e1127d763504,crypto_miner,44880743,175396,350841,351575,526971,350841
1465,81b6a97d30fd1464c484055e50438cae12ece308ab2a1eb241376b5d89f8ea36,crypto_miner,1255771,4998,10148,10275,15273,10148
1466,820d89a6507f9d3105b3e48585a7f3824fbd573acba1f9e2733118de7665b9a5,crypto_miner,1255769,5004,10168,10303,15307,10168
1467,82154785d846137d094260d1ca9dc121ea1c564df90b4470b1f58ee4c19e28f5,crypto_miner,652956,2534,5221,5412,7946,5221
1468,822a452e2f851fb49d4a5c1cd6c830d3ad3aeb3b7d231fdff8bbb3522732dc88,crypto_miner,428073,1824,3432,3523,5347,3432
1469,824c75b89c2b05e891546afb330f18d12ac5e2c546c47dca4af67da26ea0b7c5,crypto_miner,1255770,4994,10168,10281,15275,10168
1470,82cc53b47da798f9cc45d18cb5a960dccc0dbdb31b4d053ab8b660b3a05ca24b,crypto_miner,1255773,4998,10161,10280,15278,10161
1471,83060547819c64d35f954083bbb26c2e8ad9966c84668359d08c560bdd8d6758,crypto_miner,1250768,5182,10170,10457,15639,10170
1472,831cfc8f08791a2c2e6a4c04057b6f71c50717b77916cb8758d389819366583b,crypto_miner,652998,2582,5053,5338,7920,5053
1473,832cf54e604bf335b1bb29a7916ac032222b7d9f70c229b27d995d4a8c5d16de,crypto_miner,5852682,24303,46599,47716,72019,46599
1474,8348838e210ab1d461ca543db0ae31f43a0b67867b948a9f3a2ab892321ff4f9,crypto_miner,653087,2546,5141,5358,7904,5141
1475,834aa2c49a91dd6e6717173196d13c922fefaba6459400e2226fbcd947c82bf8,crypto_miner,652939,2547,5198,5282,7829,5198
1476,8409a571ee34a85f425aee97e5e9334de6a959d8f0eb8c9b70b68326fe87fa2a,crypto_miner,1255767,4988,10174,10272,15260,10174
1477,845e1c5d6d0db22113102c6758f4ecafb463707d035b5bd746c90e057f5f4e26,crypto_miner,653078,2683,5075,5320,8003,5075
1478,8464be3bc02033278dc89db87785c7fed98a43d92d8cd88727adabe1dbf5b972,crypto_miner,1255769,4985,10153,10276,15261,10153
1479,846cf50353fa3185a22ff4cd002519e096cbf5952466dca4d6c62d2f2f82a876,crypto_miner,653072,2644,5224,5471,8115,5224
1480,8489a61a11a2ee69fd61ecc4ab007d58d2b6f132553e29b296a59e8bfe513355,crypto_miner,1255773,5014,10164,10289,15303,10164
1481,84b6d3cc5217cb80571c7a4dc0261a4c59c337b95d585fbeb4f6dba86a33b6bf,crypto_miner,649687,2633,5101,5219,7852,5101
1482,853b7bd81cd60c8ed4a8170d75f53f1b9c6e3ceea00b0aef2dd525e9d462563f,crypto_miner,1255772,5002,10154,10276,15278,10154
1483,85dd8a6efa0be082138e33de3aa9fb1a3fdd9efc2d6fce8e3312a383f1107905,crypto_miner,1250769,5195,10175,10454,15649,10175
1484,85fd800c97c0eb1194968940ab12227b66f909d8f32996ec2bdcd281bf678b2b,crypto_miner,1255768,5001,10156,10287,15288,10156
1485,861c110ab4d55f553a376b55972eb753343a3d056e3b6bada307630a576149d2,crypto_miner,1403260,5477,11037,11581,17058,11037
1486,869bd0580dcdf17deeb8530a3aaed7cc3a95680d76efadd78e6e8656ac357ff2,crypto_miner,1255771,5003,10159,10279,15282,10159
1487,86c7cd5d91078b163c16238476d07534eac2964fd5a962a54ddde82c9258a351,crypto_miner,653082,2574,5034,5249,7823,5034
1488,86ffe4ba967169279470d0740c3571ffffbf63068657bead6bc5bdf061faf587,crypto_miner,652881,2635,5126,5276,7911,5126
1489,870d36b15441cd8b7e0aadc2ea053191393fe8d328e16bb35eab4626eae79e9f,crypto_miner,976645,3759,7686,7939,11698,7686
1490,8717f0adca6219c2c4a33db5ae9751eeaee93f2f8c86bbee47ac9c03ba873ffd,crypto_miner,653079,2587,5008,5351,7938,5008
1491,87193e419c18641e03ebccc147898a607fed891708b0fca30b7fbd712189e4dc,crypto_miner,653041,2489,5058,5340,7829,5058
1492,87596e90e8adb87f8ee7ada4aabf8d3e67b484897473383a86e0e6971e02a482,crypto_miner,653086,2565,5109,5281,7846,5109
1493,87adc097ca78341642faa9b601416565c0a3a2599c95a528b08cf77add735dd0,crypto_miner,1255769,4990,10147,10257,15247,10147
1494,87bd1faf79bd601b3294d6f576897421fedf38764d3c27fcd0b0e50a20dfc116,crypto_miner,306201,1231,2551,2561,3792,2551
1495,8827406c7bad409de58621353de104f64010c5910cbea87423275f51ac000511,crypto_miner,1255772,5003,10148,10295,15298,10148
1496,8878399239fbf5979caf2cf6ae6650eb604646f08cb495a49be62b09bda250cb,crypto_miner,1255770,5007,10157,10297,15304,10157
1497,887b16d7a5fdf7949ee5bf7e76c43473ccf939fc819fdd2f8d5696e5fa3ed558,crypto_miner,1250102,5399,10275,10595,15994,10275
1498,88e6815bceae57b988df5138c5c18ca2c285d881183a8589d5b7b7415b2eecda,crypto_miner,653010,2510,5092,5298,7808,5092
1499,890d37c5a835832bda20bf78fd1e4a21a03d26540908e6321ebb529f623d0da4,crypto_miner,1250772,5195,10167,10463,15658,10167
1500,892e3a18f6dcbd8641f78d1c942cd831de64b88e712a71113cced0678be7a20c,crypto_miner,1414762,5463,11352,11424,16887,11352
1501,896d51a4d461bdfb5d770e3578602d6b8d8be1334962e090c65b59bee1c874a4,crypto_miner,1255771,4997,10143,10253,15250,10143
1502,89a5532e7a5d743d437a51bad887da4817d7a7e5936f443713aac797c4af637b,crypto_miner,652757,2494,5089,5362,7856,5089
1503,89b0fa76f5ee0326c39820edde9c79467a3416ee012437b8867cbe33c2b61daf,crypto_miner,1255766,4986,10154,10245,15231,10154
1504,8a780045de34eecb7a58d72da13b969a84e759047f0c3a6db7d16ddc4e1828ef,crypto_miner,1255771,5008,10168,10295,15303,10168
1505,8ab80fc4b4b4fda42551100c4b7b9d4130f124e0b2e73479c553ae693f7f00b3,crypto_miner,1255703,4989,10151,10278,15267,10151
1506,8b23835e64d9eb62f253a1d4a4a30aa67865cf23b9521259cd9faf215953ccdc,crypto_miner,1255770,4992,10166,10276,15268,10166
1507,8b277e1458028713cbed6f148efb6670e06e201eb0c8d21a19e423dc101ff600,crypto_miner,1255765,4998,10163,10288,15286,10163
1508,8b32df691b3cbe6165283bb3ab30b321326deb9d2a4591553712232e0f0f6f46,crypto_miner,1255770,5002,10164,10280,15282,10164
1509,8b4763a60bef6c41eecb0824ca1faaa48c439bbb986ec271c3ec43434c886542,crypto_miner,653061,2581,5044,5340,7921,5044
1510,8b655d36213e9ab1ac32f638a450dff95cfaca542495c6a805a10eee8dbf02ad,crypto_miner,1255772,5006,10173,10299,15305,10173
1511,8b93fc96e31372946e02eb82138f9c0a5090591e276a532e8a083d07629a8c18,crypto_miner,1255772,4969,10159,10257,15226,10159
1512,8bb838d8d5f9c7b9b3b52535836c9740f0b1261a066d357af58f5407b84cf5f2,crypto_miner,1255771,5001,10164,10277,15278,10164
1513,8c0f2572b59e2ec8c4541d0ceda055dd4809dbf276240acdb09b90e831024318,crypto_miner,1255670,4991,10131,10275,15266,10131
1514,8c192c163d08741e087ab01da11b423a1b456d760d032f8351fb3f1ac0dbad84,crypto_miner,1255769,4991,10142,10265,15256,10142
1515,8c1e129db7f809a2432551e69744f217ee797b20545b88e41d2eb9525d345d82,crypto_miner,20364872,80142,159776,159387,239529,159776
1516,8c80f38b3ec3dd4fb33a7e50b927e137ff9b0ae7ef1ea68067df60abccc6f40c,crypto_miner,1328380,5371,10572,10546,15917,10572
1517,8c949601a0fa5ad038fb38442d9b90bb26cf3301373fbcd782244f34148ee013,crypto_miner,1250781,5196,10159,10435,15631,10159
1518,8cc7d261fa1f50bfe9cdf210808701f94e392a87f6d6b35ef366def42f88202a,crypto_miner,1250161,5403,10292,10616,16019,10292
1519,8d1d8c1417e611f38831fcb3ae7789cf3acfa2c7297a0cc284067e31c499c596,crypto_miner,1255766,4997,10168,10255,15252,10168
1520,8d2d1780f51295840b866840a2412a7e267f911add95775777c8a3b5a07d5172,crypto_miner,1255772,4982,10149,10265,15247,10149
1521,8db7f67ca28db679a6c8b79b6ca4894604aa146d17abd42b0b7773c16c2465e5,crypto_miner,1255773,4981,10176,10273,15254,10176
1522,8dc9fe2134e3ce58b526996998ab57089faa419731c15fae64483d5ecaa9f765,crypto_miner,1255770,5001,10146,10297,15298,10146
1523,8dcffd030e88bf2507c4a5c1abe52418d78bae1e140b568c9070447c6b38b21d,crypto_miner,1255765,5002,10183,10274,15276,10183
1524,8de6c323deee349780339480a2c64175736f5228a230ebf2015912bfea66100a,crypto_miner,1255768,5001,10151,10288,15289,10151
1525,8e15979cac340e157f95c9be950a3dcfe2485a903c2ea7e6112981509a83662f,crypto_miner,468421,1955,3744,3745,5700,3744
1526,8e260cfd87882f907a9550526937c5f585911a949654ba46eface724278f254b,crypto_miner,653040,2580,5138,5311,7891,5138
1527,8ef880ee1c370790fa8c83032ff9db89b03663d9639248cd1e03d06a53d91458,crypto_miner,1250776,5197,10157,10464,15661,10157
1528,8f0530a7d489591e1bad5bd65afa599ac7a9cf41a5433a6bf38000bda29a1c6a,crypto_miner,1403260,5477,11037,11581,17058,11037
1529,8f30fd56c820f2bd8da9c978b7a7beb0cb233b52f12bec464df668155a683f6c,crypto_miner,1255770,4996,10155,10281,15277,10155
1530,8f8425fa3d3bd1a8b9791303002e3c16b92d2c4985aa82113accb41c7ef8bac9,crypto_miner,1255769,4999,10125,10285,15284,10125
1531,8fa91950162f20d6c2b20998381e63712df65b0913e1de279f351d723abc61c2,crypto_miner,653071,2627,5114,5327,7954,5114
1532,8ffb942bb3af46b04f353421017d4dbe13810a1bfc0e4ddb970cee99f99d82e5,crypto_miner,1255769,5008,10165,10287,15295,10165
1533,9000bff8158aa6bf98e660aadb7f3f522ce7ff4ad22cdacfcaa41a2b82b19a44,crypto_miner,652877,2537,4991,5488,8025,4991
1534,9007af764059c8d013043b4d562acfd511a4104fa0d47ddded5bebdd7ed0a114,crypto_miner,1255771,4988,10145,10267,15255,10145
1535,902d0359d869810325e58b1b3ebe3a77d5b045d772c3f1ca09f6b1929b63199a,crypto_miner,649633,2474,5147,5244,7718,5147
1536,903c988b1f35ca4dde9419b88c3cbf7290d881b89a1935ce1579c16d644ad150,crypto_miner,653044,2599,5092,5326,7925,5092
1537,90a2e37e9b0f9fa7415b64288cbdca74f962de2610cc311082897fc9c9646f8c,crypto_miner,2196178,8539,17079,17058,25597,17079
1538,90a715dbbe5fbef979799e9755b8fde2c5397f6f151522540553304a1161802c,crypto_miner,1255769,4995,10174,10284,15279,10174
1539,90c7a709378661562f38ccc2fb0ac12d96b168c9f28f9b443b6f1aada655f22d,crypto_miner,1255771,5015,10166,10289,15304,10166
1540,90dbbe333b15157bf4ff0f38ed6bbc0d811acd1080c3c401b5c4e5b11b6223f8,crypto_miner,3180791,12530,24966,24913,37443,24966
1541,90e3758cb2a8f1606f98e887ecc346a9f7aa17c5fd42a843637ad88fca74fe84,crypto_miner,1255764,4998,10159,10304,15302,10159
1542,914b9c8664a3a3c5ec345ee280b16bbc7401780e4ce262431e1bd1c8452cee24,crypto_miner,653011,2543,5154,5356,7899,5154
1543,916689d19beb0e4d948f7d75c3dc5ba11ded48c2f8da4b6983bef157d3c9648d,crypto_miner,1250779,5185,10172,10482,15667,10172
1544,91a0f8ea3cf20f0a6f51337f9f1443dd90d282852019726e751b21cebb43679e,crypto_miner,652995,2595,5155,5291,7886,5155
1545,91ad8b1c15483f44ef05755d99833eb6681e5189cf6082fce76434ecbdce7f86,crypto_miner,1255770,4989,10179,10290,15279,10179
1546,91cfff7986e5f76c1b98f0166d20f7f71bcb32e7e7889ad33beb4d7a1a47a44b,crypto_miner,435056,1994,3403,3529,5523,3403
1547,91e8218192cff84eb84dcd8ed08f56129a0d5b0160d3e91054c0a96f74755f71,crypto_miner,1255773,5010,10146,10302,15312,10146
1548,91ea57c8e0e9da971b55fbf7d18b42c9cf3b16797ec4ecf6f33066f850b91477,crypto_miner,652913,2590,5100,5432,8022,5100
1549,91f94b80f9b0c109ae81d6d1abc68323f842b93d44eb495cea71f1baf55eaefc,crypto_miner,1255774,4983,10167,10288,15271,10167
1550,92138163aec91e150daec7e0431e44162092f275a1ef91f462fca37dffa0e1a6,crypto_miner,652737,2532,5035,5349,7881,5035
1551,9284d47a67b824066687c558a6e23d8b88de17e3202e04fb0859d75d53ad17f1,crypto_miner,1250772,5186,10161,10481,15667,10161
1552,938e11182567a4a87b49c52c4be80414f3ba5b66abd28260dbb99e8079e09a40,crypto_miner,653053,2510,5116,5197,7707,5116
1553,943359a46563fb1b68423457d858dc12f97ce357cb187ab015339dfcb6e65b45,crypto_miner,653035,2533,5196,5255,7788,5196
1554,9455248a391cea48a1aa8e6a11863b7e59384dfcb4ba1aa35b8244e634e85e8a,crypto_miner,1255770,4993,10159,10256,15249,10159
1555,945cec41ae5ea27bb8a963b5d84bb3361d0369d4034866d75b731489e6a5b8bc,crypto_miner,1255767,5006,10154,10288,15294,10154
1556,94b1c36c31abc221c122131045cf622fdef04cad7b1f2c67a19cf11444f9b3f6,crypto_miner,1255772,4998,10165,10276,15274,10165
1557,94cbbdf28324d418f117681048b6104825a4e995d80a317e9a8bc3c6b2db0e02,crypto_miner,1250159,5398,10281,10605,16003,10281
1558,94f2a4a5f6b36f1929bb1a145821c3222592e87eb4272b5d539120b7a291f5a1,crypto_miner,649606,2548,5096,5356,7904,5096
1559,95168e2fa5ddebad46d01177a60efa6b567b7f608e39ff6df5c602ef7875a945,crypto_miner,1255773,4996,10157,10265,15261,10157
1560,95ecd3565aa73a00d40636fe9e94985d8d52a9945ecb43642b85c75e4863ed8c,crypto_miner,1255767,4998,10132,10274,15272,10132
1561,964393fc260e9909c093459e00542e8b6a2d414d1195ae96900724a9d1a044a7,crypto_miner,430001,1781,3303,3594,5375,3303
1562,97822fac5a9976553c7b90b5fec34b2259ba5f61228e989ebb26124bf923bed6,crypto_miner,1255769,4988,10159,10293,15281,10159
1563,978f6e63b5e3a7deaab9d9673b3fb89a4be776a575c293045b8394bb1f616e09,crypto_miner,653076,2687,5064,5362,8049,5064
1564,97a20ed3ac96fbe01f4a203125c717148431c701dd170e355f756e82b4e6beb9,crypto_miner,1255768,4991,10138,10275,15266,10138
1565,97b07e28499144f5f694ac1a72a281e1b3d150f65b2a61263d0601a5bacee7e1,crypto_miner,1596378,6356,12568,12819,19175,12568
1566,97c8dbe3214260bc925c07d3eec2517d80c1bcfb5d7e884bb23e35e4743855c0,crypto_miner,1255767,4987,10153,10294,15281,10153
1567,97e0974db215d3eab3400d9cc1e171143ad9406b007f339f49e2c60a74d4b579,crypto_miner,649646,2568,5120,5173,7741,5120
1568,97e98022c164399b00c54684ce79bd50771dc0bb09fb9332f638c35d295427a2,crypto_miner,1255771,5009,10172,10268,15277,10172
1569,97efedb8acbaf25bdb3ccf15fcd14113812f5d7a1c5ca781a6bafe2f6424bdaf,crypto_miner,1255771,5010,10174,10292,15302,10174
1570,99e25a0cd4060e2ac9d9f53ee506fcd36c7cd327b237781f0c4d30c91e274bc4,crypto_miner,306393,1312,2424,2619,3931,2424
1571,9a153c4a6557e94358f9c2bb964a9981aaeaa773d6d64c98de3709c870b55aae,crypto_miner,368921,1543,2866,2957,4500,2866
1572,9a43039d10cbaa26b0478c3096c52180e4b31b39fdc0856e9d6d144d76e1a7ed,crypto_miner,653127,2659,5151,5322,7981,5151
1573,9a4699d576ac54142aa6bc5f374ff0c606da1bfb91ccbf7bddfc932a6af58959,crypto_miner,653032,2670,5193,5361,8031,5193
1574,9a4ffe1bd79a5582d96723533b41801fe2dcd5f1bf7790ad5f5fc925f1ba6a51,crypto_miner,1255768,4994,10172,10287,15281,10172
1575,9a6373bc8a4633da271f5d3f01ce7f8d0e1b131ad9b5dd47c62e19535a7ceb9f,crypto_miner,1255770,5002,10157,10288,15290,10157
1576,9a94ab4bcf502535a8042c98d1513b357d6e303292ffbaab4735c88b2720a7ad,crypto_miner,653101,2609,5064,5311,7920,5064
1577,9abdcc16d4450e29b91247d1311755c07f05f506e6faac01475254fe0b9269de,crypto_miner,653050,2371,5134,5172,7543,5134
1578,9b175e5489a33b99e8e64957ab4c8f1368ef52d78a6e5137b9618d9262bff774,crypto_miner,4334597,17136,33508,34113,51249,33508
1579,9b5ef3726602ea0920926030ce28ac065e34358d76b28a1fc316128fd03b1a61,crypto_miner,653112,2589,5024,5232,7821,5024
1580,9b64a20b3745de8e5a34ee8f51f54396e10bef07e88eae471511a1fa6cab6eea,crypto_miner,652931,2555,5059,5314,7869,5059
1581,9bab244f71a5c013a318a18ab8b034fb16484aa694bc943fd85f746e1b0a8eb5,crypto_miner,1541105,6145,12172,12218,18363,12172
1582,9bab914e16e885227b3832ea8bfa6fea0c9a81607bfa1318b8e972c33d318221,crypto_miner,1255771,4996,10140,10276,15272,10140
1583,9c3ecec95af46d68026d3f79f8bf3267193b4632f3018ef2f8baeab4ddf12871,crypto_miner,1255730,4992,10155,10273,15265,10155
1584,9c44b0dfbb7adfe01d00f41da9cd02deb73bf59e9a98bff7b93afa7ae1cb668c,crypto_miner,1255770,4998,10147,10274,15272,10147
1585,9c95d866581c45c67393cb2da1bf78dcc352c5cc26d08b42ad5676f9955222a2,crypto_miner,1250777,5192,10173,10455,15647,10173
1586,9cadaac2122ef70b7ef49af45e579e8c9ac2bd678be99b0fbad5930acef8a6fa,crypto_miner,1255771,5007,10177,10283,15290,10177
1587,9cb3d93192e4b3418d78a27d1d0c2a95400cdf7ea64321e8047cd0b118ff0c94,crypto_miner,1920195,8085,15065,15548,23633,15065
1588,9cbe48630471dab8a7f887d52fe82ee711fbc939b3104ce4f83fa84033a2e143,crypto_miner,1255770,5004,10157,10295,15299,10157
1589,9cc12c5c9effcebee5a0f950b70f4764e477c1271b124faa51d562c5c8194ae2,crypto_miner,1255771,4992,10176,10301,15293,10176
1590,9d2d567993ebbdcd18d127eaa2dde52166bd9f6ae694ebfc279973d1aa57ffd6,crypto_miner,204065,799,1447,1450,2249,1447
1591,9d6a5babac72fc7abd62c6c6995e8de8260c1c1f2d22767efc5bdbd7e7e54ad4,crypto_miner,1255771,4998,10143,10283,15281,10143
1592,9ddc8244a57c221596ab74f3a8034b5e2366c1bcc8bc524464311e772302aa5c,crypto_miner,1250165,5404,10293,10619,16023,10293
1593,9dfa7a19dfd41565b179c3c129448ea308fdfb28f575100174dfca1c9ac0a2e5,crypto_miner,144937,568,1130,1167,1735,1130
1594,9e02623b9c8fdcb628e81686f83e5c3781426c9befafd1a0ea1af527d13f5938,crypto_miner,653077,2583,5205,5301,7884,5205
1595,9e2920b4e9d550cd8f0908ffb53ba9ba7319f761ca34f861fe41da1c0ceeadc7,crypto_miner,649604,2653,5241,5246,7899,5241
1596,9f31faff61e9f9d0edd41c0476111d961d5da5def4eb09ac5ab2beb6f6180c56,crypto_miner,1255771,5010,10172,10267,15277,10172
1597,9fb35640eae9f5746050c3165973ba32f22007e2459da3336a53b1051c59e94b,crypto_miner,653062,2557,5121,5272,7829,5121
1598,9fbbd7d6f48bbfb01ba530fe261daa739904aba8dc8a0d11e9f356fea5642b13,crypto_miner,1403260,5477,11037,11581,17058,11037
1599,9fdd508e2b57f0080acac7fb149f059f8c0295dca36f3d602bbb237a8e162885,crypto_miner,624066,2463,4752,5026,7489,4752
1600,a001baddada3185e1e1102fa9ad534328c3c2dda172bdc441537b8bdffbcc90c,crypto_miner,1255768,5006,10174,10274,15280,10174
1601,a0185efa4ba14fbae5bcb76bcda514a7533cc30fa7745a2ee813e942e363ad7b,crypto_miner,1255772,4987,10173,10281,15268,10173
1602,a065e3270c12a5d048c03ba68b29eee177f204d737a2fb07f39c29ec8f248834,crypto_miner,1255767,4985,10160,10276,15261,10160
1603,a0be19f4670d6429c59b506b4167e53bc0ba703236051277f0fcd8908d9105c6,crypto_miner,2196178,8539,17079,17058,25597,17079
1604,a0d414cb4813c6c22a158d96b16f760eb71bb9f5d3537d7e0a9659b7f70457e9,crypto_miner,1250770,5196,10168,10474,15670,10168
1605,a13e6dc6d289e86ceac9b0076db52b76457d3e2198f261f7f1ffc3309d5ed144,crypto_miner,1255772,5009,10162,10287,15296,10162
1606,a16398ad5dbaaf218fc58d4c6920d13cb3278824602864583054c81c70b690a2,crypto_miner,1255770,4984,10170,10238,15222,10170
1607,a219afdeb94b2172e767f475de9ab738892f86cc1314fb0441d887df860c1602,crypto_miner,653060,2562,5069,5344,7906,5069
1608,a233aa60f052681947ed83930ac68d58729eccc713e8b39d71761828d299c22a,crypto_miner,1255767,4994,10154,10273,15267,10154
1609,a2ab5bf8aa6676623af2659c8d336671ac49ebeee22ddeda8fbf48a46ab17f13,crypto_miner,1768288,7299,14150,14181,21480,14150
1610,a2c3b34df9401935c19e90df75043d22e6f468e32d0a7573ba9e45d4bc8d5a67,crypto_miner,306201,1233,2511,2563,3796,2511
1611,a2d46d3b0ed90617e84111f316f386967eb72a54b487006a82f1e3c53c587d76,crypto_miner,1255771,5007,10177,10283,15290,10177
1612,a2f1a4b99215775e314cdec20b3e8a097ddcbc312fe1d499734c2c0bd091ac99,crypto_miner,1255768,4981,10155,10275,15256,10155
1613,a32d109d26e5320107482d4366c36f3d022c984ef9dfd53c63544da62783586e,crypto_miner,1255772,5003,10134,10292,15295,10134
1614,a3895e9aedcaddf59b649ea6608060e785f367042e078fc36e7d421b999c88c2,crypto_miner,1255772,4989,10181,10248,15237,10181
1615,a3d638921fccfd238487c4282c17101af1cd0ae98539a2f6abe201f17351fa71,crypto_miner,653013,2571,5033,5403,7974,5033
1616,a3e5c6a3dc4b697878fe17151edbb31b7eef4ad56f4b0190aa60c6673c9a318f,crypto_miner,1255772,4997,10156,10290,15287,10156
1617,a401fb1e59ec985bc46e6577c39e2202ab16b95d15346b288e9f912c68faa313,crypto_miner,653146,2677,5134,5349,8026,5134
1618,a4167e51b69d82d33364d8483d16b72c2b812fed7158d932c60e8179ae69ee8d,crypto_miner,1255774,5002,10174,10280,15282,10174
1619,a4637f9954523cf679d815c228986dad787a1abc5af85cc0448d193365fd912f,crypto_miner,1255775,5001,10158,10279,15280,10158
1620,a4781a35de79fd56de83b7348c96a5cd2da2abadfa826b07e563259ac58bf8da,crypto_miner,1255772,4989,10159,10281,15270,10159
1621,a493efeab31250c91a709a76196a9934f3128757c69f62c78a188b75688de278,crypto_miner,4334599,17101,33934,34363,51464,33934
1622,a553cf4b0ffc87f774701acb1b308b7e0c7d845bb77c68a61d5cdd27aa3d1dd8,crypto_miner,327125,1426,2586,2557,3983,2586
1623,a55c40525ffda8f96e774e933f86fb88d2bd6bbfc3f15dd23103582c28726249,crypto_miner,653019,2577,5038,5266,7843,5038
1624,a65c2568fc06115dec0e47285db7a09c2d11d4ae52ea80d7450d2564ba07ceb9,crypto_miner,1255770,4999,10159,10275,15274,10159
1625,a65c8e5502c1f8e91ce7367a761032b1b0e967e0c0df2b6a0458f9c8cbbc5fc8,crypto_miner,652825,2518,5148,5299,7817,5148
1626,a6841e48bbb069730ec37be3037e4864dbe0bf9541ab673aee9a965049b0bf70,crypto_miner,1255773,5016,10156,10286,15302,10156
1627,a69777bc62c04daac52921ca4e7eaf94b0f871354c3445d3e54c6d5374d0a147,crypto_miner,653068,2517,4998,5351,7868,4998
1628,a6982d8e2391be536a49d96f39a057bd8ded874766564de231ca1a11abba6ae8,crypto_miner,1255767,4980,10152,10300,15280,10152
1629,a71c17118bc8630b25b80aeac47fb58dd25ef0de484d6e733eb2e55e6fd2971a,crypto_miner,439026,1911,3425,3535,5446,3425
1630,a7708c98a021e9a8a4b2cfd6b62e1e447b26160639d196ac569fe70cd87b72bd,crypto_miner,653030,2548,5157,5333,7881,5157
1631,a77ddd911bf873f09fbd13a4ffe767545f9621b5f08cd4993033a818af3457fa,crypto_miner,653084,2592,5145,5223,7815,5145
1632,a7999758e0d9bf641318ebfb3296ed74262bd58c7e7dedd23ee42c985f446581,crypto_miner,1255769,4991,10153,10307,15298,10153
1633,a81a6a0ef2db8a44b4a5e977c3da04cd280a14bbbf38faa16327f8ac6b628884,crypto_miner,653022,2624,5073,5382,8006,5073
1634,a89969924b5febad85c156cfc060c4b52e6801aba1a6e43ab10e709b12275ad0,crypto_miner,1250777,5201,10159,10467,15668,10159
1635,a905d09a01db31f510c86ba7af4bc6e8c40dde79c212deadbe65e21286832fb4,crypto_miner,653082,2616,4990,5210,7826,4990
1636,a9069b59637687ee9cd24fcf1c6cc587ca8276ca0765f6985fe29d767c0fa7c5,crypto_miner,653089,2571,5053,5283,7854,5053
1637,a95543a65ae2c31a2b7f3b042c24fb987897c971792f9d31a9710ed86ad06f00,crypto_miner,653085,2587,5036,5306,7893,5036
1638,a95a292ffa5272d900e894deabb36a96952ba7ae79faecee0452f97c09c5b9c9,crypto_miner,144937,568,1130,1167,1735,1130
1639,a9cfa81452be8e5033d7263153cd6f31c7f8bfef64009be0317487d92a58b8c0,crypto_miner,1250778,5186,10147,10455,15641,10147
1640,aaab2694cd1e823b3d2c7372e5cbfcb4b2ba039af82c6496122a7ad9c675a25f,crypto_miner,1255769,5006,10144,10276,15282,10144
1641,aac93940884c9376c1631c59d1b6c301d7872af75d196b4c5a6d15622fadadcc,crypto_miner,1255769,4993,10149,10290,15283,10149
1642,aaca9844c21b97731df78d8d4086fb2a4fd8ed2604e3ee47ea668e12c8c6b53d,crypto_miner,1255770,4985,10137,10262,15247,10137
1643,aad704139b865dc906fdadb4737e266513af127b6cc12cda2034e44b27c4685b,crypto_miner,1567898,6226,12253,12617,18843,12253
1644,ab2eefe80ec71318545c73a961b042cd6fef7b4ca0b04c9332f0437015a387f1,crypto_miner,402835,1583,3239,3226,4809,3239
1645,ab4878109d36ba98236837556b6a297a734024aba2fbc84cc47dccfb0fc3090b,crypto_miner,1255771,5006,10149,10279,15285,10149
1646,ab49616f73679372f3977324044b6e181621924830e232ec9e082201970d6f83,crypto_miner,653054,2607,5172,5407,8014,5172
1647,ab5c0d304d638b05fd5819bc4eb1d97122e7bef39e462c78ff0ed8c51277167d,crypto_miner,439727,1797,3497,3451,5248,3497
1648,ab6915dd2cb2ffa806e823608b58133051d8b1612338adc6e445687d79b1c6e3,crypto_miner,1255770,5008,10165,10268,15276,10165
1649,ab6d5847da7193a0d0c954fc4b76b1527ad97ccffd6ca6a8e0ffdd928f386415,crypto_miner,1255769,5003,10161,10287,15290,10161
1650,ab827656bce97f813b0dcea3ccc89974c95d0fa08d382d46363d1d74af089ee2,crypto_miner,2196178,8539,17079,17058,25597,17079
1651,ab869b4a5b1b8f958f5de90b72bddcf61cb2213d58ae5526caf48ca509a04cbf,crypto_miner,1255770,4988,10163,10261,15249,10163
1652,abc7b6e16d4646b05e9edda615e04eb6b6a6656bc149b1b18282535ebee59f59,crypto_miner,624256,2584,4969,4968,7552,4969
1653,abfb362db30ad420d8af928a1bb03ca849668705539328f4e759364028db97f9,crypto_miner,1255772,4998,10135,10278,15276,10135
1654,ac0670509ea2e8d6ce238657fb96bdcd7ad516f81aa866f0f3ddf5eaed010baa,crypto_miner,2682479,10448,20909,21430,31878,20909
1655,ac09c236fd29388301f5cce954a8aba2ca0a982689bbdc888a1dc01bd5ad93df,crypto_miner,1255771,4995,10167,10259,15254,10167
1656,ac39447211a92838dcf4d74290e387e9db44872639ae6068fa770089d138c0d8,crypto_miner,1250775,5189,10181,10484,15673,10181
1657,ac71fe801df0785a9fd395cdb6906b83d2f4070b368a2fd204c560995a8f53c3,crypto_miner,1255770,4987,10164,10271,15258,10164
1658,aca9fa88b3b6f3472ff4c69b72145e2caa66df09847917792cd2a3194dc876c6,crypto_miner,653069,2636,5070,5499,8135,5070
1659,acc5281776d352aaa491fc431d715d770afdd2e549169ca8031210a0dcdf9323,crypto_miner,1328380,5373,10572,10551,15924,10572
1660,ad1e2a7a34e8a52848ced3380dea79e7592310b9ce811512b23e70eb8587f271,crypto_miner,1255770,4992,10152,10266,15258,10152
1661,ad6229a0e40f5f41a9cab4667519875f90801217556f7ba6daed3eae67a3dcd1,crypto_miner,1250168,5415,10309,10616,16031,10309
1662,ad796ea99c56afeeb0328a36b0eee63237d8b3bda2947d2841bb5a2c1f0f9cf3,crypto_miner,653066,2562,5104,5224,7786,5104
1663,add7c52f8197f3d9ec2675a9c347550069e7cbfed9d6d66286a8566f5ccf4eca,crypto_miner,649569,2580,5084,5331,7911,5084
1664,adde9368a7b350c258340424c71959f27cff500b4a6922ee5a26ba0587531998,crypto_miner,653094,2546,5110,5425,7971,5110
1665,adf0e26c870c23ba52602eaaf1f05f088426386d2bada22f61cea33963fb97ad,crypto_miner,653016,2524,5061,5260,7784,5061
1666,ae161740f7a8d92900324fccf3ebd5a6d8880f82eaf9849c925618d09d71ae6b,crypto_miner,653072,2586,5002,5432,8018,5002
1667,ae19d3d4a7f6da061a08c70b193b02cf556a72145a2a240d7bb17879aa8e8f08,crypto_miner,1250770,5184,10147,10453,15637,10147
1668,ae3bc8c94b024428e80de0d4f287912079f33e422eb90d039991a03ff27d7270,crypto_miner,403786,1533,3237,3166,4699,3237
1669,ae9c7f62f99b11e4c8cdc360836c5c4d121a8469e4bff5e0a245cb26c6e8c8df,crypto_miner,1255528,4994,10170,10278,15272,10170
1670,aeefb247d8f08d599261b7b337d269f04e458eefa7bb10dce0bc2fdc35925e5c,crypto_miner,1250766,5193,10187,10469,15662,10187
1671,af44b64657f5835384d9ee481eca32d89b08c54815106e89a48ea88736e0a4c8,crypto_miner,1255770,5007,10141,10289,15296,10141
1672,af50e01ce6e1cedce37fb29360e7b913058bc2a4a4f3e7c7d341c07b9ee95795,crypto_miner,1255770,4993,10158,10311,15304,10158
1673,af848206a734311f1e5a5e651bd57f5e4ac73ff235b16934d2406650253c97b3,crypto_miner,1255771,4997,10154,10267,15264,10154
1674,af93e54fa1cf9e99049d63777b6d209346c9fb8e1197de402f925997c044a46a,crypto_miner,1255767,5004,10154,10281,15285,10154
1675,b01083bd1620f4886cf2397661da1646256876f2fda7525559c2f77538d27c53,crypto_miner,1255770,4995,10162,10283,15278,10162
1676,b042d46d60bdd7be22f359fce8f02e2361772b81ef7a59c1227128dc1f308e51,crypto_miner,653059,2622,5108,5296,7918,5108
1677,b0b73ca245603e190dabe144b2000748c9c52b89f7fb5b7dfef3115f5ac7e9eb,crypto_miner,1255772,5001,10152,10296,15297,10152
1678,b0c9c4c8cd93be069a8b41cbd407d566e818d95cf07898dd6dec4c4f149c3e95,crypto_miner,1255768,5006,10124,10280,15286,10124
1679,b10c68166b49be8ff382d222fc03998a490cecd85c40400dd0f967c9e22ecedd,crypto_miner,1255771,5003,10150,10280,15283,10150
1680,b1315badf2c62e09a9096bf09ad890d99dc869c9520e4de4ee352ff2fd0904ec,crypto_miner,1255767,4987,10180,10277,15264,10180
1681,b1bb61ab1a89ece9ec994fab2dbcce1705157168e486e653c7f52f31267b2fa0,crypto_miner,1405766,5440,11240,11326,16766,11240
1682,b1c7eda437909d4c984101a4c061fabd135d7647496fbf07f0336e7a33614471,crypto_miner,626300,2498,4884,5089,7587,4884
1683,b2e2c76f5567a18ffa26d27b3d9866467e04aa0e45ba8a12c90276d8bf338a59,crypto_miner,1255699,5007,10167,10284,15291,10167
1684,b32653ed3807c2c5bf68152c75f94528e836dd26b91f163c6c413fa203049e10,crypto_miner,17158818,69415,135523,137685,207100,135523
1685,b388741dd262abe6d528c406613be9b32b39e5fca23f70f8769c422322dd7853,crypto_miner,1255769,4994,10151,10251,15245,10151
1686,b3e618c2da543199ea6dc1e24ce0f9178df99adf77da390a1c594df3469f03f9,crypto_miner,1255773,4989,10167,10272,15261,10167
1687,b4171cade6114033acfda2cf249b70ff72df33e7245d30a4a8276a344d0f600c,crypto_miner,1250774,5187,10154,10458,15645,10154
1688,b46c26280bbda5d273ea109892eb4d4c480c7df5f30a34caafb93fe16a371079,crypto_miner,1255771,4993,10158,10258,15251,10158
1689,b4819a94e569496a6c703fdee4e17ecaeecff841f2dcf1a08f2e7fad0d77a431,crypto_miner,1255769,4997,10156,10298,15295,10156
1690,b4896129a8241e11f86c440f01ae4361d6eb395a0f2260e51a5d8686672bb5b9,crypto_miner,653104,2625,5141,5348,7973,5141
1691,b493961ea6b2e644c21595e80d078b7262c2282dd021a09d1b768f4a179cc3d9,crypto_miner,652968,2660,5096,5315,7975,5096
1692,b4a80556760e23787000ab7f427b231d6abb3945dd28433e3ac9f6acd75bc420,crypto_miner,1250771,5197,10164,10464,15661,10164
1693,b512bdd22233fb6328261e4f06d996fd6c0c108d619c3cea484869a9ce20a612,crypto_miner,653097,2502,5070,5375,7877,5070
1694,b552e70813e1a0e2c549f4762b96de45db15a9a0396e25b50c563e634a78c518,crypto_miner,1255772,5001,10148,10270,15271,10148
1695,b5863a15dda58ae49e9c66bca353bd14904c86970c651b16334a1219fa0e497d,crypto_miner,653073,2553,5081,5280,7833,5081
1696,b5e66d6eef1a52192cef32017150e19b10edc5cb7e8530875ad749b70bef368c,crypto_miner,380328,1589,2970,3090,4679,2970
1697,b604d6c9c2b8f1e51176b6f3c2e0b072cb2f31b1a0bf466f0e9db029dfa12aca,crypto_miner,653084,2549,5154,5349,7898,5154
1698,b61e808dae07793357e0e25adf44a1f4bf8e0cac442a4a6824a5b87b0fa290a8,crypto_miner,258276,1115,2109,2041,3156,2109
1699,b68f0fec97f419b7ce09596cc09638dfdd8a97b9e7e76c59fd3c42ac84e3ba1a,crypto_miner,1422105,5526,11320,11357,16883,11320
1700,b698caa2ab9399d4fac44a6c8e281728c059f632c0946d57be9f0be8b2c1885d,crypto_miner,652991,2549,5190,5407,7956,5190
1701,b6b6af9df263835217888f91e4f93538dffc092c4231ed31bf2e8abf822e3ebf,crypto_miner,1255769,4993,10182,10256,15249,10182
1702,b7095cbe992a7cc2f55bcf3477b048e90030cf0135751b82243633a24d1fe529,crypto_miner,1255772,4995,10146,10283,15278,10146
1703,b769d948f90f3a980c2ec6aebd944e847f0203c7e1fa2f28d3e6517e9e0c18ec,crypto_miner,514065,2091,4146,4146,6237,4146
1704,b79bda4505dbe52a4170a588d59f1796272acd73b4bdc9b5fec5d4ea07ccd5f1,crypto_miner,653082,2524,5051,5349,7873,5051
1705,b7f0fc7d74f4b8ecf72aa46f7bfa238a049776a0209978d39b5f72abc59e548f,crypto_miner,1255768,5004,10139,10294,15298,10139
1706,b87c4dd731475946f20c418500c770bab78c3931584cdeef3ad993f5e2ceb8d8,crypto_miner,1255769,4978,10150,10289,15267,10150
1707,b8b083e8e41e920c66972828e46a7a80c6c394643748d83bbb908da6b9d7df0a,crypto_miner,1255766,4987,10166,10288,15275,10166
1708,b90bdce5a07272bc1072176cbbc2d3149660fc25fe65684651ced96f846f2929,crypto_miner,390116,1665,3160,3087,4752,3160
1709,b911930c92d131c0f3f869b5c07af4391c019d7cf1ce2e058d681ca00c1f5ea4,crypto_miner,2194486,8653,17129,17250,25903,17129
1710,ba0b614a0acfc77c5fe884607a0ec633ddd7922bcaa0abb78d5fe7f25c16274d,crypto_miner,1255768,4995,10160,10272,15267,10160
1711,ba18b5507b46e08fbf6c9759d00579b9de84715c23cc3c6d71cdafc9b7d1de94,crypto_miner,4213404,16718,33064,33508,50226,33064
1712,ba1c378a383308c80b9bcbbedc9ff40c87620ef0e17e0fb768d7bc0ddb653b53,crypto_miner,422336,1809,3307,3242,5051,3307
1713,ba9e4419fc0bfbc7b107a92825ae4eeaa15be70415a4d5fcd1fc18162e61ac68,crypto_miner,1255771,5018,10147,10281,15299,10147
1714,bac35fac54614781291db7c733ae14193f550791e03dcf9de8e4306d0f7d7089,crypto_miner,1255768,5028,10151,10289,15317,10151
1715,badf5443363ba267a883480a4c841f0bd1cab727779c9b84b79003d7cebd7010,crypto_miner,427276,1763,3417,3422,5185,3417
1716,bb09d103808f88084b331a52ba1ce75125b0b0a83d8630f63f2a90f2e74f086f,crypto_miner,1255771,4993,10160,10287,15280,10160
1717,bb10b79fc15b56f78a0bd6da5b5b8025943019f2a05ddca5bfa19e20a448f51d,crypto_miner,1255767,4995,10149,10265,15260,10149
1718,bb970e102c348fb01cb93bf90e335ecfd4dab4134af5802c641d80212a7bbf84,crypto_miner,1255773,5004,10141,10278,15282,10141
1719,bbeeda64c2ebe978b8e8c896a0eebb9753c55ab6574026f4bec811733e00c7f9,crypto_miner,1250782,5185,10145,10460,15645,10145
1720,bc4e3a9c8b27b136d9b7c2245d0432ccb295ae13bd55eb89a259130fb1d83242,crypto_miner,1255772,5002,10170,10267,15269,10170
1721,bca59846ab83bc5bf5d9b956a8a4c2ec1f7525ca1bc2211d43bf8732158434fd,crypto_miner,77587,292,571,612,904,571
1722,bd9886550b229fd7af5c1750c4467086e5fa4b1566d4175aa0a220e7766460c9,crypto_miner,1255766,5004,10166,10272,15276,10166
1723,bdd180510ff57f475f4d029d401b75b53bd53092b23e494b8a532aa8c9aaddfb,crypto_miner,1255767,4991,10147,10268,15259,10147
1724,be0d6482c554b656149401db5e6f770738f0c686d2f23f95a2485a3910a00c79,crypto_miner,1255768,4989,10130,10282,15271,10130
1725,be5a54a9b6ef30b6cd2766532eece9a38739b72597e3975bf0f9bd2fad42cf0e,crypto_miner,1104353,4333,8564,8730,13063,8564
1726,be5e11fcbf56c3a7f1be067320da4f5d94ac66d837b790b453aedcbb364ce941,crypto_miner,1255764,4992,10161,10289,15281,10161
1727,be70ba47c619617616dc739507ddae64df3e3fc1fb17fd3fe3ef9b36ca15fde9,crypto_miner,1469638,5671,11585,11945,17616,11585
1728,bf23b73f131dd04a6c3da9365bfd34df3a64523d91119d07815230f148db684c,crypto_miner,450609,1893,3565,3490,5383,3565
1729,bf442d995e2e1141ddf72e16327f67b4a999edbe78d3c642788b35968a595f74,crypto_miner,1250772,5199,10148,10488,15687,10148
1730,bf8183e58be6f8af68ebca90811b3c4a3f3b99c8b82f18c1693ba77bc5b4be47,crypto_miner,653084,2581,5088,5311,7892,5088
1731,c01a27de04744377cd876fd2accc1bfd627c0ac948383fb170969337b41ee40f,crypto_miner,1255772,4996,10144,10273,15269,10144
1732,c06b28721832c8f1ca159b2f271a44e77b4a9cbf4ee21fe16655e816e3ad457d,crypto_miner,653096,2564,5201,5310,7874,5201
1733,c0c1084010463df8145f75b892dd37ceb81e3fdfaf2e79bdb1f4534eab5fa800,crypto_miner,653046,2609,5112,5314,7923,5112
1734,c104e064eed25e4f1a128bb0c03875ede9f1c1b7c6d43306e58284da864b6a97,crypto_miner,1250708,5197,10132,10463,15660,10132
1735,c125a54f8d718244c5bc43faffc9a84c627eff38efb9ca33d4dc47a43a40393c,crypto_miner,1255765,4985,10156,10269,15254,10156
1736,c1326fdf867c811e5776ff8ffd1a21ef214c744279c977f757428f97481d4f68,crypto_miner,1255768,4999,10158,10277,15276,10158
1737,c1446e31f8371992307d9e3d4ca13ad995f041606399aed1b2e1405186744c61,crypto_miner,1255766,4994,10164,10292,15286,10164
1738,c16ed26c3a7f74d42a09aac876f2a8d47e3aa318a3517781a6efe3ed3824d811,crypto_miner,652884,2656,5172,5382,8038,5172
1739,c175d659c9bcb7708af2add8e50a01ac56b6e2dd4130339ace9fb56b601e1ca8,crypto_miner,1255769,5000,10163,10282,15282,10163
1740,c1935646da5bf4e559795e0099245dec041a32873bd0da67af6eea9a48b5be32,crypto_miner,652736,2634,5240,5234,7868,5240
1741,c1ae771206be0532c36ded22dd6226053ce30d41db9f7b7c4e4cb068c02a7eb7,crypto_miner,2196178,8539,17079,17058,25597,17079
1742,c278c8a6d872d29fc1ef417acb15fa83b2a6d9f1aaad430d8e3e939bd0b71c16,crypto_miner,1250770,5193,10156,10482,15675,10156
1743,c27e1e7dcf43a8bbd5e48310c4baf73a4cdfea913faedb069fa6981c72664162,crypto_miner,649526,2633,5032,5142,7775,5032
1744,c2b47ecac3a9dd2e301e9b3dda05edf734488fbbed7e71a3693ba2629296bf37,crypto_miner,1255768,4984,10145,10283,15267,10145
1745,c32f5341f9b9a772357356622e31f8f259797b31226e6ea54c4fd4ce7e37bc9c,crypto_miner,1255770,4989,10146,10263,15252,10146
1746,c34a15503bb4af82c9dc6c0e31ab535e37bd2081f97349e9c20dd2ed8d77bbd5,crypto_miner,1255773,4990,10170,10295,15285,10170
1747,c3607445e2869f31be6206e4619fc63622cd4ef3366170b265c661868ce3e748,crypto_miner,1255768,4984,10141,10297,15281,10141
1748,c36b3f0238a7852a23d09fee1320a083869d0cdf901871384c82d13d89232618,crypto_miner,1255771,5006,10153,10261,15267,10153
1749,c37eaf97c04c951ca123b34822e1fd22c39fe561db2eb75277aa6b708534794e,crypto_miner,653071,2536,5197,5207,7743,5197
1750,c39e63ae0f2550ab10edf5cf2c243416781fd946b1963d069eff3edf5f6f893b,crypto_miner,1255769,4987,10140,10266,15253,10140
1751,c3e93f6a67391e2006954dcefc5cfd6789e8d200857243ecd8e21b15766a4dda,crypto_miner,357480,1529,2822,2860,4389,2822
1752,c4365fe93707b47fb9e17cd172f8fcd0e2cc1936a7553f0093eed31fab266217,crypto_miner,1255769,4999,10162,10278,15277,10162
1753,c58a28ce9f5541b36e364f375e2d620f6c2208d0fd87dbf7d37b47f9ca2d820d,crypto_miner,653090,2588,5120,5429,8017,5120
1754,c59c7379f8994619452cfd514c2fe7256ec9d57017867ec08aff4aea0fd2038d,crypto_miner,649595,2498,4965,5309,7807,4965
1755,c5bac91929bc312a8caf06593aa1c96efade4afc33da2989a98468f8d052ac30,crypto_miner,653051,2596,5224,5365,7961,5224
1756,c62c0b9b45c72bfb4a37bd481b73d875a248d14d6ade6b60c74ca8de383e2d2d,crypto_miner,1255771,4980,10151,10267,15247,10151
1757,c663dae22015ad9938bdd4c5e758cb1435155feeef27395f0e23256389903201,crypto_miner,1255769,4988,10176,10276,15264,10176
1758,c682c31aac26ef6974325f21a1f085d6ad340eaa010588f410c12e759b42f053,crypto_miner,1255770,4979,10151,10268,15247,10151
1759,c68dccb65311e8843e080003b2dd3c195d94510c08d4fb952447fa9339ea06f8,crypto_miner,1255772,5001,10142,10286,15287,10142
1760,c6928a638dc5ef2244dc9ee153d44ce87a0a606a371c0b1d6306fa807194107f,crypto_miner,653006,2578,5049,5373,7951,5049
1761,c6da38645004b15815e7a1b7b677645fe7d663948d61925c7bc244f6ec3ea960,crypto_miner,1255770,5008,10144,10291,15299,10144
1762,c71930c0301052a1677dc7a6f0396dce7326452b227d93ffedeca1c9647a4122,crypto_miner,1407250,5492,11056,11625,17117,11056
1763,c74c7ad3aac6196280bcc0ef4656d391800e13a12faf218332512c3a381e8f51,crypto_miner,653084,2532,5104,5431,7963,5104
1764,c7868cd5fce6863d8ac450f5f3cea9b9508079f2ddab0047750e1d4f90783eea,crypto_miner,1255769,4995,10146,10260,15255,10146
1765,c79d050c67dc3c76ab1568fdd3d36cf219d83bfb7701efb94b7ed113f85904f7,crypto_miner,653092,2551,5165,5318,7869,5165
1766,c7ae5af5f4131e9f6e66b61375cdfffcb6f5f08f457b453d55eeb14a3ab839a7,crypto_miner,1255772,4993,10151,10290,15283,10151
1767,c7bbb457fa662b81d6555ad47b09f9e05369797cced42dff42533f6d4e9aa4c4,crypto_miner,1255770,5003,10174,10288,15291,10174
1768,c7c9d5eaf9257fcda8a754ccf8d6ff75fa168b08d55eb5bfca7c33aefb6a7bc4,crypto_miner,653040,2603,5126,5311,7914,5126
1769,c7e2c076fe1b35fc4e4ce0bd9eebf701982bb7a0de9b5a45c05b7180b784900d,crypto_miner,653047,2656,5109,5324,7980,5109
1770,c83331c49789783377c8ee1dce9378e2b7b474ad7195e17c70068f3678408de0,crypto_miner,649664,2510,5137,5219,7729,5137
1771,c874dede497ba8f125210ae665f4247581b4737d80e5341362b9458b43ea64fd,crypto_miner,653084,2549,5092,5332,7881,5092
1772,c884c5fd0d401a0a1d17eb996d43a6a4eb94d1a3be4f709cdfd92cd6b2f45b7a,crypto_miner,1255769,4992,10145,10305,15297,10145
1773,c88e126d03fa438a04f563d9090a160237a59ec396c0096f2fec81f529a6a9dd,crypto_miner,653074,2534,5011,5328,7862,5011
1774,c93c58c2e247bdfa8f5369bc45cb7ade69ddce3a1a1a5755aad7fd52cd57f153,crypto_miner,1255767,5013,10171,10285,15298,10171
1775,c9bc5c2d008b904c792627fd4271c8748ffe92365aa7375e10d6c9aea55d36b3,crypto_miner,1255768,4989,10164,10282,15271,10164
1776,c9efe853e00355e27a29a8263535c06ea614ce5582fc5728fddcb57d6face04d,crypto_miner,652732,2606,5042,5254,7860,5042
1777,c9f0408efa01f27f7bdb17613e1b15416662f6f8786d7699a0481ae44c491024,crypto_miner,1255770,4993,10152,10287,15280,10152
1778,c9f32adb6a8f738d1f6f752d5b404dd3fa3c29155849342c4b6172757d51da27,crypto_miner,1255773,5001,10142,10299,15300,10142
1779,ca19ed247fa5e9183f9ecf0f2fd24cf3cd629ca05aad9140d3c3808c27a97917,crypto_miner,653080,2607,5095,5293,7900,5095
1780,ca7e9de3b6d18664fdfd614d8e5ff772131d76dfd936359bc5aa8c9ab881bb93,crypto_miner,1255766,4994,10135,10260,15254,10135
1781,ca81ed46cfb84ee6464e243c1da3f3889c20f45658fd7faea8436277625a863a,crypto_miner,653035,2552,5036,5281,7833,5036
1782,cab385cd0e271f592037d36ca6a69a34aad85640097ed8b65ba481c3d9c16564,crypto_miner,2144561,8269,16610,17428,25697,16610
1783,cafe935b96b844df1b3e987492aa177f9b212d66f0eac8b9723e66156ca519a0,crypto_miner,4024543,15858,31539,31883,47741,31539
1784,cb1fe2cb197f090ff98cd8b66b02b2ecb5bf77fd314eb2227afc72002b5908db,crypto_miner,653079,2473,5045,5315,7788,5045
1785,cbb1bbd638373b7aa89c0a244a67a9204c07ff39b7218330596960c905fe39e9,crypto_miner,1255769,5003,10160,10284,15287,10160
1786,cc079d1b7a5a8a1a4ae9dee0513289046f0971e16a869ec29041307452bda7d7,crypto_miner,653063,2569,5166,5344,7913,5166
1787,cc1b6c4459696209814bf24f2e792cad9b68d764c53bd753d945349f96936450,crypto_miner,1255768,4991,10159,10278,15269,10159
1788,cd2d7a21960c1562870cb80ed0201723e9b85928482148feef5d397f8385b6e9,crypto_miner,1255767,4996,10132,10290,15286,10132
1789,cd5ffbca0b0cff8705e1cd2bc870d77a2402a090df4153b029feb4c300372f97,crypto_miner,653098,2601,5146,5410,8011,5146
1790,cd99c95193779aacb5a5211090a8dc263aa97c00d505605ab7db2c3dec0e0dff,crypto_miner,2196178,8539,17079,17058,25597,17079
1791,cda0e5ec4fccfa472101ff8410e367021523c26d8085cf6c36178c49c179998e,crypto_miner,1250766,5195,10171,10466,15661,10171
1792,cda1c1bfbf285ab2ed0f0f5a0c535b005886d88a11ffd731147d5b0c7c16f85f,crypto_miner,1250776,5190,10152,10453,15643,10152
1793,cdf4556fee6d3aa23461b49f7422df75e237be4a3822e2274cd9c07aaf014345,crypto_miner,1255771,4995,10165,10289,15284,10165
1794,ce4ef0016632974b1f6f5281dcea66d42ea6d23766c1ae9338d7811a13b09629,crypto_miner,1255769,4999,10153,10280,15279,10153
1795,ce60cb2aaa69d47e4638efb5bb78a1f1fee6c1f86a1fd5ea5fe19c477f6b9a9d,crypto_miner,327126,1426,2565,2571,3997,2565
1796,cf74f519d819a5e0e462e1d42f39a48dc5f5994859b0c71f5fec0065092402c4,crypto_miner,653039,2654,5262,5535,8189,5262
1797,cf998b2815be6cf8211e7ded00930898fc5d88243c5fea234e6308b3da29c105,crypto_miner,888827,3565,6927,6981,10546,6927
1798,cfa0b3e21d128d395e4b461085c484535bec3533d4a34577ae3c2e1ad61004c5,crypto_miner,1250774,5194,10149,10481,15675,10149
1799,d0135dd15b2b288a683d4d565de7452ec04cf564530828bdce78209f320cfdf4,crypto_miner,1250770,5191,10173,10450,15641,10173
1800,d01550c9125ecd5e5857bf4955a691acdd05c6de199b381e5e1c46b56d0a33fa,crypto_miner,1255765,4990,10147,10290,15280,10147
1801,d0511b3b9bdcf3e23f902e29ec59d57def11815feb956620913c8e6ab9b8e448,crypto_miner,1255769,5002,10167,10286,15288,10167
1802,d0a2e871e30558198c7d28a86d49bfd687ff0347500b2c526937dbf4a0fe1728,crypto_miner,653060,2499,5023,5230,7729,5023
1803,d0c30bc0081f28c0bbba289759728d46d9fb2f1d2783adb406c3291fc9dfd819,crypto_miner,1250777,5201,10178,10471,15672,10178
1804,d0e2de95186828f08d079c40019c645f6f905b0e47369f9b04281663a8e83b4b,crypto_miner,1255768,4991,10170,10280,15271,10170
1805,d1080a4f3e382d12887dc3626e48502cdc9008261a48c4288adc7bc3ecc46c01,crypto_miner,1255772,4998,10148,10274,15272,10148
1806,d10daf866cd29430f146242a6725bd30784d3b7b7634ae70ab4b5df7a0627322,crypto_miner,1255770,4994,10160,10291,15285,10160
1807,d13a886fec5875d765ac31ec527b1c76ef3afe048d9c0f4febb17d00820bb734,crypto_miner,653094,2492,5055,5391,7883,5055
1808,d195caa864dce8e27beab17bfece56a5923bdf23c7f076f5ba7d859fd917cebd,crypto_miner,653108,2543,5121,5211,7754,5121
1809,d209a110aef7dec2d78c5bbee2c379f07ba4dd025a59bbefa620759bd172c4f3,crypto_miner,1255767,4987,10161,10288,15275,10161
1810,d234f0bd7d275cee87bd509a7c8bfafcb033849d993fe355e861558e953e942e,crypto_miner,1255768,4989,10133,10287,15276,10133
1811,d24172f82c782a38cc23b197389952098f79043212b9ea7cbf1f50f171eb2e75,crypto_miner,653080,2608,5096,5232,7840,5096
1812,d25acd5133dcebaa3b8aaa23bd623e4f20d72a345ca3646be4d1dc8311f117f0,crypto_miner,1250779,5198,10182,10487,15685,10182
1813,d268d1e8956efbf0353f171dbb40262da2e3670ebfb62a89490adde34198e283,crypto_miner,1255774,4990,10149,10292,15282,10149
1814,d269d72d305d2e8b4fdac79c2a4c540039f56f8fd46fdfb9c017a83cacef3863,crypto_miner,1255768,4992,10138,10294,15286,10138
1815,d279a5f309c42eb96edab8fa0b9091167f3e2bab42edf861da7894edad4d7c65,crypto_miner,1255769,5010,10156,10272,15282,10156
1816,d2dbcddd5e0d4221dac2d27a395930dce2638c3a6b170b354926d14ef419c153,crypto_miner,1255774,4993,10167,10300,15293,10167
1817,d2ffd4202d063b8a968f7a019d99ff966e47f82d322c58dd248ad486244e73eb,crypto_miner,653078,2643,5123,5469,8112,5123
1818,d3143393022f3769be2745c869dd33c12076c1c8ee8213e1832853cb651555bd,crypto_miner,1250778,5199,10168,10465,15664,10168
1819,d346051e158b71b91d495ecc7ebd74c43e529c8c787747b356dd3d9b21a00d1c,crypto_miner,1588913,6136,12639,12832,18968,12639
1820,d36e24a8a93fad17139688c3830cb13fda2078ee0de94562acde0010d018f52f,crypto_miner,1250769,5185,10172,10475,15660,10172
1821,d39b53f2dce5bbd996974504376723b520ce0952bb492192e0ad8d9149553366,crypto_miner,1255772,4999,10162,10303,15302,10162
1822,d3a5427625045400c5cbc950021123120731ccfd8ec9cd87426bf382e8a71676,crypto_miner,4024653,15846,31333,32145,47991,31333
1823,d3f5fcfa59dfac1d39fc1aef41c9a04a593aae1f098c1bc37aa15b1040d7383d,crypto_miner,1255772,4977,10151,10293,15270,10151
1824,d409b078db72b062278010512ddf71c6999014bbd52a07011ded3e1878fa02f7,crypto_miner,1403259,5476,11045,11584,17060,11045
1825,d41d2ef0c2522ea373473f66e18a6639e3d84a37d0c9fd68a6c7552ac86b5f91,crypto_miner,653063,2645,5227,5378,8023,5227
1826,d4274b715098bc99869ad6e1309782a64a179d1c2734b690914e0fa0ef7852f8,crypto_miner,1255768,4992,10172,10274,15266,10172
1827,d447fae164e25b4bc4e7720ae513540df37caddce372f90a2de9015ebdbf28be,crypto_miner,653087,2522,5084,5346,7868,5084
1828,d4a6127b6a7149e60a88e63b0c20ce9a1cda6f1e5431ee63fde27d7ac1cbcac8,crypto_miner,653053,2613,5174,5378,7991,5174
1829,d50fe2ae3dade8b944921f76d37382448c0537726bb940f38a1be64545241c97,crypto_miner,1255767,4999,10165,10299,15298,10165
1830,d556b7779a606e52f69ff0874caf751f8e897d546311c5176fda39f3bb956cff,crypto_miner,653063,2660,5141,5427,8087,5141
1831,d565a1b30117da6134d2e82fd413e2394258455783d746761662a975c8e47c0d,crypto_miner,306201,1234,2513,2563,3797,2513
1832,d5ba9037b649bb55a565a83b89a9810a2c1a3dd6ad3804487bf7c39efe93f36e,crypto_miner,1255770,5001,10148,10267,15268,10148
1833,d64a8650a62787cebec1f8c7da2759d48a6d060de7246565b186b2d13a7fa818,crypto_miner,653057,2617,5070,5265,7882,5070
1834,d667296d238c6b599fec244c6f1457000b27d06519af1bfa66c0c076ed622b99,crypto_miner,1255773,4977,10166,10279,15256,10166
1835,d6919f1458aad3747ed23d3a51257b96a5a81b72bc0dc1fbe9baf48afc797d40,crypto_miner,723823,2789,5691,5564,8353,5691
1836,d6958d8ebc06b81be637851a49958c4a781df88bd0544723f3664560d6229357,crypto_miner,1255771,4976,10159,10256,15232,10159
1837,d6a5104ffb40ce5a380b75fa4d7829a60a6e20b2d9cf3075cd9afced8e4a914a,crypto_miner,1255767,4983,10165,10272,15255,10165
1838,d6c6299a4115232f41d4db7a31c35c12b6eb73cbd0ac17c0726342f62ebcc86f,crypto_miner,1255773,4987,10154,10258,15245,10154
1839,d72e5ed39436de1181278c380011a637be20385e46dc643271b3888f1ba55c62,crypto_miner,652970,2571,5096,5306,7877,5096
1840,d84fffc42ded37cf6b317abe8256b884f87c04025af740587911a6f3373397ae,crypto_miner,1255770,4995,10155,10289,15284,10155
1841,d8968cbea0a5410b6b76f3da2adacf6d94bc14391f3975cb1eca54747058cea6,crypto_miner,1250063,5411,10279,10599,16010,10279
1842,d8b69c8c6b9e6a3b9f049371799e54c193184b03d0030432e3448d9b0c49fc4d,crypto_miner,1255770,5013,10155,10271,15284,10155
1843,da325d19ea25508a7c9995f976eacd1cad94fd997d712bca7aa44239e2acdbdd,crypto_miner,1255774,5009,10158,10283,15292,10158
1844,da3ae1a4a743ae9733c6688852309478ce32763b46a9f54ac75b512c8fec1fe5,crypto_miner,1255772,4987,10174,10294,15281,10174
1845,dae74cf807fe3b21d4bc86708e14b2c951535c64261621640fce59da447e3a0e,crypto_miner,1255770,5007,10169,10281,15288,10169
1846,db1e7eb94052e2deca5e97a95f706d2b3e89d566ff538810ae3d60bcf90d56d6,crypto_miner,1255769,5005,10155,10274,15279,10155
1847,db675832d3c389959484950dd0a0b7398d92676adf5d3bd475816011257d256d,crypto_miner,1255773,4995,10157,10281,15276,10157
1848,db9e9ba83c34c3e3ef792225ce1d322153d58351de8f70709976dcac313f2b3b,crypto_miner,653071,2604,5111,5210,7814,5111
1849,dbcb7d077abc48e666e8ea253745cee012540ad6dfcab76bf3a4d54c55496785,crypto_miner,1255767,4992,10162,10286,15278,10162
1850,dbef82d4e615d18d7c2af3d7cf63e2f8f8441bf4bb5dbed5d223695d78e17894,crypto_miner,653067,2580,5009,5267,7847,5009
1851,dc1737d5a6a536d3f0b4e5cfcb247b98f6a4b3d66144fdb26c0865d1e9347b04,crypto_miner,653099,2566,5210,5418,7984,5210
1852,dc7885cc61fdb28b8d441fbedc46c6a89a55b4d865dcec280a26e63f1da8d926,crypto_miner,1255769,4999,10141,10277,15276,10141
1853,dcdde2ddc09b93cf692e2a6115dee1a64ed4cb8b21048509d4857666ed4e4b7d,crypto_miner,652985,2559,5105,5255,7814,5105
1854,dce506f637440229f3a7404af5b61a3efecef5f029604353fa655a898e305178,crypto_miner,1255770,4994,10154,10288,15282,10154
1855,dcf9ab504eb5a3b1bf3bda260a7293dbb951a1457a5041796575d48896802913,crypto_miner,653074,2541,5099,5393,7934,5099
1856,dd0cad1b3eefdfafa45821adba3d165c95ffcb0cf4aef1e116554fb890f2976c,crypto_miner,1255765,5005,10166,10283,15288,10166
1857,dd9ef3f2f75612aede96ed7e921945e89f815beeb8be42a483fe6ea23ae3e2e0,crypto_miner,1255771,4992,10139,10305,15297,10139
1858,de0933becf63ef4ea85f4d6d9a1660c1c6f223e32d863ad44a554c6493f7b3f8,crypto_miner,1250777,5203,10161,10460,15663,10161
1859,de1d792bfbd098fa1890e1cc412c1aec35e4ae80c776fab3a60b479e6584f5cc,crypto_miner,1255769,4996,10167,10283,15279,10167
1860,de49cc1b7b22022bab6a585c02edf7209a9a34b1f46ccf9420f251958e95df9e,crypto_miner,1250774,5172,10161,10469,15641,10161
1861,de7c9dbfd1f0fda9a296cfd51a94516d5ab64b6c830283d129b49199f017c759,crypto_miner,1255771,4990,10129,10273,15263,10129
1862,de88d3363cbc508d2aed82ad1e241eb0d6ae2bee9207e4db6a400bce335d6713,crypto_miner,1255767,5009,10147,10267,15276,10147
1863,dec27c7b9ee744c02ebcaf3d7ccb605f8be5d6b72888f923f71bc2036e3bc42c,crypto_miner,1403259,5476,11045,11583,17059,11045
1864,ded2a4bb48f40561d2461f53c5e8ba20cc80f6de9874aa72f48d8028637a2b30,crypto_miner,1255769,4987,10158,10270,15257,10158
1865,dee5015554ed5d1f2e7d943ca6c5ad5d9fba0d9895acc52ab4cce12decafcea2,crypto_miner,653060,2624,5118,5292,7916,5118
1866,df467b6892c6cad3802cef07ac6ae9ed0923739ba004884db60eb1e58bb84f3e,crypto_miner,653069,2530,5106,5265,7795,5106
1867,dfacbfa743b3827b0cad679bf1cf20d541b156be9a006b06d1446f267d556b98,crypto_miner,3590430,14246,28195,28929,43175,28195
1868,dfaf863e9ca486911295ece3678146ac4f436dd141e7258012d4730a5a7597f6,crypto_miner,1255769,4994,10159,10263,15257,10159
1869,dfd3c0d36be0aeea8c13576a6d7bdb84b0e01dca2b0db94851638e4c88cb15b9,crypto_miner,1255767,4987,10161,10245,15232,10161
1870,dfddce1783f8dd4da17c0ade4a95a59e92bb7cfdcbd540e8d782ce428e5f8199,crypto_miner,1255767,5001,10148,10273,15274,10148
1871,dff11251b443c156b374f1d3c2b837e99aa72c2c01de1129e533add0d444a925,crypto_miner,378798,1602,3159,3162,4764,3159
1872,e10d1e2f8e80070d9b5dab903fbe0bda4e610021bd93bfb0558fd5f5d800ff07,crypto_miner,1818710,7271,14551,14750,22021,14551
1873,e141496ecfc58a8dfe3185b46bd3c8cc3a87893060ca0d53bbf5c3b1ee584f28,crypto_miner,1250775,5199,10153,10459,15658,10153
1874,e1df2e86fdd3686bb90cf7cbcf65a7c8a6380cd8d1d7a59bd09bf3a13c612a99,crypto_miner,432797,1722,3458,3443,5165,3458
1875,e1e82134bc8cc5698f661042bd1bb99d48016cb4b11d7e11391d583a39185d88,crypto_miner,624057,2481,4983,5092,7573,4983
1876,e2eeed6d267e309a3cc6db711ab7dd91dc8a414a03b55ab3415ee1c179855f29,crypto_miner,1255768,4988,10153,10275,15263,10153
1877,e30ee785835ea8511151810c65eb812f0dda7f50c42a2f8c3b36baece72eaacb,crypto_miner,1255769,5002,10179,10253,15255,10179
1878,e3465b50d815e7687b9723f24c878d4fde385d0753ad41c92699b82b1694b9b6,crypto_miner,653029,2507,5175,5338,7845,5175
1879,e37a6bbd90cc54725039cb0021150c48a035a83fbc7c87286d887b2323af0f82,crypto_miner,1255771,4986,10159,10289,15275,10159
1880,e3d8f734c183411d182163d64e5dc9f353db0e919ca797fc89425d4ffdff5730,crypto_miner,1250778,5184,10168,10480,15664,10168
1881,e3f8aae99c2455b89e9ecfd96f1027b0ffc6c8aaaa8d335ce4a25a4483970488,crypto_miner,1255762,4991,10162,10277,15268,10162
1882,e3ffb785b242ff4b821e1da9118de766e23c76a5b5aab13edf6cee2697fb0cd5,crypto_miner,653075,2587,4970,5501,8088,4970
1883,e482c6a171afcda656963667e021292ab056b8dc9609f2a00a99ea10a33a64c9,crypto_miner,1328398,5361,10540,10516,15877,10540
1884,e4f37dc3b3fed99fed5f254ff70e38f287d296293b916b1ebc57c310dad8ab53,crypto_miner,1250772,5192,10187,10453,15645,10187
1885,e5162fe9dd66a14444301e437c5bd5cc6540a1a8bd08a3154afc59e388ce86f3,crypto_miner,1255770,4994,10170,10275,15269,10170
1886,e5214fc971e444309b36a8f51bb999bf1ec11abb65b860a04dce84617ae0d104,crypto_miner,404762,1560,3161,3249,4809,3161
1887,e52e43917c52fc2a467fdfbdef98e11a48843c2c65164cbc699b986e104e596c,crypto_miner,796519,3234,6288,6452,9686,6288
1888,e530aca5d9085e1d43eb5f53934326fef473189d6376d0a77a7e240c9cdd7d9a,crypto_miner,1255767,4991,10154,10292,15283,10154
1889,e54bb987e051bad4cf069e5e9ca4f1cc37ac3f5c0c8d7f422263574b7c531438,crypto_miner,1255769,4995,10155,10265,15260,10155
1890,e550394599f66a32f2f93423e4e6ed1afdcaf63431880c3539fb380505dfba3f,crypto_miner,1255766,4995,10157,10272,15267,10157
1891,e5d34fd5404ba6f5d5ce594b08bd49f66c6c8d2c249cc65c32b41bd8afff8a1b,crypto_miner,1255772,4994,10152,10286,15280,10152
1892,e5fa402ffa20bef8158f840b210bcf560217075cd7d2a54bc5767a0abe231a6a,crypto_miner,652994,2608,5133,5332,7940,5133
1893,e5fce4cbbc0cde831a1a0b89eb9ef413b81f0dd7625b57bd10ffdcfbe1452afd,crypto_miner,1255772,4999,10157,10269,15268,10157
1894,e60984b026b6789c5b4983b5ada7e6d6d9bff7d7d42ca45c7835c77de8d8fb42,crypto_miner,653019,2546,5054,5485,8031,5054
1895,e612d732fc342630baddc2e80a685d85a4b830bb12f087c469830786cda21d93,crypto_miner,653044,2509,5105,5249,7758,5105
1896,e63c18a6a61dd898b6c12ff105d048f927efa8dcecce5f3d78fee31d23f9794b,crypto_miner,1255770,5017,10148,10274,15291,10148
1897,e67c2d6353a0fd810bd15d38d4a7d0340c66e7c5803b167c708c2d8a0f3c0001,crypto_miner,653048,2529,5080,5305,7834,5080
1898,e6ba9a2f56e3ea9fbeb989bd11a079d50be2c5bd13d18faea4d371c7f12b4fe5,crypto_miner,1255771,4987,10149,10252,15239,10149
1899,e6e15e87cfdc6bf01655d1d3bac96610102018031bb2a65ec089c6fe8766e780,crypto_miner,405744,1605,3003,3339,4944,3003
1900,e6f572796783f729759f9c3fa0cef7ab94e318a9180df288ddb53eee5657e284,crypto_miner,1255772,4996,10134,10277,15273,10134
1901,e71de933d20cb2780df7fb2a40f335686be77dc4bb7d926e1c62d80ba468b492,crypto_miner,581477,2497,4614,4704,7201,4614
1902,e73feddd7e0c722186b1344e53be1ae664ddfec9d6c6d86364c975a1aae8c1c4,crypto_miner,653063,2642,5153,5406,8048,5153
1903,e76cecca4525e44e3cb0e2c1a7c7739ace7f6f90ec5b7490f6ba3bcab71f6764,crypto_miner,1255771,4989,10145,10290,15279,10145
1904,e7ce15fe3a7c98bb58ff2c346224d008988c52267f0811dffb8971d64a993e3a,crypto_miner,2196178,8539,17079,17058,25597,17079
1905,e7f86c5387894bfdf598cba028ce146c6e3057cc0bd25ca0fc40e345bf4e00d2,crypto_miner,306392,1312,2425,2619,3931,2425
1906,e815abe10ff4ea4ca58eea9a2500c9fa323e3f78453b4fbc9c9034255ae78084,crypto_miner,653051,2553,5101,5271,7824,5101
1907,e83e2a90b8626d52143fc5db8bf99124a874e4992da28ee679d8343092fd5d8f,crypto_miner,653039,2552,5214,5225,7777,5214
1908,e8536211c66aca7bec7cbf2e07fc7d87f9136215675bffd79a72dbb0dedca846,crypto_miner,346831,1342,2762,2808,4150,2762
1909,e89566740d1cd1390e13a17205a89fa51e39144518b83441f08b2448734d6acc,crypto_miner,1255768,4998,10148,10296,15294,10148
1910,e8e45b5357c12ff09e29cd9c3464eb66e51b7833b03c8d9491a626b8af99b975,crypto_miner,653050,2564,5118,5315,7879,5118
1911,e91ab16eed699c64ae098ace30f765bb2959702feb64108f63be4c668831221f,crypto_miner,653068,2535,5056,5464,7999,5056
1912,e93fd2fc69dd3495aec6f313bccac580450191d4c1d301f60b9e04d9d33077b6,crypto_miner,653036,2640,5088,5234,7874,5088
1913,e980f7ac6f03dac9904370f7096da6c07155ba66311ff00e42c57028aaca7b96,crypto_miner,390114,1586,3122,3041,4627,3122
1914,ea2543bebdaf52af8093bf36df5ccab7fa56d8c4b7a3f004a982e62eb9962892,crypto_miner,1255768,5001,10151,10292,15293,10151
1915,eb2763899a99975cfec841d6f8b5707bd96902806eb8cbbb941567f217245c46,crypto_miner,653049,2479,5011,5322,7801,5011
1916,eb5559dcb5bccd4cbaad6eaed8d3be1443760d21dd3243b4678178237401ff5c,crypto_miner,1255774,5000,10170,10287,15287,10170
1917,eb561e3709877068a8e3d5bd3844335ed5514b7bb76ce43036c52325ea82cc9e,crypto_miner,1250783,5201,10171,10438,15639,10171
1918,eb862456b86f52823416df487c1ff514891fb6c8057988d77fbbda23ee015649,crypto_miner,1255772,4992,10150,10282,15274,10150
1919,ebf67c854d699120b4eb180e890b889c2275650a303ec9acd90d69d29b0b087c,crypto_miner,430765,1836,3448,3366,5202,3448
1920,ec4322934f4c3ab9394df55e2ffbbb06915e14f125745b6a3ad56d6be9d704aa,crypto_miner,1250775,5199,10187,10454,15653,10187
1921,ec64509b9c969b121e6946a346bf3a19f958a657be306ff0f3ee779ed74b928a,crypto_miner,1255772,4993,10142,10284,15277,10142
1922,ec91135024eb1ca4777c9ee68db0859f3971f26ce4fe3b9d97640d21f0fcb841,crypto_miner,1255767,4998,10158,10304,15302,10158
1923,ecca2a99bb50096eb240e8824c58278abf3e1683ebcbd7fb0a4f996aea33f7a1,crypto_miner,1255765,5004,10151,10287,15291,10151
1924,ed0f34903bda30bf39616c03ebbdb46788afaf85f3303edb115aef488e3d5697,crypto_miner,1250773,5196,10152,10456,15652,10152
1925,ed5b6e9da58421273c633b9b1d66ce8e9cab8067da6f547d473e8d24faff1538,crypto_miner,1255769,5000,10150,10299,15299,10150
1926,ed9a21deff5c6f7600ff7525773cf649280ca589cc9e9733c236b251b8e69d53,crypto_miner,652487,2480,5101,5177,7657,5101
1927,eeb07657c5bcf0b64cbfd56a2632a414d1757117a29bbc5cff2684233e5b91e9,crypto_miner,1250775,5186,10150,10439,15625,10150
1928,eefd506bf60c0b866eb1664c3a03f52b16dfd682d22073a3a27a3f1fee50575d,crypto_miner,653068,2548,5116,5365,7913,5116
1929,ef39f36eee261d384e4298550fa54d3402fd28506df9405eea4cad2bcf74e7a4,crypto_miner,653049,2540,5087,5388,7928,5087
1930,ef49828432d047583480ab29b9f6c2ac1bbfae38486212b5611700cf8e134726,crypto_miner,1255772,4999,10145,10272,15271,10145
1931,ef7da0e4591a93987c3ad1450ba29d46698261991a54e91dbdbaad5766641b92,crypto_miner,652743,2529,5049,5248,7777,5049
1932,efa258157b7e9b261c2925b69561dc691eb58677b2e0ae037cfa3de800b1578b,crypto_miner,1387406,5452,10871,10787,16239,10871
1933,f00d25ddde41de09ca80cfcb673b8c686fb0247a7a9a3414c4787607e5b997aa,crypto_miner,1255768,4989,10137,10272,15261,10137
1934,f00fa7332648e269d044b2625a66f8dc9426d00a2056a81f6abc30581a4f534f,crypto_miner,2196178,8539,17079,17058,25597,17079
1935,f010839477056d55dfe5d78f8ca4a711098dffa19b8894d06c264dd848bf7bac,crypto_miner,653066,2544,5086,5300,7844,5086
1936,f04433d71e94ce4aee9d7776cae364a44edbaf1f86144ee79603987541495282,crypto_miner,1255763,5010,10146,10290,15300,10146
1937,f0f8080ca1e02dc44cfa276385c3790bb7c3c5f1482dfef746992f98369dd902,crypto_miner,2196178,8539,17079,17058,25597,17079
1938,f120cc51d8280559c1bf5f376ef872dfa43c9682845bec5b035b93d015896dd9,crypto_miner,327118,1426,2588,2625,4051,2588
1939,f175623f82aab8ceee45e3905715598ae44c6a0c906b6f2e18e8aa709a29d35b,crypto_miner,1255772,4994,10153,10290,15284,10153
1940,f1cb7ffc799c7666ba9a92ba320d33af49d08afebff7830e0eadb1dfd6f84fa1,crypto_miner,653057,2583,5030,5461,8044,5030
1941,f1d4ac5070eac41bf8cba298c18924a2ef39e718717664d08713082ce806da93,crypto_miner,1250772,5186,10191,10455,15641,10191
1942,f2f99d5c2fde26c05f7f51f1c2776553d151a723d46e67a8a8942615129be89d,crypto_miner,1255770,5020,10149,10279,15299,10149
1943,f33c1187a09ab7c383c631306a5366e37064d0620680730857ef4d343592583a,crypto_miner,1250776,5193,10156,10452,15645,10156
1944,f36a0b4720ad3c3a2fd32c24243d7ebb10e9f8025578374066dcf6f373c93f8d,crypto_miner,1255772,4991,10147,10274,15265,10147
1945,f36a26b2b92558de08ebb4fa430283fc0f783c44ba83efe8fcec2963ac047fcd,crypto_miner,1250775,5204,10168,10473,15677,10168
1946,f3cc2dbde1e9394c6c3f304f2c5029919e0f11d937d53f896631530ff88a4e5e,crypto_miner,1250170,5413,10288,10616,16029,10288
1947,f3dc90a66c80ddfe6aba07640bcef1e2499c2aa8ede898d8d27df9f90124057a,crypto_miner,653036,2542,5085,5362,7904,5085
1948,f3e1a214aa96d496d8153effcfd65b920a28952b02af863ac105a9164c6941c0,crypto_miner,1255769,5018,10160,10291,15309,10160
1949,f43ca8ddeca66dbaccc92874b6f54e6c61401e3da4f6d178f88ebcdab2534207,crypto_miner,1250773,5195,10159,10485,15680,10159
1950,f4fc490255995cd74b1c08f6088dd3dfad511aa8dda6918750d84b0812ca4268,crypto_miner,653031,2587,5057,5388,7975,5057
1951,f539dd11554ef285e49a21ed420d49e0af43e5d2513e6b521a0e919a57783aa5,crypto_miner,653073,2499,5168,5392,7891,5168
1952,f53cc6cc2770920a188527dd08e35ccc7fa70ccb624d212e61651052e248936f,crypto_miner,653080,2549,5056,5527,8076,5056
1953,f554c216d8aa5bb014cee9481cacd75948e3c683d261e26051ee898adf202e08,crypto_miner,1255773,4988,10142,10280,15268,10142
1954,f5828eafbbe0b0224c4ff11b51ab9e8ddfb2d68b244842c3bcf42f87980c3854,crypto_miner,1250158,5416,10274,10628,16044,10274
1955,f5bb6309113cd5761d5dfcfa22ef2816b5540a4e55db7b22ad7dc1136d8760f6,crypto_miner,653084,2546,5201,5403,7949,5201
1956,f5e1b8d5087e275206558661ebd6462f2cd68739110a3ab14c04fb3f3dccdca8,crypto_miner,1250772,5193,10180,10436,15629,10180
1957,f6773ca103acd06dbad1ca88861a63f52a146081ec8137a585e27dd536282600,crypto_miner,653055,2520,5110,5332,7852,5110
1958,f6ccd2e81e1ccdc67bb71113783db2a46fb6c6b771683e96a6fa5dc234679e0f,crypto_miner,1255770,4989,10134,10301,15290,10134
1959,f7009d7cacad4ffa0d5b51f72779a8807639fafeeef9bbf46551fa721291a675,crypto_miner,1250766,5191,10161,10469,15660,10161
1960,f7847b0c24fa30edec8a610e68c33fdbc798f3ace812bd3ca6e14e602a8e9657,crypto_miner,652725,2536,5151,5266,7802,5151
1961,f78da05ffc4bb89433b195e32e2c57bc19ff0b9861a1f862513e7d2e6bce0d6c,crypto_miner,649353,2524,5148,5133,7657,5148
1962,f79f85fbbffcef0142cc50039d0195edfb4d154511da30166382699d478e7920,crypto_miner,1255770,4998,10160,10292,15290,10160
1963,f833c4213f1831e21bed26949ce64e5d15cfb5dd444666a1650831094265a76d,crypto_miner,1403260,5478,11037,11581,17059,11037
1964,f8a75aa3f26890e53c77765ab1ff3e19ab3ce30587536254c96bc69cac926644,crypto_miner,1250770,5190,10136,10484,15674,10136
1965,f99a815ca3361d17e14c6c231e5a4a85dd3cf8054a965f166f2691596b06a3f5,crypto_miner,1255773,4992,10151,10281,15273,10151
1966,fa3d670ba46a60a3e1faa2b49540c5956ef8426ae513b235c45e772b575d800a,crypto_miner,1255773,5011,10131,10272,15283,10131
1967,fabeeb82bee93bd03a6086a715e4a90349bbf9f9c5bc3d86ca42c709faeaf404,crypto_miner,1250774,5193,10158,10478,15671,10158
1968,fadad76db358455cca2db295fe8b250ab59f3ef7c60847511968ecf00221e443,crypto_miner,653095,2629,5100,5336,7965,5100
1969,faf7e3840ca307d2b35817b6e64ce39f0747b04112f91def1a4956701ef84981,crypto_miner,1255765,4995,10150,10293,15288,10150
1970,fb73dd3d36daa8f2abb11a2bd358786097c0b7fa430d84644538ab9d21694fa6,crypto_miner,652978,2566,5139,5422,7988,5139
1971,fb88bc268a7c28ed8310ea919e585e38a9f4b1cc4685bc358f7e8cf2c2dccece,crypto_miner,1255775,5005,10175,10281,15286,10175
1972,fba6b85b7b76aa5426851274cf431976503533ea51dd512294d71e37a6e26f7f,crypto_miner,1255769,4988,10166,10303,15291,10166
1973,fc25760d09ddc701eb3a7178e66377312a97496de6ec74275277a2396c66983f,crypto_miner,1014906,3804,7981,7888,11692,7981
1974,fc628ca5de2bdfd8235ad094980b35ca7c071d04bc81490f42cac299633b70e7,crypto_miner,653061,2541,5158,5316,7857,5158
1975,fccfeae158e89175ac931af2b475de50972d9cdfe28bc4f96b9d733f25688b36,crypto_miner,1255769,4987,10152,10253,15240,10152
1976,fda44125a96d8c922e9a868aa61e2976b3721925022e9234fbf3492edf00492a,crypto_miner,1255768,5007,10169,10243,15250,10169
1977,fdbf150d1c7e1537aadb71267f71054eafdbfed89e1d5acc96053abe0dd6ca06,crypto_miner,653065,2563,5161,5212,7775,5161
1978,fde02b1f8795075dfc6ba88d1d659558bb660d961bdaa2f1e68dd59e997d490b,crypto_miner,653072,2552,5024,5294,7846,5024
1979,fe1170f0444c262c2e37a855d31ae4a5d2f6fbf80807c7575b3c28cde9f17b52,crypto_miner,1255766,4998,10159,10264,15262,10159
1980,fe517651680715323e28f2d906792f45a2a2874b98ef76a98bbaa0b6db5c00a9,crypto_miner,1255771,4996,10150,10277,15273,10150
1981,fe564555624a1577d496ac0d55a7170348875273c9517fdc552a8607e0274029,crypto_miner,653111,2566,5192,5222,7788,5192
1982,fe6c3147368e706a9cb5d529757947579ab7251167b1ad46f19418fe03d0cf67,crypto_miner,825015,3429,6713,6469,9898,6713
1983,fef5f1ec1c4aadce23018b828d6696ec7a67ac3b8cba389529f0fda310adc0d3,crypto_miner,653064,2572,5145,5341,7913,5145
1984,fefdecb4e74b74052f29ee618f07b42073eb6af8e9c3fe4b67d83ddfe1d72d6c,crypto_miner,1255773,4987,10166,10259,15246,10166
1985,ff1392e9f7dbfd75076d4af093ce8ba75a67c6524d390389265e9ab09753ce85,crypto_miner,2436125,9656,19159,19164,28820,19159
1986,ff5e14049c2c221a8c26bc51359ffd46411417cefdf63de0e22449097ac6c8a4,crypto_miner,653057,2687,5060,5333,8020,5060
1987,ff5fc52d8ba1dade7558d86a17db2472007aba5044e1fb6c187fbad997f97df4,crypto_miner,653122,2679,5015,5269,7948,5015
1988,ff9ebad7811d83cc4d0b39dc8373e4f504fc267bf5f697ff9fa12a06ad5c263c,crypto_miner,306202,1235,2511,2563,3798,2511
1989,fff90a198c86fdf0b6b99de5308c13c010b4a7266c1cc0002eabcc5601c80ac8,crypto_miner,653093,2554,5207,5259,7813,5207
1990,005b91e08af5be585927246c10fe086f2893c72baf62f45bcdba0a9c19d3c5dd,downloader,115864,501,926,908,1409,926
1991,007178b3fc5cc4482bc3a26a582f1638f3c4a1f266945ab5c8cbf6ca896bca40,downloader,188204,795,1502,1445,2240,1502
1992,008920247e5ae308c8f95d1a4be096c1d32c54d73bd990824160db10e6549ae1,downloader,147223,667,1143,1217,1884,1143
1993,00a0cc71237d2598fdcb7b4fac86da0a1faf04803f5ed0d1b39bc3dd652fc7b9,downloader,181283,760,1468,1385,2145,1468
1994,00c68c8dea825bdfc6bdbcd930f22570d701b46693979954f0d5453ac5d91ab5,downloader,147277,661,1152,1217,1878,1152
1995,00f4479b780b6166980e2cf9a91fb45d67b4a5cf60b4056bf34f4bb1cb2f3758,downloader,187442,775,1492,1425,2200,1492
1996,01a218d03c2bdc25d2c36b5f6870bbdd19f73f2ae3ad5abdeb2007b9b425d98c,downloader,182598,775,1458,1399,2174,1458
1997,01bd5549a7b8abe601cbc830a5e1f070d0da17b69c767b29f35685df1324f0f2,downloader,115822,499,937,900,1399,937
1998,026680f07286db5df7ec35c27718cbb7601b158fca6308a8a22aee977a9a119e,downloader,117481,511,949,896,1407,949
1999,028e4895b9537a0b5c9ca5462134259b5b8d6fd5ad95ca848676e45dddc1d9d3,downloader,185146,781,1466,1416,2197,1466
2000,02c7a7695ff61f880528863ab075dc09c7f343fe9a8316c7ec7ef5fd3e89db3c,downloader,182958,762,1465,1413,2175,1465
2001,02f1ec2662a1b8794786553afd012566caf8816ad45ae2ddf05a5be0989aca4d,downloader,116947,510,947,897,1407,947
2002,02f4941e7b957aaa65d2b590fec9f47edf43c195741a884d464065425908ee46,downloader,61629,236,511,468,704,511
2003,038297e08870a0f6e16df9fb61efc9cbf5104dceb0767cd993519c38025c0c2d,downloader,298531,1239,2300,2368,3607,2300
2004,0383737b679912d612464731087376b02debb7229138e27b818263186d3cb3cb,downloader,29964,135,255,245,380,255
2005,039829b8076651660f3f7387aecd442beef22cdf039441f1a3754a0dbfb9b318,downloader,11212,48,78,89,137,78
2006,03b038a77e402e635544e22da7a5418e25fb3213b04b5bf5d979570a87d7ffea,downloader,853277,3260,6707,6609,9869,6707
2007,03c137ab279691eeb561169ae697e8567162f1177a6e7f2cc2a5839c8e82cf11,downloader,30631,140,268,246,386,268
2008,04265a8f6fb0ca943ef614b3f2a0ccec1418a313def3eba50cab7d325b8fd306,downloader,182541,773,1465,1397,2170,1465
2009,044cca95ec992a11afda29554d78b022ee1cd6bf26d92927c346e43ffd03cd3b,downloader,161605,678,1258,1215,1893,1258
2010,04717c653515e53145bb181f2651782d092a988084d16da299cd8cef90a0e49b,downloader,147782,661,1150,1236,1897,1150
2011,0493df3456f20a63ef0a99d8b68dc7571059f371b567b4e5dc590881f9f387d4,downloader,117924,510,953,911,1421,953
2012,04c5fbdece604ef19b087abe30f3e5fbec43526308d7938630e1c4e54563e516,downloader,116964,513,939,905,1418,939
2013,04e7e9c8ec9468acf2abfa6439dc3cf08b6f6e73472b5c1b6bd674e88711d6ad,downloader,301346,1247,2320,2387,3634,2320
2014,0556789d5bb7e5504bcd460dc3bb7b800c42307682ab6fa42961c45ea7cda939,downloader,853278,3273,6720,6579,9852,6720
2015,063797b461a25db87bde9e06058bed6ff0351b5b67f03a962d523bfe201ec20d,downloader,181514,762,1453,1381,2143,1453
2016,063ed20ce27da212de20f5bc8a4b069cb910602f751d955223e4d29dbb75e779,downloader,764368,3083,5891,6150,9233,5891
2017,063f1da031861007a02aea3f4b0a9475b133aaf98141e56172bc9ceb352e677a,downloader,181339,764,1450,1376,2140,1450
2018,064b6d2bdda865a1fdc63afc97deba1f5e1cf6596b57b03df64b1c628abd124b,downloader,118161,504,959,908,1412,959
2019,0692b5a413131fe69e58fe590033c381ee10e7ea2ffcccb046608ce4594dbea5,downloader,181908,765,1459,1393,2158,1459
2020,069446709999c324312f326a817e3d842584fe698909d8297a74ac8413106009,downloader,186419,784,1484,1419,2203,1484
2021,06f1a588ace9661ecb90f3c37029b43cd43b0d05edacb05d0938e0e113cca34e,downloader,117624,511,946,897,1408,946
2022,07206b6fb3a65cc4333b52c40f0b34541e9ce0e99b79a410665167cc976d3723,downloader,118148,515,958,900,1415,958
2023,076adb61aaa89ed14c6d5155adaa4b35ea01deba71e919ed68e32aa7e928c758,downloader,301232,1249,2313,2398,3647,2313
2024,079a1be84c5dfec6a366624e68bd1fad63dad558b0dffeb4db2af411b7a7d36a,downloader,186725,772,1493,1427,2199,1493
2025,07a579bb472e492b499f11d829badc21bbcc4cffa53e79c68bb64bdacb122158,downloader,762284,3077,5881,6092,9169,5881
2026,08516278adbc16047403db115755197dbafad1554d53e3337f9dc55bdf65a7a4,downloader,188908,802,1491,1462,2264,1491
2027,08bf7fab0cebcb178318c6b148b0ac27c0434fe6933664ab988ce80bb79c079c,downloader,185597,771,1497,1411,2182,1497
2028,08ca6be45ddf2d63c9ffd93379106901261e9eafaceb8187314afb9a7a06e468,downloader,118421,507,938,897,1404,938
2029,090d5d1f0d0ace5819946fe46e8ac7acdf6feeff18ea25975189f98fdcd63471,downloader,301426,1247,2325,2401,3648,2325
2030,09405fde4acc63a67a829d8692f2b9af39b88c20a1ce926577860e27a1e67901,downloader,117668,521,941,900,1421,941
2031,09bedfee84863b1f095155c6e1a4774bc5f239ba56e51c57b2c587f6a9cec49c,downloader,118218,511,942,914,1425,942
2032,09cab247bde769888f4e69735d43f55c0c359ef27ad9aad4992ffc74ee8c68b6,downloader,118308,510,959,921,1431,959
2033,0aba735a3197042ec57ba43d057924a0633ccba4d31b4d35e24a5d853564ea89,downloader,118211,503,961,926,1429,961
2034,0b06784d62c6f31ee610d577cbbd8e4d08ab69f7ff3805c1dcfb52ce34c976d4,downloader,183340,765,1467,1423,2188,1467
2035,0b6795f35110910ec3a78244429605f452df271574bca7a5f62f8f59adef8038,downloader,116893,503,941,915,1418,941
2036,0b94fa25c35c73cdfd03ef86259c9d1f6cfb2c6fbfe9b54ad79be9748ec886a4,downloader,181925,761,1446,1390,2151,1446
2037,0ba1b291a8839e5485284c3ad8aca237c854520d1a0a5b61f7915fd82d3f0c6f,downloader,118637,504,961,907,1411,961
2038,0bd93214aeb2e750c0f6825508ec1b5d10bad96bfe8c1e033791f01d1d1a3b02,downloader,184698,790,1498,1388,2178,1498
2039,0bf5a5852a02e2c162d7e8d86acef95b8bbc8177e31d12fee309c1cf44d7a29d,downloader,117140,503,939,917,1420,939
2040,0c535521d52f303a2b1e04fe9eae5a74d0af7168f070677ad2dee3fa66b53639,downloader,116603,502,940,886,1388,940
2041,0c78860bc453feafdac39ac1eff2aefddd912a9d88a93f1290b3953301fdbd79,downloader,118091,498,956,888,1386,956
2042,0cc4349721e19d91ad523b9a28c7cbe7b37b2eb80f4e10dc82afadbd6882af43,downloader,853276,3240,6723,6551,9791,6723
2043,0cf6015594692d4f717a7e3eb90d600d9a31d32957ff035bb71bfbe4d2c2b76b,downloader,853382,3362,6682,6737,10099,6682
2044,0d8e72af668be1a4c7e71fdb436e04b256c83bdc6e48e4e4610ca5f7fabcbc4a,downloader,118165,507,947,907,1414,947
2045,0dded7c7dfa35f873de11bca4480ef4c280cda558dac6040cdd54ae81b2456ec,downloader,762314,3071,5889,6121,9192,5889
2046,0def4789b4d498ec27b8c0df27658c9b3d2f3af171769ac630eec44988c61cfe,downloader,118272,501,941,908,1409,941
2047,0e19256d21ade29f6fc41b4cc76f4c7b510feeee37e02abd758553ac9922cad4,downloader,30880,151,230,272,423,230
2048,0e40d2932cd05b200e01f7f67b231799e522aae21556792976d196b92fdbfe51,downloader,10574,43,99,85,128,99
2049,0e6f5c1630d046ea3dc4a258ed8bde0402de7ec657ad96e1c8ba4c4b6ce1f423,downloader,184918,772,1472,1391,2163,1472
2050,0eb378e7d01946a4e9df0a3eb3fe1c638f3db4adade332039e67e228fb28b3cd,downloader,761860,3075,5880,6109,9184,5880
2051,0ee0a5418616c262fc04b36c6ada0e8c1bc5c26af4c9e2a98918fd1d0791e82c,downloader,118267,511,942,915,1426,942
2052,0f229152a22d1d80a2f70035e4023f616cdf077b0a02cbf6abe3473ee47d1c16,downloader,185304,780,1472,1410,2190,1472
2053,0f678eb828a583cd646869439036dffa2a7b7d754ef6094fabfd6ca08c55792c,downloader,187991,788,1511,1451,2239,1511
2054,0f86b59caa84ecd353f5716635fbbed3f8b8077d7b88b244da1524cbce62f272,downloader,30688,151,243,259,410,243
2055,0fb5ba47d3c133be60bf61e27bd71855c6e67f8a6d4db8628d94c274a2188554,downloader,115683,497,937,895,1392,937
2056,0fcb14ac9295abaa2ae631898c0314675b8b7b31acc2522d93bc1ac654a31c96,downloader,182211,776,1454,1392,2168,1454
2057,0fdf5d48112a97d6955452627948fafdd62a2d3c41a7599af7c7e359977b768e,downloader,118429,505,953,898,1403,953
2058,104a804956300a86360c6be8b7bb53f0bc003217410ebd76f9369b0f13961353,downloader,117662,499,948,904,1403,948
2059,109e43b784321e6b846b68e3a660a938d9476ac574c4d91e9221109e345398d3,downloader,116951,505,935,908,1413,935
2060,11bf1330a71cb497d780824ca478470277b3187538cef7fb3815a3378b337358,downloader,146814,657,1137,1209,1866,1137
2061,11df8d8ec5143d2aaba7ebcc4610330dcc6fad6a193f51dc30e1d3c7c636b526,downloader,116938,511,935,905,1416,935
2062,121b2ad99a2d44ae6f135da9756dea78a719ed263530050dede993db75d11c02,downloader,115963,488,937,896,1384,937
2063,1231c95d6762d32b160ce121a0c2ed0f8b03a0c00a49256e8c1c967a6dfcaa62,downloader,187964,789,1496,1430,2219,1496
2064,130446a0461fa675df7fe234e0b1cdb604e423ff75a7fbdfaad430aba4b783ef,downloader,162717,700,1257,1233,1933,1257
2065,132d8589df32da8e200eb5319dde268eb452d755479798d96f69c16da8cd164d,downloader,182026,764,1465,1380,2144,1465
2066,13e2dfdbbce9dc39ae15b4ad867dac2431e01a7b48603a92a4a6ed02b9aa8dd9,downloader,762408,3078,5891,6119,9197,5891
2067,13f1b847df8e1f9e2b7218cec41dc4388cdd306c1275d3626aa6f380bc1f1568,downloader,187089,785,1475,1436,2221,1475
2068,13fc3acfbde5491c81d11344f74b966bf6c6676851613e50a1549feca1cb16e1,downloader,118374,505,947,895,1400,947
2069,14476258ca739acfb14e9c9633db7dc84eaad659f6da535405205fffcd38c497,downloader,182632,765,1460,1401,2166,1460
2070,144ade8b37ccf20f7b6a48767ef928acfa0cee998a2113eae7b0f8886f5d251b,downloader,188431,785,1502,1440,2225,1502
2071,14d597d04a87ec60964071ef3140db7e57cdccf23ba71d08147c966e435c06b9,downloader,182830,761,1471,1392,2153,1471
2072,14de9ebdcfbdc07d17cceaedd8e7efdda836a8923a8fa41cbe3e44a3d5962a95,downloader,181542,772,1450,1375,2147,1450
2073,150bdd1c9a50d685fecd45a113104aee2448733b351bf8aef6b4f9ee722a4fa5,downloader,117881,523,948,912,1435,948
2074,1531cde07ed07773142cc5fea862e1f41e59697e4844bacac03d9784978938a0,downloader,181399,763,1451,1377,2140,1451
2075,154f1e4a68ba06749a71478e230f2f22abbb95f10fadc777a866018eb0173101,downloader,15589,75,130,122,197,130
2076,15a2f52ee941b583ba147c4d24fa5c5e41fe84a2bbaddceee4f200a841176126,downloader,29982,127,269,224,351,269
2077,15c6ebc543a9535898d2fc1bb122d38487f5c92f28af44f266495297ce6f6fe1,downloader,186660,785,1490,1415,2200,1490
2078,1644862185204aabe9490874322498504fd793768e9ebaec7682e3adb9669f8d,downloader,116565,494,940,907,1401,940
2079,165bbe60f8a376946f82428168404a2d4e55abfa06faa81b7761d79f80dc1a50,downloader,118051,508,956,909,1417,956
2080,1662f6171df2ee89c22947951454e38abbeb9e779e044f560079d2c7c24e848b,downloader,761410,3070,5883,6109,9179,5883
2081,168434fce1ff993eb73f9942e2152b8c7efb63abbf46dfbf2397d1f000fffbb0,downloader,116907,499,936,903,1402,936
2082,17068c90a71a42866d580d1cb61605a609032f82647eaaebec5759a812edc2e3,downloader,181434,760,1468,1381,2141,1468
2083,1724d334171beb970db81309ddd459d204856c6d98b2f60ddd86e82d67d45437,downloader,117903,508,951,905,1413,951
2084,1748310278357e873c78370614fc2a618d308218fcd529b7ec17479ef8e6ce22,downloader,187959,793,1499,1441,2234,1499
2085,179acecbc9135042bb2e557f26c53d1411fed0d827ac3e8d34e15e34f1f8b2e9,downloader,116519,500,943,900,1400,943
2086,17a1156dce4176107ff5af7ff20f3d6a7995e27393f7f5c6c499e43217ac9064,downloader,187145,775,1493,1452,2227,1493
2087,1871d143befb8c523011a1fb292ec45b4dc09d272ae78833e41c383a7e5db7ae,downloader,180688,752,1443,1374,2126,1443
2088,1886c87b00e20bdb13eb691c97034d0b587c6131fee58dbf45110d454a5bd644,downloader,189013,802,1508,1454,2256,1508
2089,18a597d8e43a6ad4ae9b999baf8dbc22002efaf01e1dcd6ebc0000323a97fd28,downloader,182136,770,1466,1383,2153,1466
2090,18b20aa1ff4b77cca5e3127f2cb86497819f9a0c364b4be478c5954055f3a24d,downloader,116976,499,950,911,1410,950
2091,197fae56b3e4c07c0da3e855d33c3cb43ce88b2e6c8df553f308ed5b3662a82d,downloader,182067,760,1455,1395,2155,1455
2092,19a851e4dcbd75f3f2f08db68dfc41ddde66aa09408504bae470629787da0f1b,downloader,117552,507,942,896,1403,942
2093,19cb284fbefec8722a4976a6b85b7d0c43ace4be6e20726abbc8ffa4722f1a8a,downloader,187933,793,1497,1439,2232,1497
2094,19dec2a6cd870ba6f4c6a1f0865a2c0d33ac9f16d3dd24272757c52cc91faaf9,downloader,186618,772,1492,1424,2196,1492
2095,19f76a5a4859ac4e164b3048194c7bbd52bc13b09422019ce6f0751220d39987,downloader,181831,747,1463,1383,2130,1463
2096,1a226d109c12bf0d8b78c3d1c814aeb6e14ca7c5fe2a7f77f540273f330731cc,downloader,188474,783,1491,1434,2217,1491
2097,1a598ba1621338790ee495dafaf182159e540eb6279b19947ec7c553e2659221,downloader,187556,791,1495,1414,2205,1495
2098,1d22471d4903137c437abfe596e6acd770e90ea4b5f2d2b274588dfb9d965ff0,downloader,147146,672,1137,1211,1883,1137
2099,1d503be11322f3f0f5a903af3f6ba9bb917fb6be8c64b3c24a89b2f1cfa16669,downloader,77978,339,656,595,934,656
2100,1e2aaed96a561f60e90fe7d1b5312b9f3b6cd1309df48bfec8f9f97f084e21f8,downloader,182293,760,1464,1401,2161,1464
2101,1e6a8fdd71a8efe1d595e530102bf9c9ac2ecb4266775d6d4ecf39b5bae33b52,downloader,762857,3076,5892,6101,9177,5892
2102,1e6b18d78e0d138da94de81aa0d9580fa9cd9fc6645b3cbef40b0678548a068f,downloader,181833,765,1448,1389,2154,1448
2103,1eab8e056c67342a1e72749cf769c974f3c0ea15c43c7e93e85295f23b21520c,downloader,187225,788,1478,1438,2226,1478
2104,1f26bd86dd8c3f7deb847a163bacda4d2f135b09d1656b997758470b3b3cab8c,downloader,181143,746,1453,1379,2125,1453
2105,1f43fc08c5d7dc6fd303c5234f1ff40bef004c6a1cf6dbd12e360ea67380b5f7,downloader,764215,3083,5894,6142,9225,5894
2106,20559ece06ca2023365cd0b57b4b959b47b8652ab18bf38cae5d909410ea9f9e,downloader,117906,509,944,914,1423,944
2107,206655bc870add7398c576f36225ee9d687f977a675f5870ac016ebdd0c982bd,downloader,147197,649,1153,1205,1854,1153
2108,20d78600937638698f65e2e609d462ae3198787a19a19b78a2aa320a1de7edb8,downloader,183053,766,1447,1416,2182,1447
2109,2110e960d731bda2aeedab3af2ccff3fdaf24494559cf18680f467194e9bfa9e,downloader,182141,770,1447,1395,2165,1447
2110,215149e1857c67d4813b7fa0f60d8194a046fe50a90432d3198f991c497d101f,downloader,181547,764,1446,1376,2140,1446
2111,221c43d9ffa4e533b3a22ad50cc4da723b4d0bfe9f05f26e67835a53c047785f,downloader,186732,800,1478,1422,2222,1478
2112,223cb2474c42be1828956eb31ee17a6d51264658c3c7891422084160fa1bb208,downloader,30667,147,275,236,383,275
2113,223dbacd4a09189f31fc16c8ee661fd9f04c0c6fed267d2b6812667f4baff29d,downloader,181270,762,1439,1386,2148,1439
2114,2253bc48849f8772f9f3a44d257b7dd96d551d41b89ad2396d65eadc6238ec5e,downloader,117582,510,957,919,1429,957
2115,2265ebbadfb8fb941240d73f00450ea51c3448a46bb8714a8d71272203225074,downloader,188464,787,1510,1433,2220,1510
2116,233eab5fdcb3dd26c09396f618cf39c92c066c720dfb4040ec53ddf8bbeb43dc,downloader,182334,765,1458,1387,2152,1458
2117,234cb3d1ebc9e109218313a317b2ffa1c84f32e7525c188af75ead1a0f41dd7e,downloader,186511,786,1484,1418,2204,1484
2118,235b9c41efa0e5f13aa7b7b3b8eac764586377db658568ebc73a8756f2ef87fa,downloader,30482,131,264,241,372,264
2119,23a0711f0143493c4cd13a093243ca434354d92e9766516b2acbb672c102a794,downloader,181791,776,1451,1389,2165,1451
2120,23a6761e7c5e75e2e9d63dc3789a196b201e6bd3329f3a54e330a99d7e31b834,downloader,301429,1249,2323,2396,3645,2323
2121,249d7d7ba19f72544a0b5d4922deeb5dd28436b1c0e66681c63c44aefcbfe176,downloader,182271,766,1446,1391,2157,1446
2122,24a63f6ad66c834fe7693b137185a9b79d8a4613920d756d29e55d239832ffae,downloader,180947,752,1446,1368,2120,1446
2123,24ae97250ddf05d367c13bb90a0870fa8dd424ebf4f271da9c044df8b9f987a4,downloader,182686,766,1460,1393,2159,1460
2124,24daa0b73c4a39fbf63294b28c8daa9d4fe9a89c9f4ab769456ff58bc3b7f90e,downloader,181200,764,1438,1384,2148,1438
2125,2512498c2e10617c78d6c551286fbbeaa1c5328d6508376556ec119c3c9d64d6,downloader,181891,762,1456,1400,2162,1456
2126,2524eb417ca81080d2a6cc646e632bc66c9108d4876572992ccee7a7540513c8,downloader,301288,1241,2323,2385,3626,2323
2127,2573ad252164c931826b08fc8cb2b185f269a7ed124fbd4a3c4880b25a0ad4a5,downloader,119016,513,937,915,1428,937
2128,25a27a81914d416e6836d45c9410ab5bb40a9ce21e95fe3cc6942f2845a83475,downloader,182152,769,1447,1396,2165,1447
2129,260314773b17dae26811bbd9e8922af3da07fdf19d013abb0a233a99a3b38ec4,downloader,671417,2704,5203,5395,8099,5203
2130,261af3e144a3457a37a50286c1c3d49c297eedbb9284566e3b32255235f9be96,downloader,187893,800,1484,1441,2241,1484
2131,262d0c768bf027a2ddb8625efe27598673d414f0710b6f03cca976d5fd396359,downloader,182746,763,1478,1402,2165,1478
2132,26d769222ce1ddf2bde6fee87d8e422458a70a2bbaa3bef75831edcef7fdd4b5,downloader,117541,514,947,900,1414,947
2133,27508a46e4b910befc75606436fa03ed46f1211d56e0bbdf78e0fed505b07c25,downloader,118092,503,938,901,1404,938
2134,278c4b0e6b58a48061a099e152e5474a601390ee9901fb0edb58bff40461faa2,downloader,182521,761,1456,1401,2162,1456
2135,2796c755532ac82a07b64ea9feb3e5a6ff1a3f9fb9b716a75170fa4ef88fc8c5,downloader,116980,508,949,917,1425,949
2136,279886bc3b6d06ad688bcc3ab5d683384fd7bb213ceaabe13f9d2c6a730cacad,downloader,118878,505,952,909,1414,952
2137,279a951d3d26fbc0c0c4f7c4ef294ffc833ac41516d723f32b0638a8ce32a64a,downloader,114454,483,924,891,1374,924
2138,27af911a89e0f647fe7c4c91fe42d3026bdf792e3bf50184e1056e8212d751b0,downloader,118098,494,953,901,1395,953
2139,281e1ad48337d206743cbcc819f45d8b82faed9bdc6b7257e9b98a33e323ed71,downloader,762830,3085,5877,6114,9199,5877
2140,2823b8a87a71d6256491f676d0d49299ab8dc3f8a6b9cb4bad18c275d531dcbc,downloader,117392,504,942,910,1414,942
2141,2840a019329705509f0d60a5a50739a6b4a1f43edbb95995073f8dba5f4e97d1,downloader,188745,801,1490,1461,2262,1490
2142,288ce3593e3908074ead58f06e08e5426bc6c6b4dda2112741aba52557d8add9,downloader,116432,500,934,892,1392,934
2143,28c5a803fb2d742cb45c63d1074565bb634766158aa336e2d412ebf96fb19388,downloader,181933,774,1454,1391,2165,1454
2144,28e0706d39511e14787c91ab149ea50124f74599196b143c13eabe913e952217,downloader,30607,142,281,240,382,281
2145,28faebcc74e7fbae8d089fd6e97632dd757d987df5bd88c0c22ab28d97a1b427,downloader,181433,757,1466,1379,2136,1466
2146,2948e8dcc61d021d93725b68c8f3fdfcec9a423a5f5267a09a3a937e708c5109,downloader,181897,766,1464,1384,2150,1464
2147,295c61dc943eeb228e60bc66949e4d0c6ebfd23bd1c25b8103f715ff68f5b67d,downloader,117536,497,952,902,1399,952
2148,2988e004c8a9d7be2365d28b22b36ecc825e6ee1308eed1f19d5aa8ba600c1a5,downloader,116823,503,925,907,1410,925
2149,29aa64954c7eb596a2bc02cc6f3d8b5b5a2b5c4c5a0579ee0af1b08e703becfd,downloader,11266,36,95,99,135,95
2150,29b184fe2ca07f506c613354db1319feeb6482e0ea4798428c45c41267ebe4f5,downloader,301317,1246,2330,2391,3637,2330
2151,29ff5cb515c3d16ca142c7da646bbe6969665fb2b298d4bb22a880baef434e39,downloader,182304,766,1467,1405,2171,1467
2152,2a0ea747267cb041f8f045bdb8ed180b705859ed85956785a7ad5cefd65f02a0,downloader,116899,502,942,902,1404,942
2153,2ae9c131da4ebc23375e1af5c66c2af3350be5e5ecd5c4287baf0617a4051f14,downloader,181335,760,1451,1392,2152,1451
2154,2b582e4e08b3beea6905ccc542bb6918d54910753f31299a25d0937641180046,downloader,69908,270,549,522,792,549
2155,2b78e690e8a2d505cf344304e03eaa91f0d44f5bbcab873703c3885820b383fb,downloader,116363,495,941,897,1392,941
2156,2bbbcbf611e60da410694905739c0abc273a2a022948f728840fbee5f712fb23,downloader,184818,771,1473,1392,2163,1473
2157,2be5a1ead5b957600f3dab3657fd7def6f2b2e25e9b6c6cb5dfe10ddf0c5adab,downloader,187960,793,1497,1440,2233,1497
2158,2c023b86b665d08d3d063bb181e1ec37c73af578436c875af53dd8b9d06466e0,downloader,117546,507,953,909,1416,953
2159,2c02c0f00c04a7cd86aa11c72e3ab1ec6a57a852a880b6f88f4a9cc0c4501555,downloader,188274,799,1493,1443,2242,1493
2160,2c35f93372b6d5728e9e7e514d764fff7289d2e3cf02e8be430d4d063b92ebcc,downloader,763244,3075,5918,6130,9205,5918
2161,2c3cc69b22132357413b58c2cce5211ba3b64ab5bf1bb19e9ce60739d3b37de7,downloader,117267,499,951,909,1408,951
2162,2c3fd527194e3df1c970dc63c408f58bcc3a835212309007247856b9a0903e2a,downloader,115455,495,933,886,1381,933
2163,2c8aca1aa7c4377ec9664ba46345317b67e843689e5881c7db38d3c783fa5a64,downloader,116471,496,935,910,1406,935
2164,2c994630c472b707d3c5611bf781f0388391c5333140b6e86922bda54cb02962,downloader,181399,768,1447,1382,2150,1447
2165,2d2382779cc879ee0f8bed2f7c402f42e9b81ff8685a0bc395e6feac3efbd10b,downloader,853276,3275,6732,6591,9866,6732
2166,2d2b0527b4568a312f5044ad85e397f1f4f6f97a4327dd0b91502735a57a770f,downloader,118157,508,944,910,1418,944
2167,2d35f3156685736133b184fba252de11d42127732db19f885f84ed547a7842fa,downloader,183816,770,1461,1384,2154,1461
2168,2d5b56835c01c675f6b1d418632061ae5a1e14c5de0fd6636672c2d0523898b7,downloader,182596,776,1456,1405,2181,1456
2169,2d695f82d513138f0e77883706cc39c7f2e966a620a0ce5faa9e6bff4ff1a90f,downloader,185713,771,1488,1403,2174,1488
2170,2da74f5dfcb4b4921b3d93827e16edfc9daf57f8c40743b9cea2ddfb4d6fc80d,downloader,188535,792,1507,1435,2227,1507
2171,2e044af2f23848461664cfd0ae15630afe3632da15187755c5c598902a5a53d3,downloader,180799,760,1449,1370,2130,1449
2172,2e6a6ea5931f7f048cf2be7ec06c041a76f26dfdf8c5491c817b0d8dc4c18a9b,downloader,114919,493,936,880,1373,936
2173,2eb8ec752339601a0a87503208a655ad6da582177de6fcaf5452a9d11d93457a,downloader,188301,802,1487,1460,2262,1487
2174,2efe0eaf08acc5f3d92e44ff1d8a1eef9c0d7f07a7fd165ab04e305c3d06fd6b,downloader,30904,153,247,244,397,247
2175,2f1924093874821c59877f569c62f2ff07be53a546bed426a1ba725c237437e9,downloader,118908,504,940,914,1418,940
2176,2f7180481d6469610c6db53cbefaa935f3d10e36a9b52fac51dbb7ac38d5fe61,downloader,188734,801,1490,1461,2262,1490
2177,302b0e3cba01cb1b5f17da181c3f19cef2034f056635998181db040b5f067a2b,downloader,30579,150,252,246,396,252
2178,30bc000e16a580084f6e16c822b2ab07481d4cf4ad856301dbb7da80670549e6,downloader,186855,784,1488,1449,2233,1488
2179,30d06c7abd7e978bcb7bcb7974afc75284e3e9fdcae58e0d1bbc52b5897d84c0,downloader,188263,791,1500,1473,2264,1500
2180,31488d1c8eeccab89d6c2f2f4106ac4ac65543074a6265dfd8bd859b0dc2fbc9,downloader,183188,770,1471,1405,2175,1471
2181,315ed45d8da10cdccbcaa34faf00f43becd340da4f9de9f3d9006f89013d5d11,downloader,183185,780,1475,1406,2186,1475
2182,3196ccb0869c35946b370edf054804deaca8596b68f7916d34b5f568cafe3a37,downloader,118303,515,956,916,1431,956
2183,31af0417358baced917f54d09203b68ccf2b5de99255895b7b6ba6efabb1806d,downloader,118145,509,944,917,1426,944
2184,31f95977d58bcf8be7b5c75850c24d45d7aac6b375138e0e9b5aaece14cdaa7d,downloader,10628,41,91,96,137,91
2185,32a9a4f76ab914f41eda34edd89cbab52c657da989d8f62b2f8bf3128ed4bdd8,downloader,299733,1243,2303,2377,3620,2303
2186,3306f31948cbb5f18e984791a1071d5d80f97450b2c4ef7480e619ac0a014cda,downloader,181328,758,1458,1385,2143,1458
2187,3345cf203e10d0cd54a1bc54b306d055a72affc632dd28d36893086528fd3a07,downloader,180933,760,1450,1371,2131,1450
2188,336db130ce30586e7f8b5ab9617eaab2631ca11ed240b64b75d5dff908dd4eba,downloader,185911,785,1481,1415,2200,1481
2189,338f8ce1912ec704453e1ec205426009b5778a55f8946fec2ebc833c979b05dc,downloader,117855,509,953,909,1418,953
2190,3392eaec53afebda6e1d3f1b392f1db7e71e19eb08831a055144241f7e2dee7f,downloader,187313,786,1489,1446,2232,1489
2191,33a5dce6668151310d65ed24bb96980b1566b0458ebf7e25b5dcb819d741d48e,downloader,182814,773,1443,1395,2168,1443
2192,33ad1e1319e01feb7ed50b94c3cb5d57e7effec0199dd14717de58dd10e681a5,downloader,181604,761,1448,1381,2142,1448
2193,33ec10c620215f910bd70d25e0176151aac7abfd575dfc1c0d898015d2c8bd0b,downloader,116479,495,934,902,1397,934
2194,33fbc7261d81faa67d722698abb291dd309a3f1f5b59ac14d138701e895aa66c,downloader,183520,771,1463,1392,2163,1463
2195,340a702182210b10a6ce307766d90f103ab86818c0f38cf34316dace599a0708,downloader,116528,496,942,910,1406,942
2196,3436bde8472f022b4662dfd0db211c5c9a1b5cb0468b22146d51a15e93187a4a,downloader,186377,786,1484,1417,2203,1484
2197,34bbb4b960063b3415362e3fb7f35d348ba1da94433998643617f4d6d160d808,downloader,181751,760,1470,1386,2146,1470
2198,35039b60f1e6501963b418e3e4a2922de9c0417807f8e643db1af5002de4f008,downloader,116636,503,937,903,1406,937
2199,3512caab211fb5df4095fa5036fa8f51c62e1d9f24ab4c2e7096ed7c8f214b9f,downloader,183496,769,1475,1400,2169,1475
2200,3535b935085d05c59e71c7c22c0f7fb7d88709ab08bb5a01b153fec73e0e6b76,downloader,761989,3073,5881,6112,9185,5881
2201,355fbec3970765d59bc3bffa24f6cc0503c42d64c7f796d48b298dfd024b53b5,downloader,762190,3076,5886,6091,9167,5886
2202,35a5cc420bcc68e9b5f15505dd3b774b698091897fdf43067f6cdc8beed11fe7,downloader,185086,783,1479,1412,2195,1479
2203,35d8195980b86df5c7d943a71a4beb90e80fef5fadc54c95cba05cf157a667af,downloader,118500,498,949,909,1407,949
2204,3687010f00c77e7d1453373095e7281b3dfa235af1af390e16bd1015f59d2703,downloader,31032,151,244,256,407,244
2205,36a37f394d2c6beac1519fad5608ac55a7004c5a3010ad02de01781974bc38a1,downloader,117923,507,947,904,1411,947
2206,3714f5002ffaa595a073f7ce132b98b2b0c19994854cbf48e9a3c79fa0ac3d0c,downloader,117414,511,952,908,1419,952
2207,3751e1ad358cb2918327be23e74280d05292bbd3184ffdd4839be0ab6844c5bf,downloader,183584,776,1476,1403,2179,1476
2208,377ee8e21208503d998dd6c6c178c453091fe72d2b1493912f399141e7835c6f,downloader,117950,522,959,892,1414,959
2209,3879e0460fe8510d955076d1ccff62ac38693152262dfc935f40c1c4cbcfc1f2,downloader,763439,3081,5880,6130,9211,5880
2210,38c844a2cbd6b7ea9ae584bafc00f0b4455484da821e084fdffea80131a9909c,downloader,181801,763,1451,1383,2146,1451
2211,38efd61c4fbb29d92fda40a3d4d6d01b9ac2f8680ffa8315266470584d7a4ec1,downloader,30090,128,247,238,366,247
2212,3923968de1345c85ec7d7c1fe0ce79d679f786348862adea4154ca5d1749b724,downloader,30008,133,239,252,385,239
2213,3956a89c6a680a7b58796e5fba6c42b2140a83ac336575cb630df7bd0f1c539a,downloader,188780,798,1499,1451,2249,1499
2214,39e8914c743f435120dc6c1f4ed31031273f6d72e639d797892d36044be6349a,downloader,115499,496,933,892,1388,933
2215,3a0db473b12e783612bc6f087e9e7c56c4887415f01866c426ac2bddc8067e11,downloader,117123,498,943,898,1396,943
2216,3a1e03bb7a4bd47878a00da0d752bb252dccbad72861a803b98b1cd9d4e59fe6,downloader,853382,3364,6633,6726,10090,6633
2217,3a25bc0e074294ad3facd73016d0c1552714210f8700e5e804c575fdc0161d85,downloader,118079,508,947,910,1418,947
2218,3a75892dae9e792140e7db3c2d9ee6764e18fdc5330f3e7bf9f29f2b0025765e,downloader,183457,782,1473,1416,2198,1473
2219,3b5928b62506b5f5f78c686e3b6d180c43f563f139ce456153f0fe91fe6cae7a,downloader,117771,501,941,903,1404,941
2220,3b78d6353b9bbb072a9bb7f794be735285fd690c6bccc7f49bf0a1a1788ee9d0,downloader,117628,504,946,914,1418,946
2221,3bddf2e0e4f1fb25e09ba6f2723e30646275246fed27f9215e3a82f145a9e8ea,downloader,181469,752,1446,1393,2145,1446
2222,3be2da0d15f238caa72538e46b4afd043dba5211f363ec05a8bfc6c9308bc70a,downloader,763332,3083,5908,6133,9216,5908
2223,3c23b18d0eba81ad21656c1a44f458ea3b6cbbabfe0d63b8644abf4a869b803e,downloader,30778,141,255,237,378,255
2224,3c36f5b9626b587d05cf02baceffb4eaad7acd1642bf0f70e123a7526f2a3297,downloader,761699,3078,5880,6089,9167,5880
2225,3cc5c384f7c471bc71d63ca3c849c2115c536012d1014f39555f899002fa77fd,downloader,298266,1231,2301,2362,3593,2301
2226,3d37100c576584e4734c19c18b32d688c79c4522a889388b9cc774836adbd904,downloader,181266,763,1458,1387,2150,1458
2227,3d3bed4ef97f6aa743617e2e6ad29c3af0d3ae39e4e139b5f12fb0b54de546bf,downloader,117549,506,946,908,1414,946
2228,3d3df82c78bdc60565ab145cf54f541b50c00cd9bec017393adcf63c675c1086,downloader,763388,3091,5902,6129,9220,5902
2229,3d571a5e13a809f86cdf040581fab664875383173983f6322dd1a746723bbfb4,downloader,187522,794,1495,1438,2232,1495
2230,3e2f35c71675fdd39540e89880bdc195cf98a9e1a008d0b32234098c88ea54d6,downloader,30617,146,252,228,374,252
2231,3e3c388c67bb7e0cbe103d1ab0f3f9cb1d1f919207ffe68fa5f7b77fb9e1f8cb,downloader,118528,514,941,922,1436,941
2232,3e443495533cd88e71401946af0f3da358c78789129c8a1eec9845ed6e5cbd99,downloader,181836,763,1466,1379,2142,1466
2233,3e9299c6d221333f0eb9e581dd93fccc901f4bf126492e6a42a18095ce626c3b,downloader,117086,510,946,903,1413,946
2234,3e9888d6a8fe842e356eeb75ac54b5de87104504793b0e947e39abffa3e6ad6c,downloader,762870,3087,5894,6107,9194,5894
2235,3f1c5d4f03a74309cb8799fe91773965f0a9b58243d064c3553edb210a524390,downloader,188317,794,1491,1458,2252,1491
2236,3f27bc0d4188b2834cebcffc001d265c804ebff9afda7142995270ffc267058e,downloader,181547,758,1450,1401,2159,1450
2237,3f5e427995fd167740904176367904784efd2edb41126eaba1a7e878b8399ba8,downloader,117737,504,943,889,1393,943
2238,3f6fde1d00188a2c4f8740292c9cf5f74a237642e0ca0f2f32e714810873d041,downloader,184663,779,1466,1392,2171,1466
2239,3fcd9f1f69c373985fc2ae0bef7510f3104201fc63b467bebbd98e8672bfa3fd,downloader,117650,514,954,900,1414,954
2240,400590b9ee08b238361819503f31a70bbd6b4786ccab8cb8f4a6eb9733d3d0c6,downloader,30211,127,227,228,355,227
2241,40225da63e1228fc2d1f9a29cd4d0f7e3b67dbafd22d8e9adb09da131a2330cb,downloader,186719,781,1495,1417,2198,1495
2242,4023152e4d2896e30ceec4d04bd640d44dcf64407f403d7b1d6c4a81f4cd4a06,downloader,762843,3084,5882,6130,9214,5882
2243,40414a2a9f2fa7b644dc7e6d256d18b7562cce251ea6ce9cf80a5ac71a9f58e1,downloader,763267,3088,5886,6123,9211,5886
2244,405a8eb6d1391b59d7fe7d299575f8e47de623744b1ac675aeec727127d07cee,downloader,117051,503,932,905,1408,932
2245,407fcd4ad2792133302da9dcabf0ec6cac74321c8a1267c9a07881b878ca4fa9,downloader,182558,759,1473,1397,2156,1473
2246,40e3d6fe305f69a360ecf1c0a079a6ec01dbeaec756e0c2f22d32c7afe4c3abe,downloader,182022,759,1450,1392,2151,1450
2247,4124d1f7e8a69cbf361c56378fbe080919398c0ae1292826be074a015c8925fd,downloader,115764,503,929,901,1404,929
2248,4142ca918018f978b109c557aeed10507f75f16f71921a318f6b4cd39d14b999,downloader,301112,1244,2322,2389,3633,2322
2249,4194c9e4b3b008ad7f953999ac6208f5595612a810da2f9bd6ea03d5316a1994,downloader,185867,773,1482,1417,2190,1482
2250,41f83b0966b1d7fc7bbf66b7e4c69ee52b1233a61fc34051fc2ed777d008b7d9,downloader,45311,187,375,364,551,375
2251,422b13c31b06ce1488c189f32969bfd3eb4bc97aa0849fe3fdd5e040348357cc,downloader,147159,662,1148,1208,1870,1148
2252,4260b49779910e2fc730b97f0e2c738630562c25615c89f61b7f3e2aa207df04,downloader,116812,501,934,907,1408,934
2253,4263eced3d62bd7ff29fe02a4bdc6e5fe2b71425d7bdb913df3eb999c45ebf58,downloader,184308,774,1472,1401,2175,1472
2254,4266a10490dd70956f6584c3f4b2fc5acee7d8d12c50488457ee7ebb838b7b77,downloader,187457,788,1479,1439,2227,1479
2255,427088ffb46156429cf90e639e486f1769a3cfa8e17a6ab70188900009417b95,downloader,181004,761,1451,1376,2137,1451
2256,428198b368fb083c853b50c12c5e9bf4d5a9f5b52337bb629df1d4317941800f,downloader,181530,761,1481,1370,2131,1481
2257,42af83113a70a9121378fa775adbbb34719a06e4d9b2c4350fe3d9ee20e7d91e,downloader,115661,495,946,907,1402,946
2258,42e103035a4de240bdd165e2ba16d3352945f5fc6ded2b3a6cc4fe3bc7d6fd87,downloader,186786,785,1488,1416,2201,1488
2259,42e6514e4de57293f1ee81483ba00dd355aa684ceb2070c96c6e3fea9398598f,downloader,182206,764,1464,1399,2163,1464
2260,431d0a921a3521577a82bf89a925468f6eb0d8d18a92cd1c8192dbb09aa9265f,downloader,187143,796,1492,1436,2232,1492
2261,4339d21672524f150ab383e2801bd789a0236f919439510d46b3341c8206a65c,downloader,30480,153,255,252,405,255
2262,434af238b9b472f013ca4d2feeb1c699de9a83033b37f2223ed79e1f9010cc30,downloader,117447,513,946,907,1420,946
2263,4385ff8c06de9db2603ed0c7fa1a3584c0fbc79af0047f33174a85f889edaf27,downloader,301126,1248,2308,2387,3635,2308
2264,439235c840c16030bdc11964c76312a5486d9509315cbfd065cb8e311dbfc035,downloader,115807,493,934,893,1386,934
2265,43ad3f134af8ad9f62483cc1477d3ab67a4a2100b1eaee3519410fe7d9a999ea,downloader,849991,3379,6593,6626,10005,6593
2266,445010176fee053767c704ca5bcd0d9ea014ff8f58006b8ada03886f114499e8,downloader,162344,686,1269,1226,1912,1269
2267,448837544bfd7e27f9a387034bb0dfc1f47fff9076f9f3838e58d5f85c43f7b5,downloader,761960,3083,5875,6122,9205,5875
2268,44f33a264ae9cf09eb8605c71d5598b58239416fd3e95fdc19481fee559a2099,downloader,181348,759,1447,1381,2140,1447
2269,4590b2b862addde5fb5358440623ca231a39d8b3c25f2770eb69582b02b68ade,downloader,182389,761,1464,1405,2166,1464
2270,4618a7836fd4a968f6d4177daf8954874df9af224e70006dbb551cd79ebe7430,downloader,147244,664,1142,1213,1877,1142
2271,461edeaa9638dcb2a92ba90d35064e84b6eafb47b9f506c0b50232aeeb9be239,downloader,181802,763,1469,1376,2139,1469
2272,463fe5a40dfdc2e116e1e54d1982ed5d95bbb6af9f045474863beb7431947b33,downloader,301460,1245,2328,2386,3631,2328
2273,46fa20146267074393db160f138aaf3d1d578e071453d6c0d6d41627232ff0e7,downloader,29897,160,272,202,362,272
2274,473a8507eb6b1c68a1cf74e6b712776297e9263410ca55248c1088623147b584,downloader,186827,783,1489,1451,2234,1489
2275,477d16e3755e7d921c921c637b9ed719461326b46787b74db4c099c3207c1dc0,downloader,118172,497,955,915,1412,955
2276,478d0d304d72b1d6bfc532350565c561ba80228ba28a59b5c3b77084f2497596,downloader,116983,510,930,901,1411,930
2277,47918a9135288ad1e7add5b67acff4a4c411c8086dc15d395d065d4a6db50c29,downloader,187045,776,1492,1445,2221,1492
2278,487e992b3094bc6b53041ec66360c31af97368615d57f9ad08a69f992e20ab1a,downloader,180736,763,1442,1380,2143,1442
2279,488059bd07f2155471a7ef3965a0c2992b56c5172907cf40a45ab06ab6cb1a62,downloader,181995,763,1468,1404,2167,1468
2280,48a77200f4768a5142da09474e435722474bc1d4e9211c6ea3fa0d93d5cca360,downloader,30502,145,264,241,386,264
2281,494f68d1a839c6374c08d558a91a6e39a25f1bca8ca58de850414f6ab76b9c91,downloader,115631,497,935,905,1402,935
2282,494fef1322113c2d22f8ab301c7c3213552f1c5df527a0ea65df6ee6d17048c6,downloader,118185,509,961,903,1412,961
2283,498907875688180b3c40c4416e091cc3dd3389f86eb74e846bc81a5c9ccc1f22,downloader,181409,753,1459,1374,2127,1459
2284,49ba96586af1374b3a08839fa2eba9e507ee54e9c9b5299a312a9d21f31a19a6,downloader,186716,785,1488,1416,2201,1488
2285,49c2fd465800c2759be248d9147531fdd5fbd209ddeb1f0161ee813e14118497,downloader,181094,757,1439,1389,2146,1439
2286,4aa23a695b0dbb1973f377ee155f026a7b78a58d4d6a9938a5997071abc898b4,downloader,118243,519,957,922,1441,957
2287,4abccd410e526bdf4995ef5f7b14f1464c25e0da86c827cb75c720a2b687b741,downloader,117486,512,946,905,1417,946
2288,4add3fb2cfff943df28960f0df6e580cdcce4f9bf8cffcac5b1a4721536ea126,downloader,181743,747,1453,1375,2122,1453
2289,4afefd86ef7ea0505b5d8d327a41d0fc9d5a11ffc44f152c80d2df8879bc2a59,downloader,30683,139,243,249,388,243
2290,4c1dad6d34f55dfeb282c544b9ae1777530048798c58e44ecfce33de54774899,downloader,117921,508,947,899,1407,947
2291,4c49d99d13b7dc5dc59a63918d365153686a3fed37d776fc0b9793f9ef3d5594,downloader,762786,3081,5890,6127,9208,5890
2292,4c4af0e01f08e9b5b5fa4aa0638b62124d140cefe48fd4f8871af9179628852f,downloader,30957,138,225,249,387,225
2293,4c60c6e37a4bfee55bf4f6cebd0d05b6716a18db702b85d30454e9445f491bea,downloader,186912,789,1485,1422,2211,1485
2294,4c875e8b42fab562c5964b9ab9366aeb361f84aa361a834fddea737db0482ce2,downloader,30505,140,250,250,390,250
2295,4c9b2b7cd0d22a5bfa4ee61032e0536b47cd14f93d1befe3dfc058e32bff7448,downloader,117595,510,949,910,1420,949
2296,4cf185f604b68e88211cbf96417020643177ac4d3c643845cc46656d90f2506f,downloader,116868,497,945,907,1404,945
2297,4d2587991cc7961326969d79703628071b991cfd0f189d220ab4ee35be74f0ba,downloader,187396,787,1492,1448,2235,1492
2298,4d57830b3f25e56e17b34961fb2bd93a97cd0473aa66a518991ea0cf96ed0397,downloader,117688,494,943,918,1412,943
2299,4dccfc4b25d368bd3916cf255ba508ab7b642ede386b68e684f7cfe66ed58f20,downloader,763103,3084,5896,6124,9208,5896
2300,4e1f40887edb1b21807d1956a2bb3245ba21747d757f8e6f80b5a176555ae94f,downloader,117563,510,938,915,1425,938
2301,4e98f66ffe487f258373864c9f29a46d407fba013e2e4e14f5e28f8fcb7a4df7,downloader,185275,781,1472,1410,2191,1472
2302,4edf2e85787a0eb8c592bdea724e39798779ba8e8157f752637ae14ddf5806bb,downloader,118691,511,944,920,1431,944
2303,4f6326174b61209add1d29e25a9a99a9ea6d3f1816671a3919617de37c7d1a76,downloader,119111,511,945,926,1437,945
2304,4fbbdd92d35760db8ee8324880129184856e24a9f7e2a11295533348583e3379,downloader,761756,3071,5886,6103,9174,5886
2305,4fcbd35c9f66eb2a401ab02adab89546bbe01bc65fbdac7bf12c6f68c30b11b8,downloader,690828,2672,5361,5418,8090,5361
2306,4fd305eb869e8cdb6c8c0a426e027191c8c18c9974ab1c8185de44538aa4979e,downloader,182652,759,1468,1398,2157,1468
2307,5007ace2a40ffba252df0e4f8492592eed22bc5d83b6a2162a92bf67f6fc6a88,downloader,298213,1242,2288,2370,3612,2288
2308,50254b78011c253809f26499a2bf5919eba2b517da2523d6c4c0f062bd8e5a95,downloader,762113,3082,5875,6100,9182,5875
2309,503f348e7b7d32733728ffda03b2021b0f1c95a1e199ea44aa6e1316484071d0,downloader,118159,505,958,912,1417,958
2310,506cca9af873e7c83ccc731a6bf8f32b70557794034418b258c2e4f1f1a4f7fb,downloader,116584,504,943,900,1404,943
2311,51047162105dd43bb87763ee980ca9b8b02b59ba151363e418afc8e458d8f7de,downloader,181906,763,1446,1373,2136,1446
2312,5145fdac267b98e4fcddeefa3795b528b75582bb3c20c67984bf2e3703880c03,downloader,116720,509,942,902,1411,942
2313,516b173e8c0beb40ef19535f5bd05ef0803c25fece44b32dcb48eb30ef3c08bb,downloader,187050,786,1474,1441,2227,1474
2314,52d3a384d6466a79da98850905079b4d9bb73477e2066bd29706e72c1d76d8da,downloader,11173,59,108,100,159,108
2315,5319999540a76d8cc07a00b2bee1456ce87225436810b1196dd4f378467324a1,downloader,181638,764,1446,1394,2158,1446
2316,53225857061df39c3fdc779fc8d312103b12428ade4aa298262ff8bdb9184eda,downloader,183659,770,1453,1394,2164,1453
2317,5389d7bc442c7a889fdf62a9930ecd3ef94fb33937a7e55c057a195f17f1384f,downloader,117817,508,956,920,1428,956
2318,53dd3b87b343587f983e249231a9dc83543c8e77e3f2d13bfee7d8502ba69802,downloader,189102,802,1492,1464,2266,1492
2319,5416643c1206eb8cfef3277c11ba9ad24c31a0e652f4b62afb6be4d164d6cf8c,downloader,118572,508,968,913,1421,968
2320,54a16de7ace77c1f349afe5b73975a2af35f50ad1a153dd85c493db28edc246a,downloader,146432,653,1145,1205,1858,1145
2321,5510f2f6cb758baefa2ac7be06d16787410ab3503e3db97f9ce797a2ba6da2fd,downloader,117932,507,953,908,1415,953
2322,559a164365ea0a657bd7556f889e6c1b63fa9e7b97b1ab7ae5c6da5d13088b75,downloader,118262,503,952,919,1422,952
2323,559a4e4c8ba90f83eb2fe02ac8bea3f0e3cd7d40e99f6f2bef00fde7aa6a199e,downloader,762632,3077,5874,6117,9194,5874
2324,55ae91ce7276aac672572c7c7003cbaa3d75c0faf039a661ca50373a2f46a02a,downloader,30634,121,234,256,377,234
2325,55f1e001914aa6c78adf5f0a49e137b8431fd9bfaa231ee0cd89100bfb1e5aba,downloader,187883,800,1484,1442,2242,1484
2326,561140eae60cc45f481d247b3842c588d3fdf564898d3b20dfa333c5e7841c3f,downloader,182583,762,1472,1398,2160,1472
2327,562cf3c7306938ee4849a42b381feda170170d01340d2028691b08dc46b70b02,downloader,117796,498,952,898,1396,952
2328,5630185dd64edf675fc9fa18a5ea31f4c2092fa5c7d381864e4fd1a0c9cec767,downloader,186777,782,1487,1451,2233,1487
2329,563920eab23b67bc7e166166e0d353052ecebd16e999b6099fc71af255615d97,downloader,762895,3067,5880,6117,9184,5880
2330,5690bb3e8d9a2258115ffaeca6b16a77c6c0fd8523fd26ccebf03d87a7222ee0,downloader,762675,3090,5921,6104,9194,5921
2331,5690f36b3f81503c0f15a4c48c9a151e49898ef5a345b8f86e5d398eceb5b793,downloader,183464,767,1472,1407,2174,1472
2332,5765eb4ad0c3984b41a9a8c3c65989cf8863c7b36881a0a9e1e8f2bfeee83e55,downloader,763087,3071,5890,6125,9196,5890
2333,577d71977e26ab0ba4195436e8dcf3781a4a77105d8c46b85d6a842685217e70,downloader,11162,39,104,104,143,104
2334,57ce47e74455888a2a92bb1696a3e617d73e591773b4bd6e17ee6bc67ffae793,downloader,30632,142,278,232,374,278
2335,57d30f2ccc5624c4c72bf81df8b90bd32509278333e8ab10bb8d8bf7a9259ca4,downloader,181730,772,1452,1386,2158,1452
2336,582430c453c3cbc3ff96f43a0de94fefb5c20fe80a586c12af6436ab4a8599ff,downloader,118620,507,932,914,1421,932
2337,58348ef65acaab138d218374c9ef7cb65f7cf9533270a06ecbe39e85b8be9912,downloader,182616,766,1458,1393,2159,1458
2338,584569f6a980da78137a049c3e9fb13ff2bbef988e20c09bda1a71e3242cf45c,downloader,181984,767,1445,1390,2157,1445
2339,5856d4955c120b1fa22a96fab30e369daf749932b688ae1396a466f5e642ee41,downloader,185322,789,1478,1408,2197,1478
2340,5972672b74afa1fb0207ceabfa5c28a669cd2155fa95c97a83d87209a4157f22,downloader,181464,763,1455,1390,2153,1455
2341,597a9cf72e195c5cc5486561324180e6ea3216c28e4eef9c55e100730e009ad5,downloader,182468,749,1446,1390,2139,1446
2342,598595b6188931dfb2b5ab22cc8e3f011189ceebab5b86e2cd0150ecc218a991,downloader,117245,509,949,889,1398,949
2343,59d6e39252663be06c99b7aba49f49a7cae9d70cd15190e0d52e9df9a9af5d60,downloader,116765,507,936,906,1413,936
2344,59df238e267eba36e92cce42e7021bf5be3de5d6ebb60002871793b9eda70bc2,downloader,184386,769,1486,1400,2169,1486
2345,5a5ed397f9dfe7c5fe0e71683864f893b5d03558f14983276978b4415cd161b9,downloader,30559,133,261,247,380,261
2346,5acd6c947153145e8f8925a230ad92158dace91f416ca368e4764c5234f2fd3c,downloader,301339,1245,2326,2397,3642,2326
2347,5ad7271f371e7e1fb4037ddbac8dc3f6aa1f9285825d2151698047e848c889ec,downloader,118336,512,956,910,1422,956
2348,5b22bf495044477c8c30761d2421df6ace571a19e2642cbcbfd44dc984f2f2f5,downloader,186795,791,1486,1419,2210,1486
2349,5b3ac8a67c2e672dc9ebdcac87b17c59acaf68df1ffa3460dd5aaf6aeb06cc67,downloader,114393,490,927,879,1369,927
2350,5b92ffbc54e1cf43775cbce2e2bc3943f466fe0ccefeb17a748cbff80aa636f8,downloader,762199,3072,5890,6124,9196,5890
2351,5c028969a417fb863bda60b1f3f57630fa6e9a39681aa96303f831f54e1a0b7f,downloader,189101,799,1504,1454,2253,1504
2352,5c10253c5ec821f167debd2494e348fcbe2396d5989da6e91ffa58acb2ea1d26,downloader,182892,773,1450,1409,2182,1450
2353,5c12c6a5f673326f6bdc445147444520cdf1410c5d77f58354b0ecfd8cbd3320,downloader,118282,519,962,917,1436,962
2354,5c1ca2506ce60ff5b3ced3e4e9fe59757493b83a98c40cfb7f3dfb65d3644d35,downloader,117861,509,953,905,1414,953
2355,5c751b4cce8da6c63b50b08990501c3d9e9a8eecc15ee6758dfbc22d46c22fe3,downloader,181447,754,1456,1385,2139,1456
2356,5c859740f0b6df31dab556b45b882bb056a4a64ba2775124832d7b8fecb34a4b,downloader,180734,764,1441,1378,2142,1441
2357,5caf8503b2dc05394a4c7ed94833ab3c5cf54e88588710872d593bcf49078522,downloader,134365,590,1051,1005,1595,1051
2358,5d23eca620d5dd4c5487e923e0ddca79ce311ec23e4d752db9d934a656dacbe2,downloader,187999,787,1513,1453,2240,1513
2359,5d82e90f913137729f34754451a75bb8f13f45384ba461e41e325fb0d8e12c05,downloader,302444,1256,2339,2408,3664,2339
2360,5dd6fa4718af2254aaeb832774ebc28a3ffd9e80f927dc19a4616a177c512832,downloader,189271,793,1515,1460,2253,1515
2361,5e0f671e773ae6fb28e2c56298a577ad3ec24007a892489c5ebaf92885362a06,downloader,761803,3068,5885,6102,9170,5885
2362,5e49ec87c1f84b2a30bbfdca61c64344894609221cf5360025db1ce4d2a5617d,downloader,186749,785,1488,1416,2201,1488
2363,5ea28fbc92beb5b05b5e1ae74bacbb908f543c91709aeb129d2e566dd856174e,downloader,118384,500,951,922,1422,951
2364,5f13a383c84cb6bc4ba07364fce6320385b9d5a3d159aa64e73e6dfeab9e9da2,downloader,182284,763,1465,1396,2159,1465
2365,5f41db724839c11450a2a86c1d581c71d4f3806b1eab0714148dc6721d5ec3c2,downloader,182404,756,1459,1401,2157,1459
2366,5f82f628aa33e2a4598140a529d5f893ee1c20d9a09a874dc189963de6c553c0,downloader,182057,760,1460,1386,2146,1460
2367,5f9ff7226a53af521ea06d50d9ebcb0cfdc721daff2992d3c4851f8d36d89639,downloader,118439,513,968,906,1419,968
2368,6040ed5b53ca0e6571c5087cb8725d432f42b32e03db39b6d3f57f60ea4ec789,downloader,184572,771,1471,1404,2175,1471
2369,6053b78f57c3f49c972635ff6f4cd734506675e3adaeaca096a17c13c98c48aa,downloader,116973,503,925,903,1406,925
2370,605581c842488beb7b9ee5eb89a0757f6356c9a3dac80727548e0f6800d9f5cf,downloader,117912,506,958,909,1415,958
2371,60931799c4b20670949f0ae50fb92e0cdaaf653937a04c78dd4ca93b64999047,downloader,117969,501,957,896,1397,957
2372,60cc428ab569e3d644480511135a78a0078ae6a72811e1e56d749673f0f95073,downloader,181982,769,1453,1403,2172,1453
2373,60fafefeb66497c58a1a1e46022fe0886714bf959d300c79af3bc53a2cec0204,downloader,11212,43,89,97,140,89
2374,62285ee0cc05a7963e01eaa1b5fc1a13483df25b23e26de7f8d3cc47b7bdf8aa,downloader,187205,792,1499,1441,2233,1499
2375,62c7ad9a503bb0b736894c28335ef2ad211871cc6132b801708114a62cfcc71d,downloader,115568,490,942,895,1385,942
2376,630490b1890a0740b1c1bc48e98365367bcdd5d512ca0d0599ec2e61b7a681a3,downloader,115243,492,942,885,1377,942
2377,636ccb6a1b29b903002d81af10ae937411af24abbf82506d6ff914318e78e7fa,downloader,36468,146,297,319,465,297
2378,6440f42e2f07177762a805a873ff5350db481fbf6c641aa97b9879e457065977,downloader,11435,49,97,93,142,97
2379,64706c64049f422a358daf93c09ddaf015a698019ce9b7c0ded90f579706bf92,downloader,181503,763,1462,1394,2157,1462
2380,65cb393a9157c657aa673f4c944ecaf1deee86a8f21e262eb140669857d875db,downloader,118231,504,950,922,1426,950
2381,65d07953354f224f5aba41467ba8e6299d7fbf4ec4bff65f45cee00b6db8c709,downloader,187380,786,1479,1427,2213,1479
2382,65e8502374365bc374783ba65b365cd32f152121b332ff3a87017d0e83275c08,downloader,180887,758,1454,1393,2151,1454
2383,65f73d7269ce94fc2d33f4064202ef52244f7c62d5681d0a16b10eb6ad60e928,downloader,761907,3082,5885,6116,9198,5885
2384,65fd700857150ad04bdc9045fb97ae29e29199c69cea8e94b0cd4f603d88b5dd,downloader,188636,805,1500,1437,2242,1500
2385,6601b9b3888f028e5d386d64f14d49e095e9e577f74951e78738763abcc038bd,downloader,118798,509,959,919,1428,959
2386,663ab005951f270c46600d01fb48b49cad768c80a582a488e62008c30a8b6edf,downloader,182284,754,1465,1392,2146,1465
2387,664dbf4efa88123e9819b5dd092ca74c49faa4c7c0f2a2e87297ab8447eca7f9,downloader,181868,763,1455,1391,2154,1455
2388,667abb899ab302c89d912eb5585d7cff5a6be3af0ea1e60c12a72c3ccc1f2066,downloader,186835,782,1487,1451,2233,1487
2389,673f41d2dca6cbd0775ed6a34508bc05725dece08ebfdd46a13477cb015aabf0,downloader,10863,34,105,87,121,105
2390,673f937ae2c20919033850a6ea4b16921924e96bf193d48c887ef144beefc627,downloader,117794,514,952,903,1417,952
2391,6771531c7ccc22bbb72a10580e9a593b4aeacc61cda070704fcd446a50167f2b,downloader,118837,511,957,920,1431,957
2392,6788f06dd5c616af67a51468104021adf280b105abdae79ad624b122000cf340,downloader,117700,502,952,906,1408,952
2393,679eb35d5b4d792addcb05be74790ea64d6e83348b070b063631700c04ff1d99,downloader,118145,526,948,911,1437,948
2394,67a287565712c93157274dd163c3e64e04d822b990261c5eee11eb1663c009bd,downloader,182613,762,1473,1394,2156,1473
2395,67f587e4d9fd2c1ef57ab37852f49c94f739d068a9a15c5ba6a7d28c29a1635e,downloader,183409,770,1468,1418,2188,1468
2396,681281126c1c9efbd3acee5a54d47dae2d6868ab585c00caa97cd352142ee3f5,downloader,30183,146,258,235,381,258
2397,695301fff5c45d12e6bfa0c75bc49ebfa68100c4ec0dee75fcc4733e9d97bb82,downloader,182602,763,1472,1399,2162,1472
2398,6963e678e8ea04ede4e8f10f2b90ec906ddc32d625d568cd9364f6da0219571d,downloader,186943,786,1476,1434,2220,1476
2399,699b62d730ab8af1a2be8a6ac6a392981d8e62d7fd8248ef4382dfb3b1c49948,downloader,181793,759,1453,1385,2144,1453
2400,69c0ca19b8fb9ee2c66f510352209ec87906575c5ba2b4b6655c1908e8fa1676,downloader,147014,664,1141,1209,1873,1141
2401,69c814b0987efe2b4901c780c65b082b3e97f4b23fb8420678bd4c5f4c7124d1,downloader,115320,498,937,888,1386,937
2402,6a2b136125db6c12f1f20cc388cbbfa4ae4ad8f88ca78786be38dc3856ee6872,downloader,187431,787,1494,1440,2227,1494
2403,6a87b07c02bdb38844a8a1763ae941becd442d1627366a013111943076d3a4ed,downloader,187943,797,1485,1455,2252,1485
2404,6a908f320c6101e8addb279c696b318194c38059721589d35b9682c829f928cd,downloader,185463,773,1496,1405,2178,1496
2405,6ab1c3aaf43b6db0c114c1c1819b78b09017cd4c7d44e27f10f94337c1371121,downloader,761760,3081,5881,6124,9205,5881
2406,6ab2596d39826ab5df67f79749336b4893cedd994e45a3e5590fbb0f38f70776,downloader,181146,757,1455,1382,2139,1455
2407,6af0cc4adc19b8300150addaf963a979521b5a14d05a1f71b2b7dedc82b265f1,downloader,301458,1245,2319,2394,3639,2319
2408,6b1b54510472bcced96af1c369f43e53ae126855be6acfed7ae095f56967e3d6,downloader,181795,760,1449,1390,2150,1449
2409,6be9ebc40b0e57de3da7ccdd57c97cd9cb9b56716fe43f29e263a373d7146a8c,downloader,118727,511,947,915,1426,947
2410,6c6755d74d9bda58dc258585e25501389cc9c3261b2f5797f1f6363f5ac12aa2,downloader,182225,766,1453,1394,2160,1453
2411,6c76ade4021394c90f1c92792b0c9b753c992f79b3faa6d58f2d62d847658bb2,downloader,181376,754,1446,1382,2136,1446
2412,6d92064e3ae33a9e19375a85d214b0a1143fa0699b6b3bb222bb1444f09555f0,downloader,118110,515,940,908,1423,940
2413,6dd5485cf3f00768997f154527b4cc5aa1d5d024d5de6c536f0059a3d6b0b57f,downloader,115914,495,929,885,1380,929
2414,6e9d5c734486f135de9e14831a6147a64fd02aadb3f072041200d2a44e4f8649,downloader,181297,764,1459,1387,2151,1459
2415,6ea769f45b1101e9c0410e473c3577485ec9fe39a372d1d339fea50a83386c17,downloader,182858,776,1462,1413,2189,1462
2416,6ed5a142a02b593b1496997382319af6690aab31a7756b681058177d13584b98,downloader,30145,127,228,226,353,228
2417,6f2f8e14059e50c4dc50856a2da3ab96b0d94632e6d26f7863863cc1db34c2bb,downloader,181319,751,1454,1374,2125,1454
2418,6f5eed12ef18bf8505302d65c44442a8f212abe479874795b84fd091fee8f72a,downloader,117861,501,944,883,1384,944
2419,6f95a63e7397917bf28ff072025cd1a90407c358a1fc8585cb493c2147bdcd9f,downloader,116643,498,952,904,1402,952
2420,7099d57583ccd1b479925d5d1a66aad4d29eb3272c2c1a1ace7640b575507587,downloader,30734,136,271,253,389,271
2421,70c751c1e8fafe79d1f897a949acd9afa026b97ce6a65880a724abdaaabb12e4,downloader,147001,674,1147,1219,1893,1147
2422,70f81d40f8c12eb037355c1a823ece0ea0807df62a3bd3da3a531899224431c9,downloader,118573,510,960,922,1432,960
2423,710a57bed9b1c9c8fc3e87559030a88b9f03c9785ffcac6b1efbc30d1c304de7,downloader,763238,3089,5904,6121,9210,5904
2424,717d36f58fe7e474faa4392cd34b926fabd147fa7f0f6e3dd43b86b77a0bc778,downloader,188154,791,1495,1469,2260,1495
2425,718da27d80bbe3cf062d50d053092644a42f002789a1439f91d91be38f70afc6,downloader,186586,776,1492,1424,2200,1492
2426,71a461f764824de2c08da3df5e1828f40d91a63c51695d9319a8f9fb622cc08a,downloader,182373,767,1463,1392,2159,1463
2427,71ed87766dfafb979a9b3276d810397be1f61ac6bc23419282f977e8c69ec1ff,downloader,118665,508,964,928,1436,964
2428,720a14a5e1ef8db42d0f901a8671be6fa63fde4935e797d664800813f232c73b,downloader,301985,1249,2319,2407,3656,2319
2429,7250013bce400f25c5c945c5d26d4e82868b5baa2a5023a2050006389fc763d8,downloader,302085,1246,2327,2395,3641,2327
2430,72896365f9c3b54aaf498e1abc6c887e2e6e227a017e571592cc0096057ec096,downloader,189128,796,1505,1456,2252,1505
2431,72ec9c4c48368c1524f6e77d8e7160efcfeceae0d7463f901937cd453f1a5fea,downloader,118639,507,932,914,1421,932
2432,7304ae8a5abfa61b038d688f508e332b926a95d8367ec306a437e4e3e56aa561,downloader,117867,499,953,914,1413,953
2433,731656423086c3ac8c7aea93a5cdf965c8d3a9f2463362d83732c38510e0973a,downloader,116501,506,939,902,1408,939
2434,731c8bdfb8bdf7dc56b1f5c2f86eb8bcd1cb22f1ee54711ac04669c081a97c26,downloader,117741,509,948,901,1410,948
2435,732c8d5893fd5c2f7d51e878cdbc78e7d39cc8ff7d37974ba3daf7dae50ac18c,downloader,115623,496,941,893,1389,941
2436,73b25de54c65cb1d892cd2bc7d13e0500852589607fe5e8659f7addb73eab93c,downloader,181722,747,1455,1380,2127,1455
2437,73dedc6066c2f9c2d3764eb3671297e8d60cee9bab89b1d3d6a18d608acee169,downloader,188790,811,1499,1435,2246,1499
2438,7421f7ffdfee670bc9ba7f3972f365ba0a39b1d407e732a6062e2c93556e4289,downloader,181957,762,1466,1402,2164,1466
2439,7453f620758b77c86b37c598e6a8206303e6b75641d8e5c8609890b7012830dd,downloader,182559,763,1474,1403,2166,1474
2440,745402ef1cba69258a2cb0ff01cd482658cee5b410ec84f83b66005c808f2f83,downloader,118087,508,952,908,1416,952
2441,74c29207ae4671ed7ec6b3f21eacc1370b36e8fabeb8100f1046d7ab7adebce4,downloader,181939,769,1471,1395,2164,1471
2442,75aa1cc311e1f17b3070b4cf485ff9c43a7786389eee5fb6986d0fc229bd10e0,downloader,182228,761,1462,1401,2162,1462
2443,761507ded1752abfdf2ce00f327711e13298a3539d5ac2bd96684e995eb2f030,downloader,180021,754,1448,1379,2133,1448
2444,762b474660ee45d4985182ce366b13df88b4938dfa119a13ca3c0abff62737c2,downloader,162039,693,1265,1228,1921,1265
2445,7696e745d64000e49f67f400f0ac9681ad76b2944cbe1615c4ad735758f8ecfd,downloader,182238,760,1465,1384,2144,1465
2446,773d81571e8d2996de07b440deeba705e642c960146cb878a88f9611e71e7c87,downloader,186824,785,1476,1434,2219,1476
2447,774d720c73e25ccff194f36a1804cf679c858bbc8d159d9dcf939758957d88b7,downloader,186884,771,1492,1453,2224,1492
2448,784545eb0d75f3844be335d703e7373da56a936c4c676f69240c463f6458b602,downloader,181944,765,1459,1379,2144,1459
2449,78d6eea0cd0dc9dfc441061c35d68a427c10594d09c7c0fb38be1d51e1497790,downloader,118364,511,943,901,1412,943
2450,78f09065b14d77ac10f1d6e42784f7ec1d01deebfa5761c44f154be43c178ab5,downloader,182867,763,1450,1398,2161,1450
2451,790283cfcbfefd71814d4776e1fefd1b6b3c934318f0c9e5337a702b89ca51f9,downloader,30638,138,269,248,386,269
2452,794805221ead142d284efa3515f85f0fee22be5198496b26b580f5fdafba4eec,downloader,183060,770,1451,1397,2167,1451
2453,79d4b544d8585b33b7e76c6859088dbe4d235b9acd009571cca58df10cd82f3a,downloader,30630,139,255,221,360,255
2454,7a12d0e254c75d3f74f1ad83b4134b25cf8223495c86ee1bb97cb32e1e0d8d67,downloader,147134,658,1144,1223,1881,1144
2455,7ab012ae2e803c7995bd7924161c92b6d63e78b6a6446cd5007d0f63dc2a150e,downloader,118338,508,943,919,1427,943
2456,7ae08340a178e156f69bcbae427403d68d504f79cc06f343de39ebea58b19b4a,downloader,115755,500,943,918,1418,943
2457,7ae5e22dbc5488ab48fa215e14b56cb10947db3ab545acd0f158759277d2dfa7,downloader,118140,501,961,918,1419,961
2458,7af0699bbe2e640b75ad4fc2fa29c654781d7726fa3b6d6778cfe6fde277c3cf,downloader,116158,503,935,896,1399,935
2459,7b4cbdbf660d79c08ced6dfa6e0235f3c959c237a7bb8190bcd89d9b18471877,downloader,761982,3063,5897,6100,9163,5897
2460,7b96fd63e22451586a67d74221daf03091bee87197feb0212112202d91b35754,downloader,181843,748,1449,1395,2143,1449
2461,7bb1be6f17e87b0e77b2fa71f8f39c23a85c71f008871e09ce81d8812017b75c,downloader,186836,784,1476,1435,2219,1476
2462,7bcabae949a9d0d9f313b5434c3393148058b7d442d5cc86f797e1b0deb6b6cd,downloader,30753,144,216,265,409,216
2463,7c69ceba9adec540ebafbbeabbacc15f1df168e9bb45e98ad0c0bd9fd2117747,downloader,301686,1246,2317,2402,3648,2317
2464,7cfeac2e3d2b3e0ae24ea12590829404baa95928b46973f661eba062de82eb6a,downloader,187675,791,1492,1438,2229,1492
2465,7d5aef18f3e9de38a84f2844e0b3c59e0ed36ebd25a5b15d3ef0611b779805a2,downloader,187788,789,1506,1429,2218,1506
2466,7dbe7c94f408f10e3785a3c2729311b814b8648cc815d41d8e457a2e6dc2bd31,downloader,187047,784,1489,1452,2236,1489
2467,7de4cf209ab15657c4bcb2817f24acc056961a9f79b8ac0f68ac838a75815b46,downloader,298482,1240,2296,2365,3605,2296
2468,7df505876afd756a0365265325d0ec75361352c1f6cefc57179c6dba2eb55777,downloader,180522,758,1438,1390,2148,1438
2469,7e0865a4de1e1b995bc4060ed8ccff06735d37280b66cd1968f372f9def34964,downloader,186780,785,1486,1419,2204,1486
2470,7e8dde9505110882596d7f42ab938a2ca1b07e1be9e1d876a8d0c5d757fabb16,downloader,187902,784,1498,1440,2224,1498
2471,7ea6f3d5cfdda2b7087bfdde1afce2d26ce514e99147c4070722d110c2b756d8,downloader,30670,146,289,239,385,289
2472,7f48efe82e5fe2e46ec981203691091aeb40ce3534e7fa5fd8965f33b016ab19,downloader,29835,131,252,227,358,252
2473,7f64596c0b26bf03a30ba8225976cd9c987618c04636b42a7fd37368fa7ac333,downloader,30575,144,276,216,360,276
2474,7f9726e25067788a20540bafafeb06883f7bbffc4c0ab8cb83e53420491b93ac,downloader,115954,500,942,896,1396,942
2475,7f9f823ab1f8be1c29a8f126aec6d6b81a68a5db9dc2518fccae5014240d45ba,downloader,181759,759,1475,1397,2156,1475
2476,7fad2788ecf9a0235b997d9b9976b17eb718897c914fd80f6ba880ed7333e56c,downloader,301997,1260,2319,2402,3662,2319
2477,7fb57b04d6d741c8295ddc9f3906c55cba72ccf7a868559bd789498553dda8b1,downloader,181297,755,1451,1381,2136,1451
2478,802e21c761db8948c154771114a356f4fe54b45c70552a6d66e5a02fc94a6e1f,downloader,117201,514,938,891,1405,938
2479,807060b90ab10c0d41501d1ff279160cd383b3710c5ca10594f29e1114d00beb,downloader,115523,494,938,895,1389,938
2480,8071ac825ce64a162edfad52bc72a6be01a22371e6be74fc131cd6056c0ded2b,downloader,10741,44,85,94,138,85
2481,8094dd7215fe6d462bb132594e7c39086decd4c4bb8c19b72c5045d45c31e5e1,downloader,182142,773,1446,1391,2164,1446
2482,8094e059170cec94dec6fe26f135422a6884bcbb4a6af2240a8c00e6e334e895,downloader,186879,789,1492,1419,2208,1492
2483,80a58929a014ce00a545b5efce7c5a8743ece51abd72787d709679d3e6b97ff7,downloader,186795,799,1482,1421,2220,1482
2484,81a0a03adbfd19837836952849e7add408b6e1473cb0071e0004a4a95d83b390,downloader,77405,350,631,594,944,631
2485,81c48cf01df7d1fcb38cd03454d880b7440e1abe974f82a87cf7a684b9bb64f0,downloader,185149,769,1482,1402,2171,1482
2486,825f767341e2b19f76996727363c9510c84165d39561720a6fdff32fd0feaa98,downloader,118180,506,957,924,1430,957
2487,82e2abc05475c9886a20aab8dcbe0946e0d2247914380d12a4b97d77c07b6323,downloader,10786,42,85,111,153,85
2488,82f8a878f3236e551496164138b58ff2b55c8df0bab70b3ea93e6b23e557a669,downloader,182620,773,1473,1400,2173,1473
2489,8347466fbefca25236645a8cb641a99ed07f1c42589e8b101a4983d3c65ae3c9,downloader,182464,756,1449,1397,2153,1449
2490,837a14a7c3bea18c604a49c159331fe57d463c8c7082ecc3ccf8df93a6826013,downloader,187892,787,1511,1434,2221,1511
2491,8385ddc2f1360d6e6253ee67dc86349077d896cb8e6cadac7713d4a5a4c8e0a3,downloader,186863,785,1490,1416,2201,1490
2492,83a2afd3383896ccb570692dd8dfc1390fd9d01c7c2d906ec7479a0427c8d3a1,downloader,116453,498,949,896,1394,949
2493,83df883e1b67af2f711acc94a501f9f2e4552969738c9e735ce614906d74555b,downloader,116624,511,927,906,1417,927
2494,83f27a8746df8e10508865850c67c35e0f5b269b37eee7664e294858e828cf51,downloader,30852,152,257,249,401,257
2495,844a123ab3df0f6015bf62ca8a1d850f81e08c075ae9afe7a0503ccfc6e54d97,downloader,182203,772,1472,1386,2158,1472
2496,847b43a60354e34c951757ee44d2b39cf982ba1d6164502d7902f67ee9835825,downloader,187707,777,1494,1421,2198,1494
2497,848943f96b0d7fede4b8432f8d9f88833d32a0a6d5ca382c9b28e5c1a995d049,downloader,762398,3066,5893,6120,9186,5893
2498,84bb6855ce00f3362c785066246cab31c39e4404f0c85016e84b5b7bc908b0ad,downloader,188697,795,1508,1451,2246,1508
2499,851ff4cec8aae026c748cf5363cf7f77ddd098ea46230ab7c68c8bad94d40670,downloader,30186,122,248,224,346,248
2500,853d3b3f676b6b445c051542d6c4c7717d0681068106a77c75bd6d2586c634a7,downloader,30640,160,249,239,399,249
2501,859dd50cda8ec2968078f3fbd262484d2b8cf06dfd3dbae0510add31d9de5a19,downloader,117553,503,950,905,1408,950
2502,85bfa030a58f818926e29d041e78fe8b7d4ed49bc1336b290c2852bc9af85389,downloader,762742,3081,5896,6117,9198,5896
2503,85cbe711d6e83754ecbef68e2458501163addccd5539418be9f33f3e9b52e5a3,downloader,853382,3334,6644,6751,10085,6644
2504,8602bcd3bce7e88b275fc1fbed607ea4b6507acbdcde1b18382da52ed9900a0b,downloader,182247,754,1447,1406,2160,1447
2505,8636dc85a3f65d3f192a7c27c5b3534113beb09320d5bfed64a0590d4ffe121f,downloader,187931,787,1493,1439,2226,1493
2506,86372dbc744bc95bc140a03745ddb1a98763b6c1416105afc2a0144d475f5cb4,downloader,116906,503,941,900,1403,941
2507,8650eeaa350b5a171b5d2327b53d7c1dd52c6cdaa4e996500ed95707fa96cfa7,downloader,187256,784,1488,1437,2221,1488
2508,8752eb56ff32cccb2e00d232be674087264209bc8d6ab5f2479b9e434dbf402c,downloader,116253,496,938,906,1402,938
2509,8781ca999540da6add2b25c733682d4ae79ff7de8367b1c50262907fdf2496fb,downloader,762111,3078,5874,6098,9176,5874
2510,87abe4a3535b752790782908602d4ba577c71e77870fd50805c5be432b6a9198,downloader,31269,144,252,257,401,252
2511,87f74108a7f1cdc6368d9ad59a1d061512f39dc9de2310d27dd8640178aeb000,downloader,162444,699,1258,1215,1914,1258
2512,886408d84bc464b769dddc803c00eaa0872e189cf7d68265a7a64884ee96d7d9,downloader,147288,669,1151,1221,1890,1151
2513,88a8e7e1529a9282dcae6f051bfe72ca729603d9ae6c1e505d032e6a6438db92,downloader,116325,499,933,897,1396,933
2514,88b15f59deb4a90ee236bf0478706d1c06fd12969caaffeca7a7d87d33c7bf27,downloader,185037,768,1486,1430,2198,1486
2515,88f3cc0ca16d62ef9e5f7aa098898860a76f477b887c28ee79a1d96c0c34c69c,downloader,762767,3066,5899,6120,9186,5899
2516,8a2efe07094f5d79fe5ca0ec12dc2804012c2efb04657ee8818c18f2599f1539,downloader,186745,775,1493,1423,2198,1493
2517,8a3116b6e02a160bd04b70ab0a685f65fa12d7f5a9f9417405f652cb0145baf1,downloader,116746,507,939,896,1403,939
2518,8aa63ccefdb3038c943e983d3ba860c1113ff9ee4cce25b429789f2f61e4a617,downloader,147703,668,1147,1216,1884,1147
2519,8ae64a16df3e7ad7f3d4430f258b2073260c2ac091a2a2d3d381d20a1ed875c8,downloader,162069,688,1256,1202,1890,1256
2520,8b5894cf8bff67cc35fdb0424d7585c62a3f1f9e7271cb52adda36a098baf170,downloader,30582,158,249,238,396,249
2521,8b7d5395d1ba38196e7d91712b4eabdccc897cb5c533f609634c0c7abee06e93,downloader,117513,497,945,910,1407,945
2522,8b7fb6f9b9031b98890d8101d7f8f6a57a23118fd6ef077818591a176bd068a0,downloader,187997,794,1505,1422,2216,1505
2523,8c05e9f1740a4b9411e318e5a29c24578ed97013e3f06e4deabd599162a6c72a,downloader,118643,507,952,904,1411,952
2524,8c12ef2f43c54335ed114f5f840087b19fdd7f4534d394572aa0857acfe5339c,downloader,118469,502,950,898,1400,950
2525,8c9f2b3cb98179fa786b93a91c856705fdda757c5b533d5a87d28b408e4e1614,downloader,182533,769,1466,1390,2159,1466
2526,8ce27a9426b482f5448d8992c85a08d3cb77ab82a5832480eef2d82578fcc819,downloader,186012,796,1500,1425,2221,1500
2527,8ceaafef630b724799aadcccbf82d7bab13f0152ce58d33c06a914caf8c1a1e5,downloader,181909,765,1471,1397,2162,1471
2528,8d3de83c43d99274238b3d480c18993f0884fd167a9aa7cfd9c58499120f2b26,downloader,116621,506,954,905,1411,954
2529,8d6736bc4e7bf554afc8b08014eb72861da18f4618eb4f4e678fc762f1950d94,downloader,187685,790,1480,1444,2234,1480
2530,8e219e6ec599414deb8db164b8dd63763866c44b245c623405ebd4756c7385f0,downloader,763431,3088,5891,6141,9229,5891
2531,8e6d2d2ea58bfdc7872da42a52b3d81c2fb7e52c95ec3c1a933345adfa60f1e3,downloader,182097,766,1457,1402,2168,1457
2532,8e7cd020f52fe4576d16eec819c25cbdf8c54ca4f0d8f0094e8de8e8e3a55428,downloader,115744,493,936,888,1381,936
2533,8ea0ccb45779a6dba4536ad05f497328527f893f712c64206184c94c4aca8a9b,downloader,182255,759,1466,1379,2138,1466
2534,8f848719b2d13ab61c558461d297c2d9db076c0da2cf054b21a05f9bda5bc334,downloader,763578,3083,5890,6112,9195,5890
2535,8fc3eda046096935ecd5213d8cbf5208eb60fcf0fad88b3d12bb06f03f4e5205,downloader,187980,787,1509,1452,2239,1509
2536,8fdcf6f29d03e2dd2df1c56e0843c205a9b378d11752538972d1bcd0346e3748,downloader,186733,788,1484,1421,2209,1484
2537,8ff68a4699a39a4662caf16aad39924d6226eb25d2246eed96a5a67410a41f13,downloader,116037,500,931,891,1391,931
2538,900cb07b0f61f34da4f8e5494e6ebf3b73cc2007adee600c93b57640d9f7e325,downloader,181826,759,1457,1390,2149,1457
2539,90411ba38bb2629cb44e3366b84f3819a80a7f94ad494b42860e07741e916451,downloader,117362,514,944,914,1428,944
2540,906fc04b0fdfacc02d651aac84d004daedb627b9d780e9067457eb6192bc1d83,downloader,186659,783,1486,1449,2232,1486
2541,908a93f2b4dae258b17d79b0c866273ee9713da5ae938252ae3a436539f7aebb,downloader,187941,790,1494,1442,2232,1494
2542,911842bb92181ea1133fa174994c3f17ec56406024340ad8b2e1f561412c67b3,downloader,118502,511,952,913,1424,952
2543,913733a2313f5eadd77e386cc35583f5ef4a2f5effe462f4f5ab102894041cfb,downloader,187941,789,1510,1451,2240,1510
2544,915627c330af6799f7c1a6d21bf995ebf8b699e162a075cda794ed034fe9a72f,downloader,188379,789,1492,1435,2224,1492
2545,916d176cd86f3e7a5b7f71131d8c2598ca615ae5489dd55e634114beb13fff9d,downloader,116234,499,937,888,1387,937
2546,918261cce3e142b849ebeaa0c46b9d50901974927fceef40997f2be62a08b95d,downloader,182674,766,1457,1397,2163,1457
2547,918c8a5a8cf467d32f077b08434d7116a8d0bece398d5764835fe3a0949fe730,downloader,116073,505,936,899,1404,936
2548,9277bb2263ee17970433dfea2aa9e1cc3ce4a0639289c178ad0fddae8a5e0413,downloader,761852,3074,5878,6111,9185,5878
2549,929f0a77092ef3711a4d04d8c55610d7defa812ca0961ce87f16867073ed6d61,downloader,186753,776,1493,1423,2199,1493
2550,92b6df0fef151372252ba6aa91f5a53d5221f74cdc23e66af01353db6d77ad37,downloader,181690,756,1449,1386,2142,1449
2551,92eaeed977bcdbae9cf8cabd186b6fc68ca72c0bfb9c1f44f558ce9e4641beb4,downloader,30565,132,268,239,371,268
2552,936c8bf1dd1afd92cae160534223d517b2e1eb80f5b7c28bdec40a557060ae1a,downloader,182117,763,1460,1389,2152,1460
2553,93dc3ae0e6ddbd2398fbaad28fe3d7d739070139d3a56f4bc6eab0a71c3ef14b,downloader,180595,756,1457,1375,2131,1457
2554,94168582117e38d65d33438d90ae34fc3ca349de2af6a9d661a30316245b5382,downloader,30645,151,244,257,408,244
2555,94268619708dbac281d221106a5e58efc2698f781ecb436b277af1fca213dad2,downloader,117569,506,944,911,1417,944
2556,949a17f49ac829a2c2e48f9323e6159dbc30eba2405e4fca8a1182971b5ebbaa,downloader,146423,651,1139,1208,1859,1139
2557,94b2afc10a82090767164f030e6654042a53684bbbdd434936be22bbaed2bac7,downloader,30649,141,269,246,387,269
2558,94ed26161572c0f84db506e142e4eece12c21e36635b8e12251be3daf44e6689,downloader,183519,780,1468,1389,2169,1468
2559,9504f7545f58cde71847f17893a378c124adf391f0e7566420891f3024044525,downloader,185037,779,1464,1414,2193,1464
2560,950faa5dcdee9f0d2b23837efbaada9fde4be28b5ccb9e772dfd94864923d955,downloader,117875,506,959,916,1422,959
2561,9532dc0e9caa254815eb0af13e3c12f85735daf9c1845098bacf39026db08933,downloader,186712,788,1486,1421,2209,1486
2562,95493651be9213c12945a96814887584d306ca2daff576373ad04ef416587d11,downloader,182769,762,1469,1405,2167,1469
2563,9565f95fa6095dcf581e7e99ffdc0fb296d63d700d1af263c75e1283327a4ded,downloader,188250,794,1505,1425,2219,1505
2564,9592d9945f02dcbaf67c1b4bda655cdd36d4ff137ded07b102d45befdf9b0644,downloader,187398,790,1492,1436,2226,1492
2565,9614fc6ae788ad0e8f951e63c194f47eae1c9aab6108fc49d4767fc36afc5381,downloader,762894,3074,5895,6117,9191,5895
2566,96225a0b7ae89fa7a071f4e6388207355a09e1ddafeb889876182e9f112b72de,downloader,117445,508,943,915,1423,943
2567,9625186882dfc2e298bfe5286b1b79461decdcb22ce4962bdbeed20db48c4658,downloader,182378,776,1469,1390,2166,1469
2568,9633553e13314dd5e6f64d809ab61fcd221f6cb857eb1072e2798238c0a86796,downloader,117632,513,947,929,1442,947
2569,96d5ba20bcefd816cbf7e150e873f715e1a75ead7ae692a84c64ce792d67d128,downloader,117496,502,933,904,1406,933
2570,971a6f50f96b548f0dc8b1b7122b1e96f10dd2f5fc1329c80d5e665d1f64f885,downloader,30821,142,211,262,404,211
2571,972f48587b9eaa5ff2df32182591fcd0ee7fe351827918b3fd7fe1295d940b74,downloader,301896,1249,2322,2397,3646,2322
2572,977b42e87ceae19dc86e28658b37c12ccdb6de97e2afc2119624415c2bc042f9,downloader,187103,775,1490,1450,2225,1490
2573,9797e7edc9fe816cdc87c306bd58ba2e846e579cf09da74749e6b409c7c00329,downloader,182302,760,1459,1381,2141,1459
2574,97f5761c16f6d47c2bb64bd761c0d8142d0489db6eaa0ea7f4b0c4f3e6f2835b,downloader,181802,758,1456,1380,2138,1456
2575,980cb270987cc5d4fead0d59170522d8df107dbaf5039e79fd7a81041d6865c9,downloader,117001,510,962,932,1442,962
2576,984c9e07922e150a0b3694e45019534bf65bbb5bdd0b26aae4242bb3ea9d5af8,downloader,183477,786,1477,1408,2194,1477
2577,9888b8e30394ea803572ca4a888839f9c1af66f735a7a35631a2eb1ad9b16c32,downloader,118512,493,961,909,1402,961
2578,98abcf92c4e208945913db74621cabff15732955393b17eddc7616c1916bd618,downloader,183028,759,1454,1401,2160,1454
2579,98c032228ed54a6cba1ea47c7deeed16021b8a886e60174ddbd5ee2a0d566f1c,downloader,182323,760,1458,1381,2141,1458
2580,98d6c71c21a5b268249e99589b0cc971ecf2f68552c883b8218cd3b5cadecc7a,downloader,186265,783,1481,1416,2199,1481
2581,98d91c203c4a41951ec41d1fe23fbea16e4f23ec2934fbb4d814fbf869a519b1,downloader,182106,770,1464,1396,2166,1464
2582,98dde855d1b124b85c21f786a55d775e45674cd917b909436d9bb6ce46416e34,downloader,118889,500,971,905,1405,971
2583,991b3286ec5c1c1aaa5df6df002fa3a171be56e0c335ead0f33e457ceb816ece,downloader,182314,763,1455,1388,2151,1455
2584,993e21cb0d4a9f1a8d537ba170afdad55490de0c8c746da2d4fe1818e1b0ad8b,downloader,188739,797,1494,1440,2237,1494
2585,99b3997f865ecea05785afcaa3e2b55b1dac48a3cb2b8f7d45a64996c960f429,downloader,117954,506,945,909,1415,945
2586,9a228ad34b49d6dd9fc984a6e11f5dec469d79c4596fb3d207ddeb01165b5803,downloader,117765,514,957,900,1414,957
2587,9a2794dccdbdec38837cda2749cc30412c597f6e0408477f3ba319a64412bc59,downloader,183349,778,1473,1426,2204,1473
2588,9a72220bddd19967c010a7b43bc804047986787969a6458fd8fb9c81f13e6348,downloader,29909,135,228,266,401,228
2589,9a722711a88c67cfd02cbaf41e9bea51975e8fdd76479a6e70f29151b30c3410,downloader,188372,793,1511,1463,2256,1511
2590,9b32fc3598ffbd9b5fa68fae266b0522c95f5c8f12411f6d212b7679ab3198b9,downloader,187158,787,1488,1433,2220,1488
2591,9ba0b139672e51f6e3728fb50cc7ec11d5076779646651c513e3b9b3ed9f0b4b,downloader,187912,794,1506,1425,2219,1506
2592,9be37298c900d55e6e86a3db8120b0188c35c8bc7440cd81217a5fa07b65e4f1,downloader,301200,1248,2325,2384,3632,2325
2593,9bfe4a34e5edac63bbe567aa72da9d59e2e616d5027f9c165405ea7a7a3a6b5a,downloader,188410,792,1505,1435,2227,1505
2594,9c527c419330afca013052b73036faf305729f9695eef50157b7e033307ee781,downloader,116659,508,944,906,1414,944
2595,9c61c99eedfe6f60138d88da9de56f278984c738e235fbeed817f32e6ddf7e0e,downloader,116788,510,942,892,1402,942
2596,9cc93f4d322f3083d2233c281971fc7227dc0f533fbf01d63090a909fc8ac75d,downloader,181326,756,1463,1388,2144,1463
2597,9cd8ec499654eaf95199df57e56e0596233eb597b8cd7543f2f1674b51330dbd,downloader,186396,786,1484,1417,2203,1484
2598,9d2c04dfb89b2b8fb7532b53711c78c6015a05ae5b2e2b7725fc0409df402877,downloader,188409,791,1485,1433,2224,1485
2599,9dfbe61c21ae2483f7e73ef064bbb83578c41fcf9cecf01fe1ef53fe18c1d00a,downloader,118230,504,944,918,1422,944
2600,9e506e926ab30681d1310a2deeaf6cda56bf4fd35d5c52909138ca56a5e5a38b,downloader,118716,512,956,910,1422,956
2601,9e9a03899b3d7bc577bd19512324fbb89dcccddd744534bd2490ac7d53eeda4d,downloader,188845,800,1502,1447,2247,1502
2602,9ea0a35da448072a87f46624c036ea57dc8051d6b1293f17c81e5453fe75e4c6,downloader,187659,790,1498,1431,2221,1498
2603,9f28b85d55ec105cd8977cb358c6a3b89cd8751760f0ad5cc4d4bd1adc9a3099,downloader,117902,496,954,922,1418,954
2604,9f6f7f57cff0d227b4cb23b6378929efab67dff66d4c2fc91cd8a15ab40f25a8,downloader,154027,655,1206,1158,1813,1206
2605,9f9e91a6ce80660ea7c40fd77cec15d22e1e2d7f2839e0984b3e5e1b5c7d94d3,downloader,299232,1238,2301,2381,3619,2301
2606,9fe0d97683c26dc719499b44d8b76254d012f74cbe111a25c9bc62446ac23116,downloader,762989,3084,5866,6143,9227,5866
2607,9fe469257c289bf43991bc140f9a553e5a7d09f602acb461621078f83bab6036,downloader,116699,506,944,914,1420,944
2608,a06d703024e068bea9645afca72c04c1ee46aa476272633f648ac9fcb35a1f2d,downloader,116644,489,943,901,1390,943
2609,a11c98ca180021bedffb4c2c75980d3e752cae97b638ddb50847e7c401668aae,downloader,118368,513,955,909,1422,955
2610,a1e40c77797b517022c87965619782b74a5facd14fc2017d4076f9306296cf90,downloader,117052,502,952,902,1404,952
2611,a1f37f876fd7b97d216071fb14a7f71b1b2b450768d804980a8f86234c7306c3,downloader,762944,3079,5881,6107,9186,5881
2612,a207408545d2315e899db9f2c029d9c86e59dd4aff3dee17db3760b8882b9cd6,downloader,186322,784,1487,1410,2194,1487
2613,a264cb5beb0d47f3b9d0db87ebfe23da88f5d0d5a3c5de81ccfdd544a6759d01,downloader,762696,3092,5869,6144,9236,5869
2614,a29a4107691698d8ea662b746b507e7d0641f57244ce02ff0239f30d23c631bd,downloader,118165,501,955,901,1402,955
2615,a29f94c3a529d91cacf866d40e383e8698769510f33950259c8ea381470e9865,downloader,115857,486,935,873,1359,935
2616,a2f861040b2342b742454f1a520a88817212612fe371600bd5ed211c31948170,downloader,30685,143,257,263,406,257
2617,a31129f1f9091e877d41ca39117f5ef21d1be6e7ff9b0060e3c29f2b29bc739f,downloader,180894,756,1468,1379,2135,1468
2618,a31daa94297321efa04a884d97655e6a245f7dbe4edc500a5f91485c88d6cb72,downloader,298564,1236,2297,2366,3602,2297
2619,a31e6258463fe1c3fd5aead1a3917b6d149026f1d414c3d3461c147b810f3d80,downloader,117997,514,950,918,1432,950
2620,a3cf25e9ceccd8384562fc401ddf351be13fd0792ff15c398a066528db9f32b1,downloader,187370,791,1478,1437,2228,1478
2621,a4491c623789496fbe5b572edfac3099433810a66e7825f61416c94e04bebc74,downloader,183116,766,1474,1411,2177,1474
2622,a4c8880610b4793520e2a227338af275ffdfb52dde4e1c476aacdada1ac571f8,downloader,118330,517,951,922,1439,951
2623,a4ed4b14bca457b57a6141b05d330702e7490a7245150babf10a97c16388ddff,downloader,187068,797,1486,1431,2228,1486
2624,a54aac4c1725338325f3f2748d04ffa40e7f18d760d73a095cac9fe2ff23e34c,downloader,117752,511,948,903,1414,948
2625,a55c66c73d4892849a5313debe25878b59aac3f45be66acb3dbe3468a0e2d8b2,downloader,188253,793,1499,1441,2234,1499
2626,a56b147e74a5e03867eafa8ede9f06caac923336c0db6318a79bdd402adb1bfd,downloader,30461,157,255,244,401,255
2627,a5789a944effa7cb60a375069475540bc2e3ea630917ff332022b63469857ef1,downloader,761979,3081,5873,6132,9213,5873
2628,a5980419f8b3b0766935713faba1b6dd96954701e6496682927a1e1faec304b0,downloader,764558,3085,5913,6135,9220,5913
2629,a5f12d737db6aa4cbb0c73e1d1fe0bc7e0d8bdaa372ab6a7aecc46c1c4e75a10,downloader,188392,785,1485,1443,2228,1485
2630,a624affefef439806fbe288b9767dd77ec3689c12b64d26391f65be962ca4b5b,downloader,30525,146,262,242,388,262
2631,a655fea8c9d69fc2b141531106b84fb9d75e291fbb8295385077a5b0900a7cce,downloader,182050,764,1456,1382,2146,1456
2632,a682b6a93f6726222cd73d50a09c04c3fd6368e2c6474bd015c0a36dbe8ffe0e,downloader,181577,771,1465,1396,2167,1465
2633,a7077059a0f424c8371cd3bde1a84eb144d5aff86781c105960d1285291a4b4c,downloader,187316,772,1499,1455,2227,1499
2634,a75e8f2415af38628ad43bb06181c4ebc1490268e2ae21b2453a3f8b6c5a05b1,downloader,186571,785,1487,1415,2200,1487
2635,a75fbb8775ac94ac02f149d31d39651cc1ab11138751ed41ffcfb4a540781913,downloader,161317,678,1263,1218,1896,1263
2636,a763af6a9f96d81f295238b5c6d295fd27352e9956e78ce2a61a8b629d62aa15,downloader,187853,793,1497,1440,2233,1497
2637,a77f4391ebcbb611ae9923ac11cc528149468ab0fb9f27f51684ad47cd67e7a3,downloader,188358,795,1505,1425,2220,1505
2638,a7a59082561ce159c8928f77c0b4893325c210986450c59d41c9b1d6b06da14e,downloader,116669,500,939,905,1405,939
2639,a7b394fa18116a90f0f683b2ad76a7a4071928e9a8a38ad5c6bb33e9053bc1d5,downloader,30529,140,264,247,387,264
2640,a8084447912f312e3d85fe4f164f6a240f398824c87f4183f50e4bfb0196c8fd,downloader,146815,656,1140,1205,1861,1140
2641,a821dd9592429203d82cadac7bc4688906508eaa05a0ddd29fbf507828bfe3ba,downloader,187380,788,1491,1447,2235,1491
2642,a82e527f0aa375e92a22962878ef753bcceab83c748be3f17f45c77afe9ba9a2,downloader,189051,787,1517,1454,2241,1517
2643,a86aa64edd3db7a9a472d3b0ba6a0f3c5ff9f2bcf15a72ea0871b71b1035648d,downloader,118646,513,951,918,1431,951
2644,a890c78488722b03b209f9f631e45fe084f89fb05d33ff44effeb9bd72843a2c,downloader,186747,787,1488,1415,2202,1488
2645,a892bd834ca8ec076cfcac8375755b88a8541594f93a24e5c8d92c1dcadeb2dc,downloader,186414,786,1483,1418,2204,1483
2646,a94d769a63446eb3b53b0e249cebaab917a5baec02b202f2f2ffd42dc5352a21,downloader,117536,508,951,914,1422,951
2647,a963720bb556de9d7619b4560eb5ae71747fb131213163e198a08e4c610b05ea,downloader,187874,787,1509,1451,2238,1509
2648,a9aeba48d4b8560eb222229f1ea15f7caf1de1cbaaf79372c56339816cecfa5e,downloader,118329,503,947,897,1400,947
2649,a9d79fc33395ebc6acc6b810828134db9ae74e8b730c187fb422de41b6680b53,downloader,147132,662,1147,1230,1892,1147
2650,aa05d14d9995be45862de0a828d75a3848332c25a37f80849d7fb50e28a88af8,downloader,117798,507,942,892,1399,942
2651,aa16a5718ca9bc7cf78e07d4b23ea8ce6f9d59fa169ccf75971ac875c1c69986,downloader,189004,780,1493,1457,2237,1493
2652,aa3da60ccd2a3d650384a3f5b61b145284e5c0c66d8250ba2e79a9ad99ca9936,downloader,298176,1231,2298,2361,3592,2298
2653,aa4c5ec6773b5a5c30a4ac736b4c9854c20799b10f453ca9c116530cd86f84e0,downloader,115764,505,935,899,1404,935
2654,aaa28b960c0909f2e5232becae592561c0a12c98c11758bbf2a28c94d5849719,downloader,186777,785,1490,1415,2200,1490
2655,aac1855aa7aacded116dbbd0de66786cb01910f1af92a9a101d1f6390983b67a,downloader,116901,504,934,900,1404,934
2656,aadd8de4257aeb3e41f55516ed0e611ac16475122e8496dbf061d7e117b28580,downloader,118349,505,964,903,1408,964
2657,ab3e69029b4ad944a62374a02ee55d4c6d632528a899d98e0a1d21163c6a536b,downloader,117844,508,947,904,1412,947
2658,abafd85f583cde50ed6658d09e0e7d1326c5069fa63faa5bada080bddaff9d09,downloader,183948,774,1472,1410,2184,1472
2659,abb23188c35ac7b57d618c95a5f288958ed10d0be6d6a3c6e6b11b6dc5dbfa10,downloader,30588,139,272,234,373,272
2660,abe3fd3bf6cceffc28c81527713500951293849fdb63d3b8b510f5a3377a400b,downloader,186974,800,1485,1425,2225,1485
2661,ad079bbd9be96f53b1f92f207b33681115c738527f54cc86717774da795bd345,downloader,181676,768,1442,1402,2170,1442
2662,ad579dfb835dbc39d757dc7989f4a6b7590b22a0c3ec2447d6b59da8588fb0cc,downloader,31046,150,243,255,405,243
2663,ad9840b91f2d6f3e1b191fb8d1948a360be52a68e204a6f1cb7841b11bf3b627,downloader,116956,506,945,904,1410,945
2664,adbdea2e5d18f466dcbe8889ad7e4d610bd28bfbef2e1f9ede9d10826a3caf90,downloader,181963,760,1448,1403,2163,1448
2665,adfba38b3450b4f4eaeda7e62b074dbfaa3ca73ff8d024cd2cac3d90b320f0c5,downloader,187135,775,1490,1451,2226,1490
2666,ae39af6c644da847dad0450e2705be83717b80b375e4a51bc6e2eb6c3561a836,downloader,115291,495,931,892,1387,931
2667,ae7751f10426877dd872feed312a25cd40c73143ec2e9a937c4a1024642615fe,downloader,187950,793,1499,1441,2234,1499
2668,aee3e8662cf606bc80078e45d067b5f861a6b727fae8476a96adda682921e365,downloader,118620,509,956,914,1423,956
2669,aef70bae5eafd5724f1bc3adb102a2a639863e2cecc2625dddfd9449cbe9d4e8,downloader,117086,504,941,909,1413,941
2670,aff7063c57d3b129619b669a2f4e046a516abf6866d58857e686fe3c86fdcb47,downloader,118027,509,952,895,1404,952
2671,b07af64014a724db5ca5c935b75d1f89af21b80b14b5842ed1887c94ef98f931,downloader,764182,3074,5912,6135,9209,5912
2672,b0bfda54f6d0b12d864034ead7b335493ff75140eb2756c9213ac50a3bfdbdbe,downloader,761879,3077,5893,6098,9175,5893
2673,b0c89ae487ac3a4f63a1d88e09a829ceeaa8f29f9e01eddbb57a514a51b9eb01,downloader,695616,2804,5387,5582,8386,5387
2674,b13458238815356244552945b7b0ca41abae4cb98b750510615d14e71c0e2291,downloader,184947,780,1475,1404,2184,1475
2675,b1ea7b7c4f6bda4fa3339c9c57f64edaa41388379ab9406fdb28ccc8cf32848c,downloader,184291,785,1483,1395,2180,1483
2676,b22bde4e88f33f7825acd9094446b139d008e579f20c31f83b71dc2bc05083ac,downloader,181918,767,1460,1391,2158,1460
2677,b24346c02d2c096604e2109fb265f7551c15f5fe04380346083367cfbef9e7f1,downloader,186671,786,1488,1414,2200,1488
2678,b248664875f81bc5d728597f0f94a7ea843236c176d7675968e1cac9872b34e1,downloader,11310,31,77,87,118,77
2679,b25cdf6397eb133cfec49c0462796d9198790c6fb3b829521ecf7191752e6167,downloader,118003,511,956,906,1417,956
2680,b25d7cb0588dd0e4889145ac8e146f5f52b4ce09b200ad32ffe683ffb8b6ab16,downloader,183434,760,1476,1418,2178,1476
2681,b264fdda4747892345ae30d62419d7672127e2530f48182bb6ec29642662919b,downloader,186917,791,1494,1447,2238,1494
2682,b3147d085e3c07ad847d523915c13e7916c034d4bbe2754b7379313f3c2e7bbf,downloader,118496,524,951,908,1432,951
2683,b34e59c8a72a1be8c23b81ab193fd503da9192dd227682d709156a04d4db5575,downloader,183698,774,1477,1405,2179,1477
2684,b3b4b81adce6ee93b95f43543f423a9595c013a8d04f64ba02f85670cdb02e2d,downloader,117662,512,960,904,1416,960
2685,b3c334ad897f20fba2314e83ca3d089d58d66462cd26fd1597b9d827d3974376,downloader,115712,496,943,893,1389,943
2686,b4422f86fbafab5368be72819c8ff706550540f5b2b8ec176fde73f731dc13a0,downloader,762375,3075,5873,6107,9182,5873
2687,b47038a1c631f78c8821771e1627fdf2c5268248cee3c732f0a8313382266aa0,downloader,181563,765,1469,1393,2158,1469
2688,b473b820802b7397c8ab40ccc06318d96c7856633318bca6e980f28b15bd7e79,downloader,117768,497,957,903,1400,957
2689,b47f66e6116adb29ce43bc154a9d04e1617f3309e7e5f561e2295de99cfab6ba,downloader,188423,787,1511,1432,2219,1511
2690,b50eb17c6503a65d736aa2403254d9eb1ecfbb1856c024a554ed5360b0d676d9,downloader,117026,502,933,920,1422,933
2691,b52662281ab0d884d8c9da330b7f2f4cb34cad8655ca27a82c597fc8d8a350f1,downloader,118155,503,947,913,1416,947
2692,b5a3c6d2b05377ec85fd33004b70b7e7bd196c81814897be24d793c34ccd23f4,downloader,30845,142,252,255,397,252
2693,b5c6eba50e80d549da1d42770b3bd384f737a26346c7f8e3fc193e509bfbd7e1,downloader,186873,785,1492,1416,2201,1492
2694,b601ae8ec1acfe7d3c5ddc6bd6679518af14c4ace6cc61bb121806620f493abb,downloader,181214,757,1444,1392,2149,1444
2695,b62ea259cb4d8826a54461d6f804a8824f887a96514945aba917169b20bf9a7f,downloader,762354,3082,5889,6121,9203,5889
2696,b695446cdf5ab4f438ab1840db8046d245779bfbf2ba07c3ab34f5d39d8ef8a4,downloader,11331,58,98,78,136,98
2697,b6d49613db7ad8b5784d21dca04ac3fe7c40f133ed1115a152d8119d371eacac,downloader,187981,784,1498,1439,2223,1498
2698,b6dec4cfdf183d8a583ab2e39a01efdc76a31a4e91ef805a9ef2cf5d873519ee,downloader,117176,507,952,911,1418,952
2699,b6edd43e57803657b6c06cb079b6be96f551374289bf320adcd26b8cbe5b414b,downloader,182770,768,1455,1397,2165,1455
2700,b7561638f78b959b877b0de542daa53d21a17d29a138386ecb31c4c0bb37305a,downloader,182436,761,1470,1397,2158,1470
2701,b7838f0a6cd5342d283f012b3e683af886bf3420e06acf143f9eb8cb5b4eab1e,downloader,762947,3096,5891,6129,9225,5891
2702,b78434989fa72039a0e39db32cb6f9f4abb8cec543bfd688dffad9fee5883e78,downloader,147427,668,1153,1212,1880,1153
2703,b7f80f9b3d9b45ec2e8104dd38a7aa6da84550d35e368eba43e2434d32bafe91,downloader,181420,766,1452,1387,2153,1452
2704,b9176fe7bfb577fb3a16842997e05487fc3be554b7e4001cd42f21e0ec1b02d5,downloader,117506,501,942,894,1395,942
2705,b9a797c8616bcf95619bd2165316cc8e78be20fe53e729bc8c49be2acee913f3,downloader,301991,1255,2323,2388,3643,2323
2706,b9dfe16d56e15375102fba045a1788028f4334f65385d394e0d2a6c3a63b3494,downloader,182144,771,1449,1406,2177,1449
2707,b9ebfab5de45d873f083ef656037ea32cda18fc289aa429b144094d22101298e,downloader,762569,3075,5896,6115,9190,5896
2708,b9f23fcf02914f600b6e6871356bdc977fb0b1dffa4d74e94c6cefe0c1641194,downloader,186650,775,1493,1430,2205,1493
2709,ba2af799fe88ff2a4367a87e2c99026de621e25f738338cbfacf4f186b3e6501,downloader,188550,798,1497,1448,2246,1497
2710,baa698a4c153648449721f367cf351105c3693b3391ee5702e163f049f657fbe,downloader,183359,767,1463,1404,2171,1463
2711,bad6a5e0f50752331db064e3e12a9df2653843426269040d0d6aba32191a5037,downloader,117595,516,941,905,1421,941
2712,bb04548b65b64c6620fcfa227ba2191f86f5d62af7a59b233c1f3df2928f523a,downloader,184615,781,1481,1389,2170,1481
2713,bba2dfd5f8db9812975f00fa6a9ba7fe25fb4efb1943817ba9ac83142e07f7e1,downloader,182829,768,1464,1395,2163,1464
2714,bc0ac0df0301bf9eed327df9be908c15ccf61908f042bcc1f405e33240191145,downloader,146800,668,1135,1216,1884,1135
2715,bc39de30ce148e9163a03d33fd5f522ce6784e52497091f28984270042337326,downloader,182071,764,1458,1399,2163,1458
2716,bc5319886a9bb1a7bc310fe3839d9e14402e3a8ccd0d506adab5dc13ed5ff5d9,downloader,186759,786,1488,1415,2201,1488
2717,bcd3fd12c9ff229accb09159b0812d7a9e38e0125f23b6ab8e47b8794d65aedc,downloader,146987,659,1133,1221,1880,1133
2718,bd0111309cf01db3e457cf448b043afa43d3ead8fe3d4a4e76ecb5b70f690910,downloader,181470,750,1454,1401,2151,1454
2719,bd23416de7e5e2a9401ee9f80f21a4f0288d3eb42b1703c50ef85066d0e519b4,downloader,118928,515,952,921,1436,952
2720,bd4c263362c632a212e6265ad8ced845c9b93b6ecb127e594d462455be4485c1,downloader,183468,773,1468,1398,2171,1468
2721,bd5d3b6e5ecc005664d3a4c177ebfea2c63647afb67e1a2ca7d4623e25ca4165,downloader,188348,795,1505,1425,2220,1505
2722,bd8884ce6967eb2f6156f5303b045dc14a2c8fa40fa611b05d193cae36353c55,downloader,181813,769,1456,1386,2155,1456
2723,bdbed30a0fe1e591ed4a897d6cdc6e1a78a5f1a069f83f7e24421d72a4a2d150,downloader,116627,505,945,921,1426,945
2724,be270720f2b6af82c498101f9952e825cc324b6de44c01c894c19e7e26b47d33,downloader,182376,763,1457,1393,2156,1457
2725,be30a77f0293840ce36493a23f337cde175226ba4c36d5a21612f083f7f0d6b3,downloader,181337,757,1458,1392,2149,1458
2726,beb7872b4b8561cbce610a17997f85e5ed6047c674e03cda681ca7970e6fca3a,downloader,163237,702,1258,1231,1933,1258
2727,bf3891e3bea2ab5ce56ba46ed34ff9b1b9f8090be22e64cabd2259cd21121504,downloader,115416,491,939,883,1374,939
2728,bf6d5f6831ded02bcab33f7f5edf9a03208d0bc9bf91840a29d88af23952e826,downloader,189500,781,1515,1478,2259,1515
2729,bf7d685391f3218967bfad85a207fdebb47bbbd902a83b6e9a584265a5def936,downloader,188438,796,1493,1451,2247,1493
2730,bfe1f08a027146cbe18081c3e12529779fa2fdee0f292c100f6e951d1b642f60,downloader,184851,781,1493,1415,2196,1493
2731,c02d7bac2a81fffe21999d119354fef57f37ed2d1413aa20388ddc69f9d751b0,downloader,161393,677,1253,1221,1898,1253
2732,c11949dca4cbb3d55997d11668afe418422f738068fc03bb4371858bd91c025a,downloader,181570,764,1449,1388,2152,1449
2733,c1403cf1789b5b161b1c48c7641542e83922e1d62a7b6d4c7193099bc472122f,downloader,116076,502,925,889,1391,925
2734,c16568133db2078d02e3725c4ee24a01735b7ade914897c7d28d3114636a9179,downloader,186385,787,1483,1417,2204,1483
2735,c1741bc2c2f273463949118c348d8cd5808e4c8d5f4136e7cec36cbefa19e2cd,downloader,30480,136,258,239,375,258
2736,c1b003ff649145025ab81967c9f0a17912b098417897b1d6356ca24e9417e9ac,downloader,182709,778,1459,1402,2180,1459
2737,c1cc79eddb72b72a4909599bdf917ce92fac91a59802dd6151213ec6cd49fbcf,downloader,761969,3073,5876,6109,9182,5876
2738,c20a7e1f03a896dcffe68cac467e05561e758b3f62535ca19ad9ab71f26b43ab,downloader,182739,769,1468,1395,2164,1468
2739,c2730bb806b7ad31ef7a50b6d4c0bb84cf29319408548426d7b8729582aaf3fd,downloader,116434,506,933,902,1408,933
2740,c31037de4c4d5b123f3a6a01e7fa342a7079367f98dfde9d0ebc0dc323468de4,downloader,182209,759,1450,1407,2166,1450
2741,c3c9e5821b24b55e61cd15072b17249e523fbb92a25523a2c9964c05492e1c09,downloader,116477,504,934,895,1399,934
2742,c3e14e03d335b88e14ea8a2eb65e654f93f2a7d975a00762c05502edc5a3f2f9,downloader,115959,494,938,894,1388,938
2743,c4869258055589a2aa8cca6ac249cd73acbb0ecff71343f7080ba4de154d3f86,downloader,116502,504,949,914,1418,949
2744,c496a8ea3d6293b4ba5a93e3b95cedaf0da2741964e167f477ff6c646c6a573a,downloader,853381,3381,6661,6748,10129,6661
2745,c4bae68b1e8a52e2b7c5c9fb171a58dcadd7105ef8df2339017f3ffd908f4ec5,downloader,117819,511,941,910,1421,941
2746,c4f3520f5deb508d7da0b6ef9f5d5fed819c2304da01156acae0dca8e76af01b,downloader,117128,492,936,913,1405,936
2747,c4fa360a0c0aa4a28d205f87b5ad2469e2f90f7f69ec43160227b663191eb396,downloader,187194,787,1488,1429,2216,1488
2748,c50b1161f27f7b45229d61f071f749c2213933df8b44d39f7994ebf8e453b3fa,downloader,187735,789,1486,1436,2225,1486
2749,c50cf5bc96ac43553dbdaeddc43b335967d5edc2a7a7cf8647e15e0915908b4b,downloader,186960,787,1491,1418,2205,1491
2750,c5518712cb7f6549375ebfb46959cf28391935aa592ad887c1d797da5f0ff646,downloader,116477,500,934,916,1416,934
2751,c60314811cfb1a7baced7afdd3994309c35adadb3cad8df88961822517ca88e6,downloader,762194,3069,5884,6102,9171,5884
2752,c624c94305480aacd187a813c844fc93d2bf3d895d5c78101836bd02610e6394,downloader,183001,764,1477,1410,2174,1477
2753,c62e43f47e6fd64e55a78c75b1620fa4f6988fe750070e8ce2bd0494e2edd1cc,downloader,147377,664,1145,1215,1879,1145
2754,c641d04a6966785d77d1923f4a469db4865b8a003e1cc235cef79c4ecc7ad9b6,downloader,117732,505,946,897,1402,946
2755,c684ec24b151941019b7ebd6df3fc2a9fb2ec05bae8bf4356a64061e4214d2c8,downloader,117783,509,955,908,1417,955
2756,c6a91ebf298e9980d059df3baf7881448b9053cda7e64e6cd142cab558299eb0,downloader,117372,505,940,897,1402,940
2757,c75f960aab91d35fceed986876eb9a5fc74ee0a948bddbc354ff6de71c986d39,downloader,116563,500,948,913,1413,948
2758,c776215680759ce78f2ad64760209018354d8826cf97e83083f38bf1ca09e147,downloader,187941,793,1505,1423,2216,1505
2759,c7a3a09723989c50496ca774f23ab53367217920f9655fcbab6219dacd33f999,downloader,186683,787,1488,1415,2202,1488
2760,c7d66357e534826bc0fa00c0e850727dc226dfa0449f018a0456f01a47ed1c6b,downloader,116259,505,943,911,1416,943
2761,c8315098c2aa59b9669ed6bd13786f0abc3874a8d88757a1d3478d3c58fd0097,downloader,853276,3275,6732,6591,9866,6732
2762,c84a748f1976366d00b21b0eda9837a6e60a333034fccb20f2b582df417db48c,downloader,188706,797,1503,1460,2257,1503
2763,c8566839a17c4cd7f97e8d7727c80a74c1544caa87d072f6bffc58b260839b8d,downloader,11431,38,73,88,126,73
2764,c8670bbde18a430506ce775e00c8d81d10c9de300416a80e74bfa2bf92dfa428,downloader,147320,660,1147,1218,1878,1147
2765,c87ec71b650d36f727c5ab1aa4dd2556804a9ff00da64ddfbf0d2ce95d5473ba,downloader,761807,3079,5884,6093,9172,5884
2766,c893faab4536dcdefc4f1a77dc7c122ef324da87b9716a93d362b3d4668cda9c,downloader,118307,524,951,910,1434,951
2767,c8ae8e5b660474849b49c6d48a69ad0098652552c568d8e55c99fe8c683495a1,downloader,186425,786,1484,1417,2203,1484
2768,c8b6f925543914e0a54248f8bc5b2e9618ec325c685a52dffe3ec474e987dff7,downloader,117394,507,948,907,1414,948
2769,c8bdc59c4e285f98d1baa815693711cfc04af6546d3735b88edc5dbde55ae580,downloader,30489,147,221,254,401,221
2770,c96d7095b7a863d3f2431fd3d1c7b085ecab7cbc8932dc73696fd7ff552789ec,downloader,298358,1234,2296,2363,3597,2296
2771,c9c75237a8935ea176066d83da741001579de6cd2d2fabc5dc8838c385500a8c,downloader,115117,484,936,888,1372,936
2772,c9fe87badba73af44ed32e0b76dab95e76f1838abd85497f6db93b70ffd7b2f2,downloader,187374,769,1493,1452,2221,1493
2773,ca13fddfaa99f0686d715c6ec8791248eb3d52c6747668ad0554bacdb28bf32e,downloader,117792,510,958,911,1421,958
2774,ca26ef9692d5b75907ea2ed518779949304e4a01be58b48ecd969fc005572b78,downloader,508599,2106,3973,4071,6177,3973
2775,ca326b9df32ef8789382b40fc33b9a9343a7ee9111e7cb3a67ec6db6ea7d2f33,downloader,186020,779,1490,1422,2201,1490
2776,ca3e22dbeee0a75f755759ba2f539b99e0b7e75774144a1f08077e6891b45a96,downloader,117899,497,949,907,1404,949
2777,ca40a2e459dba5de7cd247ea8ef1fff6cd55fc944389650bad5261c2fab0ff2e,downloader,186533,774,1492,1428,2202,1492
2778,ca6a100d8d99dcbd91d2a6f88362f61dac7d4b7f1d5936ae1d7370acefc2dc43,downloader,147311,670,1146,1218,1888,1146
2779,cab61b1d93cbf179590920fce1107603536e087a71a92f703477e139b8806a5e,downloader,181851,756,1445,1373,2129,1445
2780,cad0d58d556592bd39ce5535d1a05b6e98e38851666dfd925d4bf459eac44579,downloader,187793,777,1502,1457,2234,1502
2781,cb0de98e7a7910f596bbd4bddbaa0d15ce8de0dab55788cef6445af934db7a8d,downloader,186802,785,1491,1418,2203,1491
2782,cb426d96ca79751c55a8e122076b0cd5ffaccc861e2c21d743cf37d7bb3db0b8,downloader,763050,3077,5892,6111,9188,5892
2783,cb8e83add0dd91204c54a7a98a9edd3a23cbb3f13fb4c3fd4559a87f23df5634,downloader,186844,785,1488,1417,2202,1488
2784,cbe14c35511ceedee2d10f9896548b590e991b6a346bea9561475337fafbc420,downloader,116995,510,946,920,1430,946
2785,cc5063f1a837774f3cfb897347aa7a918b38ee4228ca37d8aacd37a598b15717,downloader,183229,760,1458,1405,2165,1458
2786,cc98c0b626f0b1c7abbb4db0cb84f4592c8c92475588c62298649e48f861a765,downloader,182030,764,1452,1387,2151,1452
2787,cc98c65b0904bfdc2940205db286a52ed612e5c0991f07ee5cd66a9f019e3d6b,downloader,117951,505,961,922,1427,961
2788,cce0272399eeb2dfff3f3d659c31b7500286c6c35088e68d4155c69b1df43a61,downloader,763469,3076,5888,6115,9191,5888
2789,cd296fdc257a7a2ec4efef2d7356c7369a9701c832eb6e1ecdb0dcae68ceb505,downloader,181218,764,1439,1384,2148,1439
2790,cd537c903a46e1716a2b05e8766f8cf8124341f9bf6f43305e51342d2dab083c,downloader,187071,783,1492,1438,2221,1492
2791,cdb7dc17630e2654733ad4b0c58dce84a155932c020deee9f9ea0ee8a6f53b09,downloader,117288,504,942,903,1407,942
2792,cdd049f3e7b03dae7502a961c270cdc7fb6402bdb51f374db6f4549a54f38ff0,downloader,30207,169,260,223,392,260
2793,cdee8086a4b272a9cdd2e382d6425edd36827a73b709918f34e844689ba95877,downloader,181206,767,1464,1388,2155,1464
2794,cdfe14f9804fa26273d95d262d75c716f63bdec75661c3b43185c3a97b96a65b,downloader,30604,142,263,242,384,263
2795,ce280b709c841a5e863ed2a4de80b8bfe55e76f5fe8a68c2f87dffe2d37879de,downloader,182774,766,1470,1397,2163,1470
2796,ce90acde6de4f149b75500ecf63ddf91dc723e020ad558944a33494a9eb2a624,downloader,188224,794,1502,1445,2239,1502
2797,ceb9f94a518db6c6d8582fdb4cf1b43ffa779f5a5e45c47464643603fd72820b,downloader,181750,761,1442,1393,2154,1442
2798,ceeb9f77078ed71343b95d58351a2e10850e5ee94d1b229b37cf50bcda884b6f,downloader,186640,782,1486,1450,2232,1486
2799,cf4cc407b719aad3d375b7fd5ef34c03fffd36b14fb3521661a57253855bcc05,downloader,30586,144,239,231,375,239
2800,cf984546c831343eb1bd29ae0d67c4073c0a5c08a0ceed03a177098a460b81ff,downloader,761779,3074,5885,6116,9190,5885
2801,cfa7f7ce9b0daad32ccdd4abc909a0ef5eacf89ce658149774ad388424ec58e4,downloader,761980,3079,5896,6119,9198,5896
2802,cfb8656f5e9594e31a8405748eea9cbf63314845a92222262a506502d2c329eb,downloader,301189,1245,2314,2382,3627,2314
2803,d006ae276a346391b8b902c89d6679df631bcb35eb198f1ff117fbc7cb5ad748,downloader,117967,505,948,895,1400,948
2804,d02a71113dd6eede51625f34df6c38560092086128078ca87b3af33faf517b23,downloader,187473,797,1512,1432,2229,1512
2805,d02b5a02782c26aa2cc3c654be9fb90ecdac258dddf4c6dfaa5d24aba2079ec0,downloader,30672,150,270,236,386,270
2806,d071feca82fb4d59bb8f0515aa946d7e8cd31f90e0e8ddd06fa6d62071e52d39,downloader,118625,515,948,909,1424,948
2807,d078ca9fb08688d4ab78ed0d581de5e311dbb98b70ec46408df236fa1d0c5647,downloader,761629,3062,5884,6107,9169,5884
2808,d0f9d0725563a23f5c9763fb4c2564b080120a625f6dfc12f8c43b02a793925c,downloader,117538,497,946,893,1390,946
2809,d11465b28f60923fcffdd6a51d1eef4bdb2da5be97c62202ea94d33bb88c97a5,downloader,853276,3254,6727,6584,9838,6727
2810,d11abf1312797a20d5f4cbe2778f5fe46367266d3f5a3e2606170756474f5b89,downloader,118332,504,953,923,1427,953
2811,d134aea09d67d15d16eba4cfeb93b08f9a465e15f24b3e03edbda0884e847cb0,downloader,29968,126,258,201,327,258
2812,d23312c4d8be32c645c34262d9baadf755c83c938b3c6ca9de778fd392cae31c,downloader,853277,3283,6697,6575,9858,6697
2813,d2f5132499cfe1fa6e580a319cf60b55f25db0ffc5f441f05f8dad3e2e5281ad,downloader,117841,506,947,901,1407,947
2814,d3271d4bf86cbaa7b0d0fc54e9389fadd2a0639ff85d6f2cea1aa6f8ab243b52,downloader,181713,754,1461,1394,2148,1461
2815,d3cabb07f360c6b73ce64e95b693cfdd8b093baa21e954cdc9e364fcac740b7a,downloader,181994,769,1459,1384,2153,1459
2816,d406070c9d34a0cf76c20b2b7430fe677e850fd68dcfa95292671d0d0d1b28d7,downloader,186859,783,1489,1452,2235,1489
2817,d40f112efb7446843745620f70b1ab76c2a12f6d5cabf766d0124c028aaad6c1,downloader,189534,802,1493,1464,2266,1493
2818,d4b212c3070431a1cb99d95e111fe8193e49bb1a5ed0210ccddbd6ca3868e525,downloader,116782,502,943,917,1419,943
2819,d511628399e41b0ca4ceed02afa922ac24f7f35727763e656b3216bd70bd0222,downloader,118473,507,942,912,1419,942
2820,d515950e1a97c480c8bc564cfa4bfdd58485eefc25d7c7181c8385872293dea9,downloader,189049,799,1507,1452,2251,1507
2821,d521ac66ec1fd7a5e611b608948635929de6b30d09a6aba60aab0f30e85536b6,downloader,117603,511,956,908,1419,956
2822,d5235a4b76412fbaf37de7b837f1fcc7862ced3735d13cd2cd069af99b2834db,downloader,188681,793,1496,1439,2232,1496
2823,d52a0ed6a2df518114d960974f1c92060a53497e3417ed9e1db65cdd185a65a6,downloader,762513,3072,5906,6125,9197,5906
2824,d56da6829790611f3190632db22635ab8d39a735d1bbd8a39278678dc3c8daa1,downloader,187513,790,1483,1419,2209,1483
2825,d57bdda3d30bbd03cfc1cbccd2f7591897a6ba2d33ce52712367a813ef7480d5,downloader,186877,787,1488,1422,2209,1488
2826,d5bb161333a0755c5eb3d66d5484292e7882dde92c9ee0b5a9955f9fd3f660c8,downloader,182002,765,1459,1382,2147,1459
2827,d60472a7ed85c06ac7164f2c651d724467151a8f856cefc714caad9d5c92abb4,downloader,117330,505,938,912,1417,938
2828,d64f8417336f6d8fb63194f258cf80223ebed5dc3bb2c4a29b380d2810cba35f,downloader,118847,504,945,917,1421,945
2829,d69b4833f6af99aba3281b84cab8dcfbdf65f13c5c9728dcd30698a3515ec730,downloader,186974,775,1491,1415,2190,1491
2830,d7b0058f80c419c3a5cfa32faa0a3cb1f55873cf5c334fdceecaa606d2f1ae37,downloader,117702,504,947,908,1412,947
2831,d7d4550a4bad366f5ba988e8921f6b987e3dfbf95b904ea3f6f78563e8c59836,downloader,187834,787,1488,1431,2218,1488
2832,d8176f9ef06d59bb0130ec9d9e1416a621e3cba2b5aeceef81b971f7ecd88cc6,downloader,761809,3073,5860,6103,9176,5860
2833,d87842033c607986bf89706d74241fd90de66b40a57e9f023802d58bd6181685,downloader,117606,508,943,908,1416,943
2834,d88eeb6ebddca8975674fb84e801cf0cbef021f969a57dc0e92fbef93590c0c6,downloader,117151,495,947,913,1408,947
2835,d8d9bdb80d66f941ba41d46025c0faa88308dbecd90f06b7c676142d21ded019,downloader,181561,758,1440,1379,2137,1440
2836,d8dbb6868066055aa3af5e9c9ef3a34fcebe92dfb19773ade2a142a665c8c724,downloader,187407,790,1490,1448,2238,1490
2837,d94a72e7b3b902dc856a5c98569f754f7a229acb5c9b38fe6abac4c38233b314,downloader,163129,696,1265,1212,1908,1265
2838,d9b6c059e02ed6bd89e876a820f6fcf62444c93be0817e4ac894b4a9c9aac08e,downloader,117757,507,956,909,1416,956
2839,d9bdcfb8357e5711a82fc0a125ab75d42a71305ac36445292c28e9f7c8dedec0,downloader,761515,3064,5868,6099,9163,5868
2840,da3b485d1af388d5cc93ec852151c984841e3edfb9f3f93ec261d6a2dfce1de9,downloader,117624,505,949,917,1422,949
2841,dabc61e9ff8dc525972f2ad3427a5a9e72501dd864d5bad7316a3d8020125103,downloader,30949,149,246,264,413,246
2842,dac3ccd16ccf00a10a9f84cc7ced0548b92e9a8a8bb703c4e22e06ab1875bc47,downloader,11000,42,86,94,136,86
2843,dad191e71e224cddb56b1d3db1e40c8e9b66239b7356b7ca84e79d1ac038e173,downloader,187065,786,1493,1412,2198,1493
2844,db08a1ba324c99ddfa5df178100edd55df69a9990d6ce8fb6857c5d860430aae,downloader,763471,3081,5873,6123,9204,5873
2845,db2cdef129375d6498dba4ebd304fe0e8d6a02543492596e58d73c5ef7ef4dea,downloader,763991,3093,5895,6136,9229,5895
2846,db390067e08e388975c7bb84a0af8414004b5fc86bdac818e012f64c0e5034e6,downloader,117504,503,950,907,1410,950
2847,db6057777787f5af235d79d572b70c22e08d963f934fd1ee1264848036dc88a3,downloader,182383,762,1465,1398,2160,1465
2848,dbaf2d5be46078c0fc713f0048beb59919b777f71eac3fef5e394977d29c3b4d,downloader,182409,767,1458,1387,2154,1458
2849,dbb55d5cb26cb60036f7fade42e9b66f42efbee41441e80b9a26101d162de14c,downloader,761699,3073,5882,6095,9168,5882
2850,dc44c1d65c37bbdf7c5623dfeaf9d9af1c424e2367d8151a0e5b43652e44a1e6,downloader,187276,786,1491,1438,2224,1491
2851,dcb466c3fcc3c93a1cd06f093687a1ab68955b08e4d722fa09f21de2123f6879,downloader,147763,674,1151,1228,1902,1151
2852,dccc20c31ff8d1f17c4e4dd8ff1b301584aeebbbe567ece1deded0d5cd25e0cd,downloader,117761,499,952,909,1408,952
2853,dcdd186e8308dc5235c65ce5130ad57518440ab3fa77e3d9fc38ec1d31607fb3,downloader,10710,54,82,93,147,82
2854,dd07aeb1302ced6726ce995a646a9aa4fee607e05f8fee261434179e24fd604c,downloader,117092,504,936,910,1414,936
2855,dd2c9c9da1959ed7cbdd16cc2f2db927eb683df2d2b00e7dcf2db2e22c46fee6,downloader,186399,798,1476,1420,2218,1476
2856,dd612f5942c00615da4669087aef6b86bd46d62c97b01116696ef553c698f799,downloader,189555,813,1496,1440,2253,1496
2857,dd76de7a7ceca2d43be6f59cd175213f86827d4eab2c5837c690a600e78042af,downloader,186972,786,1488,1416,2202,1488
2858,ddad0604ad7e92668c266e8c649a8c95049d31e797b96151b0ff56b7132eb2db,downloader,853276,3275,6732,6591,9866,6732
2859,ddb5b733f9717e7a9bbc69d44074d63ab2ad8d6eedcd31cf02be339c7e808510,downloader,117169,504,945,923,1427,945
2860,ddefdd39ad8e96a8a9c52be43c95bc927110a5a9411fc19dafcfe8ecc50c0212,downloader,118235,492,949,905,1397,949
2861,de2d39cdb835e3ac8f062e124d887883a19c27df063aa9e1064162bada72262b,downloader,182254,761,1452,1393,2154,1452
2862,de5aa623133b4016d05e11e29225a7492618eb8968f1d188dcbaa50794e6fc14,downloader,186887,785,1481,1436,2221,1481
2863,dee7f2601988c1202425a2b166a2e2256f32a68006078408e66321d400c16675,downloader,182058,758,1455,1404,2162,1455
2864,df0a62f8f9109928765039d33338d2295bc2ac0093f5e03c529ce22d444c0bf5,downloader,187276,776,1492,1453,2229,1492
2865,df1ccbfff327c515618616f995ba168b230ee34910dbe00cf4a01390e8872a37,downloader,763561,3091,5901,6133,9224,5901
2866,df2ac7300e62afb0f4ba76089f47fa3d6e7092a29bae0e12732fcd06af964660,downloader,30618,154,243,253,407,243
2867,df958361c4013c5eba33f0d09db541581103717bb624be52a25d4dc2b26bc341,downloader,764074,3081,5886,6114,9195,5886
2868,dfa8021145f1cb9b4a3290e8eb5dae2548cb63bfe636188a2261ec8cf5be124d,downloader,30767,112,206,250,362,206
2869,e009a217f5c1393a14c81fed7d94c973e22e1ed38a7a563db825edc99413ced7,downloader,762224,3072,5876,6126,9198,5876
2870,e04c8abb735137dcb99e9bfbc4f6f125d3ba0faa9fda0d4cd0fc404771027d0d,downloader,118034,506,956,900,1406,956
2871,e2224f041435987b7b9b4a4e0bb29cd0300eb488245ece4821a17ac0161c37c5,downloader,187693,789,1508,1446,2235,1508
2872,e24c62619c6aadbdaa8ff011078806d185252b5d663a42d5500766613c6bbb5d,downloader,183050,770,1476,1400,2170,1476
2873,e24e4fc52506a7d631f83ea427fdb664b26d20c615f6aa7a7b64ac67f8d01cb0,downloader,181618,765,1466,1392,2157,1466
2874,e265237ddba39d9675b64b0cbe6bfef1b065585bff7ca6813e908d33d9eb1fd2,downloader,187960,787,1509,1452,2239,1509
2875,e29c91b62c1f6b07426d2bf491130a92181624174907f1c9dad72125a1f249b8,downloader,186772,786,1490,1416,2202,1490
2876,e2a190d7cd2c0f3d37c5c897d4e6b68718b3cb1bf2621fe3d93a0b41486497d9,downloader,29952,161,252,236,397,252
2877,e2b30b0e7828817ac3b5c567e07657e9418e391f19a6e670359ee57bc5caa442,downloader,187310,778,1495,1456,2234,1495
2878,e2c31ea4c6e593cffabe236477bdc9e13ce58b3b7186269d4d96a50149ae4755,downloader,763035,3087,5902,6118,9205,5902
2879,e2d3fc43b610ba626facf1ad912ccb7e2a03eba6181341d016f4807f64e40b64,downloader,182622,775,1472,1392,2167,1472
2880,e30da17bd2d4d8716f5e55746aa9e886ac47c5e4f077a73bb213f82f5292d32a,downloader,181846,754,1476,1383,2137,1476
2881,e327dcd6388428f94ca0d07b986455c0c27eba64e2bd7eb28ec6f9c537fffc63,downloader,30468,162,256,244,406,256
2882,e3748018bd925287b3267d0e3e886f58d3068c93ca48f0cfda1c06e6830f2b19,downloader,186519,798,1476,1420,2218,1476
2883,e398216c7cabf348ccae89f9e2b72f2e1bc26186d4d1f8be014939a040630ea2,downloader,116531,503,940,904,1407,940
2884,e4400f8ed6d8c03fea055674da9f6993c485734a68f45365f5f4db4d4258fd7c,downloader,182627,774,1465,1396,2170,1465
2885,e47fffcab610b142c9a5eeb5b59b4f843acb75c20f42651a8d36c0ee62c06b8e,downloader,116563,499,957,915,1414,957
2886,e4e51760f07be3882d652e6e570571f01ee199bd1df2d73137d98d1a579b6248,downloader,181307,761,1433,1397,2158,1433
2887,e4f3efe003c8a9fe6217596b526a5f073049a6b258099192508c0539dd1f9353,downloader,118072,513,938,911,1424,938
2888,e5b377eb9e00be647c4ebd3bad4673d70b3e6240f33757961eb2944615187cbc,downloader,186935,785,1491,1418,2203,1491
2889,e6126e021112eacd383a3c24770f5a6fe877ba5fb555fefcdb324c9ec77ffbc6,downloader,30579,134,263,241,375,263
2890,e65b164a4add2d3b6c355811c54a863d4d927592a9a9b3e8420341b89aabb069,downloader,762030,3084,5894,6113,9197,5894
2891,e6c2de35d58fda605494553b074b0c9eb38bf9ffd4a2cefe2e2ac39da4b80c69,downloader,186805,771,1492,1453,2224,1492
2892,e6c9f68fbdcc96c94cb5aeb2f90ef71e1894a68fa372cfb79ca95417aac00bc2,downloader,182573,765,1460,1400,2165,1460
2893,e7050df5c327ec91fc3ff29bccf2a66ca58b83b5ef0e6740b916d05c142e5627,downloader,118151,506,957,918,1424,957
2894,e740be7ed6ae1c813c212b01d9e75e59996ea4bc192f277e0f210dd5419e976f,downloader,118077,497,939,904,1401,939
2895,e77d1a0430eae53123c67f8ca63edd6f3d4c160088fcf69bc4b380f8627a83b2,downloader,162662,700,1256,1231,1931,1256
2896,e79e5b9265c0fae403d779d3c13af41e9264866983178c70fab553711a8a40cb,downloader,146733,666,1135,1208,1874,1135
2897,e849cc7f786da54ee96247228912d73649b24122c491297aaf516207ba7015cf,downloader,182416,759,1477,1385,2144,1477
2898,e8802e460b66eb856c773a1c4793c553ad6053080c7f7dce63b6e7907e708fc5,downloader,187912,793,1505,1423,2216,1505
2899,e8845a77860b5c7c9ff3bc3f1e25321c79f057927dd87476054f427d8207f7e8,downloader,134572,581,1061,1011,1592,1061
2900,e91e2d2cd54de43f714e93b2d2460dbf729d3bf134c8d7610d545a0c3b698e2d,downloader,182195,754,1464,1394,2148,1464
2901,e9607f2f6912fb7727012c7aa7464fb5c26920ecc5102d3a3c1c7226fac0419c,downloader,187275,788,1494,1445,2233,1494
2902,e9d2a8fb7e0e686e4c3a78abcc82310dce33228a28c6a40e255a592689f4e43a,downloader,183624,779,1462,1388,2167,1462
2903,e9de7280246591fd0efb8ac014fb87d62e7a5518c2e31ac3f894d082f946e34d,downloader,182517,765,1471,1404,2169,1471
2904,ea369965534eab3d737ab4f7ce899331e564275855282d7d1c1ff62d2e56c1f1,downloader,187951,794,1506,1423,2217,1506
2905,ea8df8ad736518761c35c5d5280ef7b2250eb50accb4cea37d422851765fc6ac,downloader,181193,757,1452,1395,2152,1452
2906,eb61c368771c5b055451492882df543e2daf95ea3ba75287a3124ebde04c56a5,downloader,187154,799,1490,1437,2236,1490
2907,ebde3087eeb99f27710ad2831ee48e98f93f3fd9c115ff22a8fc5cd4f64f3148,downloader,301813,1246,2312,2392,3638,2312
2908,ec522ad575bf9672e61c3c45340090940fffbd2a0a075d282bc142a16d08f97a,downloader,189111,787,1517,1454,2241,1517
2909,ec8e0fcd6c975cd9dffcc3463986edb8babc8edf7e605b63a8149c456c006c93,downloader,184194,769,1472,1400,2169,1472
2910,ecd9657b194e90c06dcc6f72f0ff1258083ec79855262ce87cd65ba77d330da5,downloader,118816,510,955,923,1433,955
2911,ecead7647dbc31722ac430b03c05049b02e157afe024aa5f07b9d1be94fb24d3,downloader,762454,3075,5882,6102,9177,5882
2912,ed05619e6e5ba32474c270c3673c64763605584b64c5910eae75b582c271ffe5,downloader,188886,786,1516,1454,2240,1516
2913,ed4e13d5506f7632b1d8e328e08232d9e4fb8e1260d34bcd04e2092c6c9b315c,downloader,116912,502,947,911,1413,947
2914,edbd8510d6c82de05bc731af9cfb9c3955f23ca0b752b1031d1e0f8f2959ca7d,downloader,118429,495,971,905,1400,971
2915,ee16fac89391488c238a46feffbd669d9ffc8c5fda0cd97d56a60c219d6d8d97,downloader,117841,505,950,925,1430,950
2916,ee2a98c79e0d66d49b2891601dddb497a9f43503c408df8e90c4106953fdb8a5,downloader,182590,767,1471,1394,2161,1471
2917,eef364fc9a215e0d028b6379bd8faefd996a8778fde2fa7f1ffef2f53ae591b3,downloader,162214,693,1266,1215,1908,1266
2918,ef90ab4b5dc76361a8bb688a0ec7c4445cb21fa93990f309199fedbd0c9680e8,downloader,301188,1248,2316,2379,3627,2316
2919,f069e7fb736daeff20a77df5498f19e8680992be434de1c7133608975773f4b5,downloader,115143,488,933,887,1375,933
2920,f0b9aabd5a340f53f7a5f0ebef3bb4f6a22b54c2e69acfd049ff9fa151f8d4a8,downloader,180535,758,1439,1380,2138,1439
2921,f0e149d33dddddef821172f99aff72589505f59b25acbab003446c68602c8a18,downloader,116711,504,937,897,1401,937
2922,f1551352208fafbaaeecda65cfc13b6dc9f3e2e7a3fcece9ae56f3678d161ff6,downloader,115747,506,939,897,1403,939
2923,f164bd0a098f7d1113184d47871e2512e67a775b5c698ad8be1706739548a6bd,downloader,9902,47,64,91,138,64
2924,f1d5de86e0116688701c90472a5611928709b9b4d2cb34128be948d1a9e3f321,downloader,115830,495,933,896,1391,933
2925,f1d6d10e5ac2565eeb00f3c6d79d844eda31f91c8e70c99496fdd7e25217b906,downloader,182235,754,1464,1399,2153,1464
2926,f1f48050acc7bf7d0ca9af3116f5c8acc9716cebc91bfc51b340bbae6daa3d8a,downloader,186854,790,1487,1420,2210,1487
2927,f205d3e983be1da57de640b664fd4bdf8153abc76a5557a49fadbf503683c487,downloader,181916,758,1452,1393,2151,1452
2928,f229234c5e5d5b212d84aeed9602bca47d3c97b9635c95ff3d82b1455dae5c78,downloader,182359,768,1445,1378,2146,1445
2929,f361878b23b29df684a313410c5e3b3cba3c533ce28b3392c9da13ad47c47668,downloader,117925,502,944,896,1398,944
2930,f39de5cae7aaa40c0b78aa22bd1986f28ff4d01475f6028e0bf4b90599876820,downloader,184425,778,1476,1393,2171,1476
2931,f3e072febfd66a0fc08053a9a8af5d47dbe268b5f106b361cdc96494859e8563,downloader,115707,494,936,912,1406,936
2932,f43922953be3a09acba71760743b07e027733842819cb0f1a32935e4e08f77a4,downloader,762336,3073,5895,6112,9185,5895
2933,f48490be07a465a75e960342ffab60625d273ea2d55d62cfa6579398e6652e80,downloader,118271,510,941,918,1428,941
2934,f48e2cf200632b32e5b634c3dd0862309e49803586f0a6e2369607a00563bf6e,downloader,181698,758,1452,1401,2159,1452
2935,f4a551773244a23f36cd9cad62d1e6a1cf9f0161f5e9b031619907318257ff4a,downloader,147779,670,1148,1222,1892,1148
2936,f4ac20e18b444a5d1d3164a177bb6cecdbafc61fef8d9e4d8723f3f79a49c0d5,downloader,182556,769,1467,1403,2172,1467
2937,f55386b0cd4f2b16c0d6f8c56a3f344cf9eb55906eaad314d32ba98ab5f95dd1,downloader,181883,761,1450,1391,2152,1450
2938,f590e48a33679bcf87f02eea6bf10bbceffe55fb17a4b00c4720b0668f01abb9,downloader,187499,775,1493,1424,2199,1493
2939,f59a24ac061cca57ca44a7cd927e1013b5efb7d83f0ccfd528dc13a8477e69cb,downloader,186463,785,1487,1414,2199,1487
2940,f5c605310610c03eeada106fabaceb3930c7862b590a1d048fd3b00bd73fdc17,downloader,182651,763,1475,1403,2166,1475
2941,f5e641210e7814465d91b82e787ab54848b60c945672c183cb40189471b7dda9,downloader,10860,47,86,86,133,86
2942,f5ebb17cfcb11a9720f4ca78c940cd80338cb19732005e16ded5889529cb6ce4,downloader,853278,3270,6710,6589,9859,6710
2943,f5ffa8019d1dbc322d77f3adf860e04b980bb633f99ab4d748defcd11ff1f3b3,downloader,134510,587,1055,1002,1589,1055
2944,f64460c236fee84517b7fe7079bfe2d16a0ff81bf057ed0b00df87e698807681,downloader,187121,784,1492,1437,2221,1492
2945,f66493521e5c3a0e121d87cedbe4b2b045fbd9f30730c4a664598ef51d2ad38d,downloader,117813,507,957,923,1430,957
2946,f6753171816ff186f720e69d9fd7080777c77ce2b178ff11249e5e5eb66906a4,downloader,302060,1257,2323,2399,3656,2323
2947,f67705df604b0c7f0d52ea9f331a9092a7a268154c79f1f85b7cd0f83511996e,downloader,118450,507,944,906,1413,944
2948,f6edb0b3fbec8c4972a98e1d2774106313cc601dd2b57d37227703655576147d,downloader,118169,493,958,910,1403,958
2949,f75b78b43811f33b34918648874d42624fa05b50657632b72b153d73c0eeb035,downloader,182160,761,1453,1396,2157,1453
2950,f76748ab4e523faa5461ddbe6c48ad83db7239f2d18b83286b6e96505043da9b,downloader,118285,512,962,910,1422,962
2951,f7eda7ebe276ce5901053ea9601c367f2b67fa2e4ca593c13a04e818ed2c0c11,downloader,182376,765,1459,1387,2152,1459
2952,f80203a65b1eae13d2ba1b1c49b19954d593b07dd96f8ed375a770e737f473c0,downloader,187157,785,1475,1441,2226,1475
2953,f80a987f8cf70421109d1d404bd3d31c2ea93135984657541601dce2820f25df,downloader,765062,3095,5910,6132,9227,5910
2954,f8369f1bcff82278a8baba2e76f8e21031fc437fcfb304205527d786d3959cd7,downloader,181134,763,1437,1386,2149,1437
2955,f83fff95f1934afa2aab1ae19bc77528da65efaf262f3e665921e0dbead9319a,downloader,762494,3081,5909,6118,9199,5909
2956,f853b05386a41dbc802f96ada6f66fa5bfeeb956ee0e74e90ab550037234adf6,downloader,188305,790,1516,1459,2249,1516
2957,f88d9f2695cb9039165dcbd85b8639824fbe03174e75c6a539ec21b62c68c189,downloader,181909,758,1448,1390,2148,1448
2958,f8a3a883e0e4daee2039760281d2f1970eb403aaa651d917ece85af83722d8c1,downloader,115516,491,942,888,1379,942
2959,f8ad61562a7ed213c23118fe5b767f5cd027f6d352ad160c68b7ddc3fb83c54d,downloader,117877,502,950,888,1390,950
2960,f946a78542619daabf62d6c0c3a5824b5b13daf1206151cdf1361290f80f5b5c,downloader,184832,781,1493,1414,2195,1493
2961,f963d6db50910844e5c293e6f4dfb55dacf2a30089812256dd874a48c4cc762d,downloader,118334,504,966,912,1416,966
2962,f98654e5215c39dae8315195ead1d1a04fe9100ccb856130bb7619d89e9a18af,downloader,118371,507,947,909,1416,947
2963,f98f7d3df44e12f397f8f20ec7e04ee6b1de30cbd975d29c48c6b75ba299cc22,downloader,30829,147,227,282,429,227
2964,f9c36f8ba8a8ff28dfeedc0f83a12db4b4ec1e2aed3fc538047f40070baef630,downloader,301031,1248,2313,2384,3632,2313
2965,f9dd5eee9a4b32656c1881d33bd125ecc0909ced995bdb35c2aed14a732f095b,downloader,762499,3070,5888,6103,9173,5888
2966,f9f9f46cbd6501c9bc39423dce452463b25877f90a74ef9787b76a492af3c656,downloader,116731,494,929,903,1397,929
2967,f9faa7cb63b08f97afe84897d30999014c8375c946e8e9c9f163411adde71ddd,downloader,184059,776,1474,1406,2182,1474
2968,fa3e05ea1bf655e069fcdeff06c71b61317f4671d959d59e5066e67c929ab3e7,downloader,188121,780,1490,1424,2204,1490
2969,fab6e3b7932a522903204ccb9e494a4d87c11ea23a704bcbea0ef7e32ddc4b65,downloader,853381,3381,6631,6727,10108,6631
2970,fac7c978ba8afc7d4dd98f1b3cf0aa8608b2128bc3137e84fa24d0d61a031f6b,downloader,118431,512,953,917,1429,953
2971,facd0164d979ddc03161c0dbd358ba1ac9ed25ab1925571bf9a01dd84fb4d204,downloader,163189,695,1257,1226,1921,1257
2972,fb57cb74b99ffe6dc90e350795caa188565df38eddf7f1c9b5080f9a615933ab,downloader,116153,502,947,912,1414,947
2973,fb6f5ac67801ffa1952927685531550e50cd6c202646d07d77fc7938909b797c,downloader,70870,329,561,588,917,561
2974,fb71edaa84d29879bf5f05530b4f1555e8d9f2eb96de4e99e1667ebc7544ae92,downloader,116027,499,935,894,1393,935
2975,fb7959d3d46bd2da093e5e85c84da83605ac23699bef667f1580d2cefb908538,downloader,840626,3451,6816,6535,9986,6816
2976,fc05fb631b195a9b9fc4b1def2db823eccb8cf467cdcda67f432733bc67967eb,downloader,147209,667,1148,1217,1884,1148
2977,fc3e6a7b81aade61918ce1bccd6db970b540296d2d2cf2fecfe233e24b0f95c4,downloader,118527,498,958,916,1414,958
2978,fcdd13ba44001bdbde62bbb882adb029149e2958c593caa871e0b0dc0246c696,downloader,763379,3079,5896,6127,9206,5896
2979,fd56bcb68b5a1fd2a3c02d0403bd980de66159d5e71c3eb9d80ef98c2cd3f6cf,downloader,10632,50,80,83,133,80
2980,fd59bec985b6d4c4bff9d0d935e0967528ab869ef49fdb2f53236317ab8eb2c1,downloader,118454,498,945,896,1394,945
2981,fd8b59935dc3157dea1873aa8be52527c39d7a7882510da1c6458dfcc30c9e0b,downloader,117487,499,946,895,1394,946
2982,fdb35b01a4440098ca857c6e88c9a9161c45054051c6c1d36b6347025d0e6a6e,downloader,761931,3079,5880,6097,9176,5880
2983,fdf7693a203cd8dd70b7ccce0df550d2a973a1b5f6ffc9fc70953ab6f7b05489,downloader,116785,502,946,904,1406,946
2984,fed520b8e52de6e9cc02899f4284a4f42a2368dcfe1b7011308a632b19804ae2,downloader,117214,499,944,913,1412,944
2985,fef92734f29c8be7b5da17ce9f2e251c5e61b2ea9624231c7b8607817d04ead9,downloader,181502,755,1439,1378,2133,1439
2986,ff05fa7a71375c04c7c6968ec743e562ef1ab4fbffab8662641ec0ae6f26bd13,downloader,117069,502,945,909,1411,945
2987,ff1188e12e7c580043a6ca82963a7ac52ed0422c56e9131424c021f9af5d144a,downloader,182486,772,1457,1390,2162,1457
2988,ff438c63324b3b65a2515a2ee2e0b3d7feefeeb56d76d74cf1e5359d0b9ec3ad,downloader,118604,502,951,918,1420,951
2989,ff60a0db9e11fe723f3df204f35bd827a9a624ae1a7cff9efbce6224fafa311c,downloader,116627,500,945,917,1417,945
2990,00044765a54758cf9599dc3a25f6bece122549223bce35cda6c76550a56ee01e,dropper,5834,28,46,51,79,46
2991,00b58dcfe55ed0a97b2d0c4fa424e318ff327be40328a66fff8853807b6c0b52,dropper,5834,19,46,51,70,46
2992,00ededfbda5983c85e60cf04e503855b58b4db6097290edb2de6401db90e13ad,dropper,5834,30,49,41,71,49
2993,01239394fe66f8a411f3516c992e5a3dd069e8a4d7185f620a6d7273859468b7,dropper,749026,2934,5815,5846,8780,5815
2994,01668b3e4bf88a0b5e7dd0c50df43f306f74f282fd7d967adcb8c132ca626ec1,dropper,736961,2928,5840,6146,9074,5840
2995,019ffe5bbd50a94168aa0fb84e0678f07aee101e00bd674d3d404f00f66de515,dropper,5834,29,50,47,76,50
2996,01b92651d6beb8caf59a5e8e4e89906d9ed9733ad52c4e0a53fa20f2ceb04439,dropper,5834,30,45,57,87,45
2997,01cd770c5199bc44725e9bae00e91b89d6e58491f67062371646ad52f148ffea,dropper,5833,20,54,38,58,54
2998,01f79eb5c52519ed4ca7d62d9de032941f4fb31aafb7005ccda407b9fb1ef0ad,dropper,5835,26,51,54,80,51
2999,02058419e111097c6de482a53899dd5c81e30974e8e6c33110ec581e10ecf8ed,dropper,5834,23,49,50,73,49
3000,020ab57c74288e456d7b097d718f8f4020febc0045ddf86025be09f55b19868f,dropper,5834,30,42,41,71,42
3001,0216c0dd5c1d6c5af4225a2e0550468a12be036d1052781452ed6127ff359018,dropper,5835,26,45,49,75,45
3002,02378f365d298dfad3ab5fa5761c6ae04075563869189336bd25425f3205a0a9,dropper,579143,2347,4541,4705,7052,4541
3003,030ebdf27e0344ae5e41afcb4181dedf3969617dcb714e58c36aa4b751c5da8a,dropper,5826,29,43,44,73,43
3004,03ee299475c01cfad72f6413f7bd8f3455e9d2a606377ce17a25eb760d5a8f80,dropper,5834,25,43,51,76,43
3005,0454b92e4724b3e55ab4b66302d11f377472026a9374362fc67cb68864ee980b,dropper,579088,2262,4468,4502,6764,4468
3006,0487231410334e3b0c75230d79a3a4e30e9f18c8869784157aabfdaf8b9693fd,dropper,5834,29,49,47,76,49
3007,04e162bdb875a395caeddfa748f7c1dbfbfd0827e3e67668c5d970d42c27bc5f,dropper,5835,26,67,50,76,67
3008,050728ab67e182bd59624d608b57cc0f174a97ec162d2701bbcbbaf887e50931,dropper,5835,28,35,52,80,35
3009,0583b3204056c7d9df50c7f07c7959e393d933dfc7d3d83b53bf2528080396ce,dropper,5834,26,50,53,79,50
3010,0585d3fe0a8711f130d3dc932402f15a776842d0791c4c833dd8676de9a717de,dropper,5833,23,38,55,78,38
3011,05b44641edb0f257aff9cb4f9d62bedc95365ad8bc0506e2a7f45e52bca093ca,dropper,5835,21,52,48,69,52
3012,05ef2016cc066ae15979a3354989c0f233eca720eeaff7cb30506d14c626c6da,dropper,5834,22,50,51,73,50
3013,062cc6e3e9761aac9158fe2f93c396ece79ea95b710c7ee002316c6b7ee82825,dropper,5833,18,54,47,65,54
3014,07253a8198be9a279decd0b9b7aaf1d91dc0e61582b51106981d484948c91d96,dropper,5835,29,60,55,84,60
3015,07880b62fae0ec83b7f8b758aa6f60878ce0fb7896ead7184adeb598d5ba35c4,dropper,5835,32,60,44,76,60
3016,079301ce3e172908310eab001d8b4eb4a95fed5ea987ba897c79ba28d3528313,dropper,5835,21,48,53,74,48
3017,079b07d47e606655e3f7d09270d4ac4bb59d41fbc81dde3d2b035f50baa4a4b8,dropper,5835,32,56,42,74,56
3018,07db1a66ed82dc7778baa59311345a189a504a91a43dd920ece2bacc75cd4832,dropper,5834,29,46,57,86,46
3019,080a1b92d16d3c67e18381813ed9e702d2e9add5d93836f323423154692cabfe,dropper,5835,26,48,56,82,48
3020,083322e3d2e1e126941976275e0ec8c2f779e9cd079a2d5067a8c7e3a7cdf50e,dropper,5833,25,37,54,79,37
3021,08aa5b5988b2c830f14b7f8a95d6401fff7fd114d920906daadc001e3ca7fc32,dropper,5835,28,53,47,75,53
3022,08e303a2537b9c6d008003e523da0a5178e5490480de01122740c29935cc0595,dropper,5834,20,41,47,67,41
3023,09698d5bb19e3a891bd742eee87a8588b60213e4ecf060d0b5b74fd89a2a1f22,dropper,5830,19,48,37,56,48
3024,09820e990a25cfe77b03ebd0ca47a6e9e6e61b72565ff3fd88e3eb136fcfaed9,dropper,5835,28,52,45,73,52
3025,09a2ffb54395198c287f87678c391a341fbe145d0865e8262dab568bc97a0b42,dropper,5835,22,60,53,75,60
3026,0a42eab303959bc6f8746e2f9103ca9035d03272f031817e4b195a16d816f330,dropper,491369,1992,3930,3875,5867,3930
3027,0a82223dc0f25c1f5cef768fa89bf75f06b9f04445c7522ab8f82eeb2b29424e,dropper,498122,2033,3980,3904,5937,3980
3028,0a8ed04e57c3c6f0f96755655133ba564b6afe84dbed416dd857abb611d59a6e,dropper,5834,23,55,55,78,55
3029,0a922122b7db1202d332ebd79f41f14b99ca72cbb7d8a7edf04c901ccdedf831,dropper,579076,2273,4469,4504,6777,4469
3030,0ab5ca69565f0edc21e36aa687c77080f8c00acc58d6957f4c83e07def4c4e76,dropper,495806,2023,3965,3903,5926,3965
3031,0b0b8d69d141d759a7acdecb25e2d40862edb560110d3a2026275a51c1d46788,dropper,5834,20,36,68,88,36
3032,0b29948786e5ec4c4a015915b5e26fdbe4371c32bd3ae40167ecec1584dad178,dropper,5834,24,47,43,67,47
3033,0b5c0a4e7d4daf321a68c65d14c3a4ab02125fa9c1409c0189408480467ec8bd,dropper,5834,20,36,39,59,36
3034,0b6c42e47c137aed4f6d6402151c8e48b4c8effaf7b524b4e447b44db9c07ff0,dropper,5834,29,48,47,76,48
3035,0ba1ac1b5e2f913b1b6d5f7643dfb654f21a8edf51d21ca030eb7b37bcc73f06,dropper,5832,28,49,49,77,49
3036,0bd8a6d24821cbe979c4f2ab082326f722bfa8e9d9a2153fb64e8e1ee33fdb15,dropper,5833,25,43,47,72,43
3037,0bdf64059dffd22b3e2bd6e800b5f6b11fed5ac4ef7bde0a5a520c4b0168be2a,dropper,496972,2027,3962,3895,5922,3962
3038,0c127743639dc6f80f1c149b4c8337fc41c1cd3cbdf110ebd7531f11204b87cd,dropper,5835,29,59,56,85,59
3039,0ca26ff012be876ad409c87f77f4dfc10a4721ea38dec7d03e5b888d0a9c3c48,dropper,5834,26,64,42,68,64
3040,0d5e4f1e4ce3f75f8978e0128c87e9d6b1398c5390eb9ea95ca82198eefa9cc8,dropper,5834,31,49,44,75,49
3041,0ed9613ab189f8a08fcdbdbcb6c4d8dd8853c17b7192ec37ffc2ee6790d2ca99,dropper,5834,22,42,60,82,42
3042,0f05d2fe207b512b77957b3cfabc6b640e4e780fbaaad71acb7ae827fe454fda,dropper,5834,35,46,30,65,46
3043,0f5d8124a135438516b172feb9f89e90c8a46df9403895297849b81bacd6c319,dropper,21158,71,177,186,257,177
3044,0fdb816077afde4019d9cc91813a3117f7caf05750809a72d881113de8f3cbfc,dropper,493404,1999,3937,3884,5883,3937
3045,11474e7d091a0c9e5a07a0a657ef2b56c85cc1a6198ad9be5c3bfc04f27b8dcc,dropper,5833,22,61,57,79,61
3046,11b1a0ba3525e8f051f310201698f1a46110cffb8b192cc325b2eb3b042c668e,dropper,5834,31,51,40,71,51
3047,11de544e8ebb1049088eda591fb024bff26a91368a31f9b348e468f77bd8058b,dropper,565756,2229,4479,4428,6657,4479
3048,1205523fe1df9cf2b4490d26534a3a452addd25a0ce347afdc549a6411aa4a1f,dropper,5834,25,43,53,78,43
3049,120f5b55c726e7607fcb33aacecfb51a8211a8e85964c4d126dabae6f4101bb3,dropper,5834,25,52,60,85,52
3050,122f75d5a2819b311bc285301bafb2e0c350826f7f70c15d37274882cd3949bb,dropper,5834,26,51,46,72,51
3051,125b08b3178570c5de79942663e55ff0740ad5f64d4fb28abaec8b582317730d,dropper,5834,29,53,33,62,53
3052,12d3911ea0d21d5b779cbc979c43975df9e964355e22f29a115c44c5fdc81f1c,dropper,5834,30,49,55,85,49
3053,12e5d2192d3890ded919ba410b8b8b8c641e3382bcf724c0ad088ac6a15ae550,dropper,527541,2142,4033,4042,6184,4033
3054,131ff004f9349fd34d33ad164c9a2b2818825466c177d6e5fcdb5c8eb330c16f,dropper,5834,30,34,49,79,34
3055,135c1261a78d887cb457b8f82a1c89baf341702c2102c5948fa29a48543ecd45,dropper,5834,22,32,46,68,32
3056,137d4f7474df8a036464fe9c9cc503dfe67eb4200533f9460577069a966992df,dropper,5834,22,42,51,73,42
3057,1382ceebfeed5dac4c66a61ae905b96f84bb5b2a561bf1ca2027a95f1b7dee78,dropper,5834,32,50,40,72,50
3058,13850e6c38775ca952390d71366e8bfea0fb5466a8545c28b16366269585f4aa,dropper,5835,17,46,42,59,46
3059,140a5cf3ef3eb3c561e5bc41dd25d0ba3aabfea840ddbe8237961d52c5d1ae42,dropper,5835,17,47,41,58,47
3060,14cbfde2f63b91b178661165e3479ca8fba4ee1da54d265b8da93c88ed9278e2,dropper,5834,23,53,57,80,53
3061,14cd94e551ee3a409de929f29fa56b96e4ede290092287fbb9875d1125cf37a3,dropper,578448,2358,4570,4621,6979,4570
3062,14d4df2b000ae65256694a3e25c8191cc5b56e6a9b5955995a3c7c24850e970d,dropper,5833,21,54,56,77,54
3063,14e5961c896925ab77da87a4c1e41f1d05ef8a03aea452bdc1395dcb8ffc2b2d,dropper,5832,30,42,46,76,42
3064,15389963b264f5280b08d3859899a6dabbd5c6c58cfb2a741260a8f473288085,dropper,5834,28,47,60,88,47
3065,1586571718f6cee848e4fcbc8136aa6aea9773c3ba118d03f679899203e2375e,dropper,68382,270,516,589,859,516
3066,159f34dace5d4fcb5b0bb701af6a00c0b39827fb25efad3206003eb60b7ee70e,dropper,5834,31,45,64,95,45
3067,15b8547f6ae9e727d565632ed89061a7a5333297e4744e3da1a94bfb64876b04,dropper,5832,26,53,56,82,53
3068,15f2789f9bb2a7e383c60fd8f55cf4a5b80948478d4f5141130e6840f5cd954e,dropper,5835,30,46,59,89,46
3069,1630dddd144c3f13f7815a5f36b5c82224f50aece60bf443403bb151e3881cd8,dropper,5835,28,58,40,68,58
3070,16b548cd8b733140f396468564311907dbd13ad9eb301304fd83742ede376ab3,dropper,5835,16,51,44,60,51
3071,16ccdcaeaf69587afa79fc8e0e54c9d4505cacdeac5ed53049f44e21f460906e,dropper,5834,22,49,42,64,49
3072,173735e531994fd9fc7ceb25fa4a26d10dabca0491f8430a020ce8d9eb5940ce,dropper,579151,2325,4450,4580,6905,4450
3073,17a27d20e4a6c442274260dc6e97e767179041b5a70caaab5e41194e9fe2440e,dropper,5835,20,51,42,62,51
3074,18547faf0f096eac8bf1a1f05c9d60ee43929206e7ffff339d97705f0fe184a5,dropper,5834,20,49,50,70,49
3075,18a234db42b9bfcbbd76ed455c3e1d30a31d93ddeddf803d32c1ae7e5a5758eb,dropper,5835,26,45,64,90,45
3076,18a6846dd89a1b48b895aa0d77d6f77df65db78ad74fbc995c33c0de8641e935,dropper,5835,33,43,44,77,43
3077,18a6aa052e0470122a4d8fa4c457581c0c9de52e73325a7780365f5ec87613cd,dropper,221515,832,1824,1764,2596,1824
3078,18bc670c8849c9caee6d6412c13477761b10dea6a17d36f95e281582415b07a1,dropper,5829,33,50,44,77,50
3079,1974bb0f3eff53c06681d457aeaa74f3325a9bd7517d3335f1eb437747863012,dropper,5835,32,53,59,91,53
3080,1998f9479b9115f82619baac988151070b266b757ad66d8a3ebc35fd4c6a9e12,dropper,579147,2319,4433,4579,6898,4433
3081,19d5d1e40bca6eac23002964eea7162c055d449662580f79c3485771b72ae7fe,dropper,5832,24,55,67,91,55
3082,19e0c539d710fa13c1641bd3457e1e46901f4935343260078f4660f0581d1461,dropper,1293865,5069,10232,10228,15297,10232
3083,19e19e61f0e149097932b43f1754c0b1e7793d93a2f08ea0910a7a5d9b748fe6,dropper,5833,26,45,65,91,45
3084,19e8b11275bf90a18c9eda5568d6ef34c4778a9449065a19394720a9e75cc0fd,dropper,5834,29,60,57,86,60
3085,1a331eccb1032476a05ec92a09cb70f53c9ef55a18e14558e94b66244231451b,dropper,5834,28,50,51,79,50
3086,1a7d1c87a67d670d3980c4beda265782d5e56b908274183f124cf93021e5656b,dropper,527535,2136,4029,4035,6171,4029
3087,1aeb0ed5a8a86958c14a16dd2f5ce1801c3fa978cf8374bc85be492e0c74c932,dropper,5834,30,45,50,80,45
3088,1b05d4e083d2e110aecf74e6ee5f963ba33d0eb093f0d06c6a986f7b3f6a5995,dropper,290749,1157,2255,2366,3523,2255
3089,1b14e0ef8a53c086db4eabbaf3c7c7d37bd453a3a03629d7b382876974a29620,dropper,5835,29,46,42,71,46
3090,1bd067cbbf361700103baf4ad625e8cb61a8dc71eb48875397a4abd726260eba,dropper,5834,30,46,39,69,46
3091,1c795de8222addb5890eb3dc69abcd302c1901138f7aae33506754626bb42dc5,dropper,5834,29,51,51,80,51
3092,1d260badbb1db3b0e51ee9a301ede3c0bf44cda1e20231120fb4e7b00775c13f,dropper,5834,29,48,48,77,48
3093,1d85be1b64bba91de58c1de21b14160db83c26f160606abb55b6bafdc57d4b96,dropper,5834,19,52,46,65,52
3094,1de587f3c027b63821fe591fb36935194c3489beaf17ab7ca1f29980412ffc23,dropper,5834,26,45,45,71,45
3095,1e04445cf054206b113fb9962b26fb94c42ba9d2366b7a01e284b1f1cfdd8ec0,dropper,5832,22,33,58,80,33
3096,1e0d28a72cd7a20f40d0e07a4d95282934e51157e123730492f02f013335836d,dropper,5834,26,36,51,77,36
3097,1e66a5a759aadc36e27ce78c245b171c29b76ff1e3b39b71b91fd0bdd6c12e49,dropper,5834,26,45,42,68,45
3098,1ed22730994efe0c1daef170450290b3fbd738c31983c57dc9bcf3b820e2670f,dropper,5834,18,43,50,68,43
3099,1ed96e204bda50d00649e04b57c2a203b6b0bb78a018da52dfb2c2c4ab1d38dd,dropper,5834,13,42,54,67,42
3100,1eed37b0e03fd7340240b49d0ac0d6302b5c1aff6d6e579a543cedd9dd63e234,dropper,5834,21,47,43,64,47
3101,1efa9f4af68ff7856d501f4b1b6ae60875bfe6e657f57bbc78d79170a76617f7,dropper,5833,28,48,56,84,48
3102,1f0b72eb50ba24525f7264be3b8051b9048897f677f17870e6bf3d28ba11e2a0,dropper,5835,24,51,44,68,51
3103,1f5082cb5ddb34fb11b117199e028654766be1e1a971f6f8c92450d83adcec9f,dropper,5833,23,45,45,68,45
3104,1f66e71a1d2d03f4b752fa9a4b349083d0d465ad43aee1893471f8f4dda91d85,dropper,5834,19,41,41,60,41
3105,1f7bc5bba3cc26c0b2f20d6a604b970b7e06ea17b3373baf75c221ef95e4128e,dropper,5834,25,53,54,79,53
3106,209df217428188d35ad848c4664cfc9069c7b30b270aca372de7d78ae671a235,dropper,5833,20,47,49,69,47
3107,20c10af7da662f40507f57b2a83877d01f3bb1b6d5d9accd069ead89a4ffeb31,dropper,5833,21,51,57,78,51
3108,214e20c1561d774900fa2dc06a58c99feaf9359a668f8b3d9d46d0b2c20aa287,dropper,5835,34,47,62,96,47
3109,21b5ed1e3aad5934907a93e5a47db502606ee6ec57d1eb0dfe766bc663d73bc9,dropper,5834,18,57,51,69,57
3110,21bc42fddd8ee2c3df7fe3389b04722cf2371f5cbc5eccff2487e00c7e5f9d7d,dropper,5834,26,54,53,79,54
3111,21d7193bdb33a96329be3edc83ccf80a4fa97311e3481590d51d765933691709,dropper,5834,28,48,56,84,48
3112,21edb560bf9bc65c1f9a2eb032939a05ea70d9458007785d8f50043e2d0bbc45,dropper,5834,21,36,51,72,36
3113,2220329dd8c1fb42e68441428519d3d5795b5507c6da8ce84eef0e834a145797,dropper,5835,29,40,43,72,40
3114,225fe3506982ae623c29be9651ad4856541540d4a30f63fe0de25f53d4541ecc,dropper,5833,24,36,42,66,36
3115,22ccb8cfbdcab1dfe1d4146678c7c789cc60e98e211d87e383aeed31c91d6f2e,dropper,5834,16,44,52,68,44
3116,22cd80b5e31be7c55a1fa5e63a7e47b3d97b77c263dc754c1988bda7382164ea,dropper,5832,30,44,55,85,44
3117,22e02db7f75fbb5c654e9e02b1dadd7aa1d12dcb7ac41947ca1b5f521c69a3d9,dropper,5833,25,47,50,75,47
3118,22f36aa734c9dfbceccc5e87a2c8544c917cc23453d81adb19044fddea52b5cb,dropper,5832,28,49,56,84,49
3119,237c3d703e0e76325c4ce359f36096d9317db17017cff401f06946882857ee5d,dropper,5832,32,56,53,85,56
3120,240c4fbf1cb289ddb94a3a3ead8343cca1386e8b11c99e390bd9e1c714b2f8f8,dropper,5069470,19729,39335,39748,59477,39335
3121,2415445dd0dd81604a5d077606615770520078a7bc4589720c5c9c5cd8c23874,dropper,5834,25,44,54,79,44
3122,2424cb9c52d25230f9d0136656d328cfca272b2f5bceaa859140f5e78f3ab093,dropper,532246,2054,4119,4227,6281,4119
3123,24488e37250c6ae77659ffbf252486210636e9802ece92507a38880d572d737c,dropper,5835,31,53,37,68,53
3124,24719f8a62fd276bd185253d9d174be38a66b076bada1e45c52037bddceff5e3,dropper,5835,22,41,53,75,41
3125,247e459fd43988ceccbd0be9d9dab8d9c83b7788c1c01d0e6105f331af7acffa,dropper,5834,21,50,45,66,50
3126,24a138ac3d19235fa92f29c61eefa807813d75e187650fe215e20a3f8e097d57,dropper,5832,33,61,49,82,61
3127,25a00632f0ea6cfc7f843b34216f9dffd7d952462c0bb230848c0c8ebc07127b,dropper,5833,22,44,55,77,44
3128,25b1c4173ef8bcb412d55627d5abaf79f382ce7ff7e0df9f7888a95f1a8d7d87,dropper,5834,17,47,48,65,47
3129,25de783290704d443a24e947cc5f7c37a398eba61c29324da283a4f654010fd2,dropper,5834,30,45,50,80,45
3130,26934111bce8152674c74643b30c46e9f508dce51623437d7e20fbc909d26fb0,dropper,5833,26,45,66,92,45
3131,271238babc65cf0f20869f9bd4964d8c106c5665a8be82c9406f09b816099e43,dropper,5071836,19698,39541,39438,59136,39541
3132,273bb0f29271cdb5a370ac192d7ba3b91afd5d36c8f9006071c0a50c25d61033,dropper,5829,26,47,50,76,47
3133,2792cac99749a08f8df3ea2e94b43973ba393be7d8000bf51317fa6ac0f9eca4,dropper,493129,2001,3929,3885,5886,3929
3134,27cc362b67802b0634dd76caad8178a2d5240fb30e62d6e53a24116ec4102a22,dropper,5835,23,43,58,81,43
3135,287add787e75237154ade77baeb8f9a92ec54d552a3d7f52d830720bacd89469,dropper,5835,26,34,34,60,34
3136,2891e152b72ea271b043702fcb0b180a1b16933213e97a1f9fff04f1225f2f14,dropper,5834,26,38,53,79,38
3137,28e14432bc1adf5ba8674520d8a92cb047aa3dfd6a6a00ccda86ac7c95aa5c04,dropper,5835,25,50,59,84,50
3138,2914f70e4ba12e0a57f84b6d2e6f1beb5b1913524c5b0495f701c988037782ee,dropper,5834,25,53,61,86,53
3139,29812215c6930d53a6c2706da32a4d3c9250b5318516919f7ca9f98c73ef70c8,dropper,5835,29,41,45,74,41
3140,2982fa7e7b4d1c96c9fa88d86de6d245e02fd89c2518a70f842df9be57d91c92,dropper,5835,29,51,54,83,51
3141,29ce76bb93e7bae1cb570640d6420d5e47ba0a1c3d9282ec22f4691c9d44b48f,dropper,5835,27,46,44,71,46
3142,2a06b80e3083e9a0d2f7aac11b5a0febcea4510b399505973a94b51b3c512995,dropper,5835,23,51,59,82,51
3143,2a796afd66abff020e11d246b8d340f12e17e852804c0b5ac7e1008cc5e1df5b,dropper,401448,1614,3151,3265,4879,3151
3144,2a82f549579243663c0210e0aaddd0d338503a23001c50823ad0b69714133c27,dropper,246391,1037,1926,2020,3057,1926
3145,2ac32549245c87af426462f64a01a7d9bd8c3fc8b02f5948ff454daa6c58f510,dropper,5834,26,45,46,72,45
3146,2b2c03619d2b9560ecce9ab9add281ec318bab53d9469008979fd1a139ef0f50,dropper,5834,33,59,38,71,59
3147,2c36e932c7e5b498c32abb10bb52e0f6c668b05dc4df970dac2415042ca39f2d,dropper,5833,33,48,37,70,48
3148,2c43b89ea6e82c0532e0b547b7d943788b6adf5782379550b5137220253340e9,dropper,5835,32,60,44,76,60
3149,2c71bb9e61e9d12f6e851b81ffafc3c28d7fcecdac0bb5a2afe1079c6faff2e9,dropper,5833,22,47,46,68,47
3150,2d885af3ae9b59189b7388349dfdf32eb99238dd39640b1a84b9010275f6431c,dropper,5834,31,49,51,82,49
3151,2d9b31202838c0c1acf124714e42a1b6144bfeebd101f043cd5d70687e84055e,dropper,5834,23,37,50,73,37
3152,2dcab1ad9bc3696737f7f58b13d787bb1b682d4e58c9d7d5751e364a7543793c,dropper,5834,34,53,52,86,53
3153,2e2331618ba2b73e0abfbf2b3ff52bc68b1609ddf5a0a0c55e529414b6683870,dropper,5834,33,56,38,71,56
3154,2e88d3ee8b24075940e33a6063ad85823b2beb932db5fdd0058c037e515f8488,dropper,5834,26,59,38,64,59
3155,2e8dd2bb082a5d732fa834f574aa7f51e20ed403594fff7c2bcf35b899e90a88,dropper,5834,25,52,50,75,52
3156,2f40a79b665966b2e27a04fd756bbc078e7cdd11359a7670514c3fbe9147dcf9,dropper,5835,33,62,50,83,62
3157,2f516c34825b8f66e63754d36de38872ec2a20b78ceed544aaec103b08aa9f59,dropper,5835,26,68,45,71,68
3158,2f780cba74ef355314775d51f0248c697d04e2dd0d2041b2ce0a05b641b3fa9b,dropper,5835,28,43,50,78,43
3159,302a26991fd282a45501d90dc060267c5ab51e4da07788033214229cc33ebe10,dropper,5834,25,49,41,66,49
3160,306f3cab546ec97739d5e26520ef5cb36a1aab0f2da8bd8d75159ef17b8cdf02,dropper,5833,23,47,45,68,47
3161,30a7f469c579f85567a9b0235f4d7dd34bd6bfa35305d528c5918c47e73020f0,dropper,5835,33,61,49,82,61
3162,30bab230cb206218495a6a37a2600e8f0c236c3af6cfe6ad44cdca9de8402b01,dropper,5835,27,46,47,74,46
3163,313ac2ab48d2656954e15e7103b20d85f4d9cd9062fcb65e114cce51ec44d146,dropper,5836,24,44,37,61,44
3164,31c8ccb3bd6858ea941f9328effff794b7ec7fed9c603149677f750c48e608bc,dropper,5833,26,45,45,71,45
3165,31d7d3b54e19a0b42f782b243414f7a2f4b34554d1ecc949b3f6446ec4c403b3,dropper,5835,30,43,58,88,43
3166,31e52a234e75dbecef94478383f84f0d1cdfae5fe17750e445754e32e0557d8a,dropper,5833,26,45,46,72,45
3167,31ea40d0c195175c7da6d8ba9182d25bf5fad57dad95262940fd00b7c8bd6a4f,dropper,5834,21,46,56,77,46
3168,325732f664122eba868190b5aad1b438353918e6964143e36abfd08d27d84a0c,dropper,5835,21,44,56,77,44
3169,327d738919cdc4e2f5ffdac56757a7b7aa9bb35735afc62d0d7adcb83a9c4190,dropper,5835,31,45,59,90,45
3170,32ced2e9300d420b4328d4c40b9e0c5565c6c040e1fd2c337cd570aa1dd0a5e0,dropper,5834,25,49,50,75,49
3171,32fe620fd9ddd1de8d9d01899f54e49a6936838cdecbaf88856f8c65bf7f009b,dropper,5834,26,52,53,79,52
3172,3321d31b468cbd2f7c0ea992b9bf3f7308f17f25d002252ac4a09ab360ca3158,dropper,5834,30,49,40,70,49
3173,334a0cc39c8005a05e83a78625b8145f1176eb3cf987a6b57d3090ff2a718b2d,dropper,1088179,4465,8682,8734,13199,8682
3174,3403aeefbb1e2d112a82ab3819af0a315ceeb0cfa947e61f80483f8156f982d4,dropper,5834,30,46,36,66,46
3175,3442f3807a133fcadc2c1d2069d6ddccab4706438567775c048a4acdf9d92608,dropper,5834,24,44,39,63,44
3176,34b2aba93b16d3e4a6a7fb5dabd168f97da16e85591393090b9213ab28b4b8d2,dropper,5835,20,49,49,69,49
3177,350d1a6b1c2ab996e8dff1dc489cf654ef337173a0fe72d6f1331945cb01c520,dropper,5835,29,40,45,74,40
3178,35100db98cfe72baf7c704a062b9aa1fd69aa8ee23f77855401ba0c70b3d5f91,dropper,5834,28,43,35,63,43
3179,351b82f9b6b7d97e28a6a58f01f674b8d682eaa23a241300995a855702d0ef71,dropper,5834,26,44,51,77,44
3180,3534c4d8778676485769fbb18efd78a198d35791c976549394e5c00c7678224a,dropper,527542,2148,4019,4038,6186,4019
3181,356d90ecf9dd52410b060177a28a95bef8149e4b71f19e977331963a5ba387e8,dropper,2960553,11460,23139,23624,35084,23139
3182,35c664def69ee4c95d6d22170722740b0bd6e331b0153afebcf95793af8c03ce,dropper,5835,29,59,57,86,59
3183,35e5bc10334b7cd5f59a426566912984a1cf0d2a74757e05687e21f6c78ce85e,dropper,5834,26,52,52,78,52
3184,36141f1515108527c19ab88b8c92252e808a6dbaa8c383ccef03d60f0c14e6c2,dropper,5835,30,48,53,83,48
3185,36508ceb8f2c1445e93c8f022cd6db71f3018e80948161fe13d935e73b785994,dropper,5832,21,49,33,54,49
3186,36f38ebec6a46c496812d967095213dbc2556b9b5421606a27a6d3e1c3bd6353,dropper,5834,25,49,39,64,49
3187,373cc13892675f94e27a3a7824c092ab7a1c0b17ec29f532e221c7b8603b007d,dropper,1316301,5317,10484,10595,15912,10484
3188,3764c998903b573f8441a3a62616d3997fef4ac46aa2aa85d389504d79ced287,dropper,5835,26,44,37,63,44
3189,37be27d1254ca993c055f3b68f32146dae75849cfd6dbf0d147840b2b58e68d0,dropper,5829,27,39,53,80,39
3190,37c9e1f0dc23a278039df894903a41e5c2893c7e9fc05cd0c70dd914f05901ca,dropper,433880,1699,3465,3498,5197,3465
3191,387a80a4d88f8da09ddcc080c1fd9b3d55e5c41d4efc0b30ef4a830f2dbe9407,dropper,5834,25,52,51,76,52
3192,38e55b02f7358a358ca5d5eec2fe3e414a344dfb5d5f9f46550d9151dd3f7396,dropper,5834,26,65,43,69,65
3193,3914fec814b8eaa62e70128f80d73ffecafe7a3a027f92e2af62161bbfc9108e,dropper,5834,21,46,46,67,46
3194,391a65e28325eb7a8415300f690aaa5a56e6c495c4d0ca199b0e86ee524ae56c,dropper,5834,27,54,53,80,54
3195,39a0f55b27301aea8e4ef3a2084ff9ed75726ac11f504f593caf01fa3132afbb,dropper,5834,23,39,55,78,39
3196,39a3b4350eae6e113e020f60e7593833780098c06d14ad96f80ce8f334938db7,dropper,5834,32,39,46,78,39
3197,39f7bbc247a629691f8250825e727b2606a5a2dfd74f1918661861e775aed232,dropper,5835,26,58,41,67,58
3198,3a481624c104f89b9bf08346b8cf820856510ae094c701d844eb9e5d30a09af3,dropper,5833,22,50,48,70,50
3199,3a672cbfa199d886147b467d07be6131af62e92b1d58018b56a4a87227f5e0d0,dropper,5834,27,49,47,74,49
3200,3a7e481d72633ba7313945876bf27e0fda005beb1bc0cab4e6e5830706c73282,dropper,5835,29,40,45,74,40
3201,3ad6ff6383113b6a8a000aaf71b62123854b9ef3a86c751a9ac2cdad5378468e,dropper,5834,29,48,47,76,48
3202,3add7e217f37fb44c0b5625c57c5db37c46c08d0851e2358f3b547348cf49d0c,dropper,5835,23,35,37,60,35
3203,3b00c80f00ce0d2f397def33d2bc18698e0360eb62a67474562490415ce55082,dropper,5831,24,69,57,81,69
3204,3b05eed89ae648d16af61ca94a482a1ac8b6eb80766e5946e828cf58b4581d66,dropper,5829,29,46,53,82,46
3205,3b4eae14c6697fb4624231943daa1d622e0ae24d4562cbfe2ca96867bc789f9f,dropper,5835,24,49,45,69,49
3206,3bf5d4bf663b4857d1d55d5f708253034f7b202188e3a00b6b6e79f7392dab8b,dropper,5834,25,46,50,75,46
3207,3c0bc1a8302ba0fea402f03d8ef6eaa24781f797a1153ab05e347d486ad29621,dropper,5835,30,50,58,88,50
3208,3c1ae071ead6c38fcb6770175524bf55697482b2b84a93a5f10ae8bec6242710,dropper,5834,25,52,52,77,52
3209,3c3566662d1c8badc0a6148e518b47796501ea1ebfeecd271d7601a617a46b69,dropper,5835,28,40,60,88,40
3210,3dcd248eb24b121bd27e9c3b33aa72a2f610e15248e2a9ab2e129aea9de6761e,dropper,5833,27,31,46,73,31
3211,3ddcfb86226c0d97e584aa36a1c18b68a960d9e8c96f7ffa35068c73696de8f9,dropper,5835,25,47,45,70,47
3212,3e8136bcde51f4822069a2ca1a1de9ef3c8c50b391874d1e3371fe1c0935f039,dropper,5834,27,61,60,87,61
3213,3e832f6e0c9468630f5593aa211ddba7350971d7c68873351db0ffab8388697f,dropper,5834,25,50,53,78,50
3214,3f1afaec30807af810063b91e51ffe97dab7bc67f58a921ea7a1433a4ee03ce4,dropper,527536,2135,4013,4042,6177,4013
3215,3fc6f8c48331a484db803ab180a9d2e001cb6d6f953285556dac601992798e1a,dropper,5833,26,53,49,75,53
3216,3fd1d9f5fce025efadce209505bfe0eedbcee874c6d6959fdc390f46001900e4,dropper,5834,25,38,59,84,38
3217,3ffbe9372a8f1787b1932d637128589b32fc7fcdb05c368c61c3db537fa29cdc,dropper,5078578,19768,39655,39793,59561,39655
3218,407cc1353e9ecac03ac350982230dbb4377b9493994291a82d05b8f03b4ef264,dropper,5834,25,51,61,86,51
3219,40800672eed91d33d71f2aeadbb4f9003cd7da01e0f18985e399317102c7cbba,dropper,151398,566,1231,1249,1815,1231
3220,409ebef867bea90f0b08dccc1e29359d63828582db6b875c68c927a817b82cfa,dropper,5835,32,53,59,91,53
3221,40a25e6bb47df26665e3ebd7eff33ea930dc95b1a385c90b83327b3b3e904177,dropper,5835,25,53,60,85,53
3222,40b3efc637f6413e33c8b3dcdbbadf65726e05474f5a4acd803d4e7b0f1e073b,dropper,5834,22,40,41,63,40
3223,41064c95ed1655f0d8c8c15016c8f66050d24dcf02aa60ae2a5247d5c166fbdc,dropper,5835,23,50,59,82,50
3224,416034f534355539cd74c2ac275f1ebb5e3b63d6f864c254b9ce00418370d141,dropper,527532,2152,4017,4031,6183,4017
3225,419f0087631b2ae7435ca1f20663d54ee2921b44018746f97eab7e3d2dffa1dc,dropper,5834,28,59,44,72,59
3226,41f9a89b252b7242ce98c0a55e84757664345f957cf55c5750c6771e51276f92,dropper,5835,21,36,47,68,36
3227,420e56161813d33842fe14a50f099568ff141952b4728dfc03668b317ea8695b,dropper,5835,22,42,48,70,42
3228,42663f6b4897d3c00251dbdb8ecfb1fcad96a9260e496d9c0e2c9ec5853b21af,dropper,5834,29,45,49,78,45
3229,42eacd9cdede50a4a73cc0d6071df6d6bb6abf6890b1d75fc54c8e352349d062,dropper,527540,2130,4020,4037,6167,4020
3230,42f3058fa4e3056c6999d8e40b8939eb9aa2973a667bc252937aea89b72cf7b6,dropper,5829,26,48,47,73,48
3231,42fd0be1a8a53f862393af2baed18053ec048412a2bef032524b9202add10b72,dropper,5836,27,41,49,76,41
3232,432fde594a5dcb4c782aa04f6ed836bb1a0612cba9b82d457e723f5f64980c6b,dropper,5831,20,52,56,76,52
3233,43552cf5a6802b00a2b447830cadf4094cf85b97cbccb4d224b9d90ebed27eff,dropper,5834,25,51,62,87,51
3234,43756bfe6af346a2680e5516a2e1a7cb2cff3552a6e9cf7c9c32a96c6a83496a,dropper,5835,37,50,50,87,50
3235,43b80a66cc2646229d8c23cabc431e93480f21e8c982743ef7cd6e31c8ff21e5,dropper,5836,28,37,43,71,37
3236,447fb62cd591aa8fd0f379b8754b2d886e7400486af1a11ce6f8a7f96c48adc3,dropper,5833,26,56,42,68,56
3237,44a025a427c783b0341b6a97cfc6ce9061a2e9e51acbff79ff202aa53e0dd100,dropper,5835,26,44,44,70,44
3238,44ab5d037f6c3fdc198b6cd5bb840620df5cda960ac3f2284718d1ebaaa0aa7c,dropper,5835,20,40,54,74,40
3239,44e733fb7fb9eecfcf5bcf95569b099ab55ee24ef5bdca13c51e0e7b5a923fe6,dropper,5835,22,49,42,64,49
3240,44ebac692c98e81a2b81c3a29aaa921456db1f9f47586419711505dece7a0f8f,dropper,105779,415,860,823,1238,860
3241,4523a8d90fdc43156525b9c3e32fed5c3d54af7d2b3148eda55e938a3ab9b384,dropper,5834,27,63,44,71,63
3242,4545a7c4cf3238712f7ebdf644794f59b1c5912a2e40e01277b28dbad23e7229,dropper,579148,2317,4460,4599,6916,4460
3243,455e019f9fb16342cfc4c22b70cd45dc94106cae4ef83d87c97d840bc5dc5116,dropper,5834,33,54,51,84,54
3244,465165efb037121597a639b776ed135864357b3435059f18eaeaaa7db5d238db,dropper,5835,22,49,43,65,49
3245,4657b50df013176eb36c77fe66bb444a23dce44b5f0013329eb9cde4984ad4b7,dropper,5834,20,41,69,89,41
3246,465f1a33916bc3c358a5ecd168f25749c076cd1031077d4333053dfde5af5117,dropper,5834,30,33,48,78,33
3247,4666d117ef335477938ea9239d03104b6733156d6e586ca9f82757eeb226a5ba,dropper,5834,22,43,49,71,43
3248,466c0956e142f5a845ddc9a3c82d5a4c3863314b493047295aec204c6c2a9810,dropper,5833,32,46,55,87,46
3249,46ae9da3dae601f19476515e111d4d664cf2d49c093812f9ca4deb0a5f574ad7,dropper,5834,25,44,47,72,44
3250,46c24120615562298c94943d6aa8cdc7b9729bb638663d234213ff704688dcdf,dropper,5834,30,44,55,85,44
3251,46c36b1683317ad28007f5c0deb446bde2ea660f8ed052d626fb6326cdaf0a13,dropper,5835,22,50,49,71,50
3252,471ab166685f1756d75672393c23e96a6ad8559ca6f1e0a1ab651c7261fb8661,dropper,5835,28,39,49,77,39
3253,472ec78c2c9ff0bc0412e10ea1471682d3ff27c280da59391891a6ac307f9567,dropper,5835,32,48,44,76,48
3254,476dd4a2d00bcf4947c787c11ad392ed8247186d18c38a46ae9838ecb67dea22,dropper,5835,22,40,59,81,40
3255,482a0acb67cd5ae917c5ee5b4dfd498990f1d5e646f68b3799bcd70ce6733285,dropper,5835,25,50,59,84,50
3256,4888335d242c99048b9d7a5f26ca2d511cf45f61e6eac571ec92a3bbbb533545,dropper,5835,39,43,58,97,43
3257,48d5cafa83accd153311fab3166de7a26c712abcb027286ceb8def18dd3beeea,dropper,5834,24,54,49,73,54
3258,48ef8c507d4519a5274ac9348279bd5e5e9c075016a0fecebf20e4896f5fb641,dropper,5834,22,54,53,75,54
3259,48faf8031b6f5c09c73487e8bf5e4d05f2dd5a0982378f5e45881f58cd7f42ec,dropper,5835,29,54,55,84,54
3260,4968789ff640040bf9221512eea7be87954d13170aaa00e979edc4ed6ba1c628,dropper,5835,34,48,58,92,48
3261,49979628d4744822759f673ca633b960f8933fc6469e9a65184113e122f2a40b,dropper,5834,22,38,45,67,38
3262,49b357b1bb70af3ce68293d21622012729db73b3dc06e5a95b5208ecd2526aa2,dropper,3198083,12462,25176,25583,38045,25176
3263,49d887ef5bfee87bb67a89d52d4726736e6451666624e4734b0f8a2c272efb9b,dropper,5835,24,49,40,64,49
3264,4a0e5a9f74958d080bf396b3e9b088829e753679881b5451459bc81c3789a7d6,dropper,5834,27,44,41,68,44
3265,4a8157c9eba4e692f121963d19cd00125d538d213f9c420d45dfdb8002710cc5,dropper,5833,29,55,45,74,55
3266,4ae500ef6db7fcfbbcc63c968637fbcaa464e1543b0029e68c8c96b438ed49d8,dropper,5834,17,47,46,63,47
3267,4b414b92e8799224d0ec2da5c4ad825eb9bedf6f04bd1749a0f3b4fba1627104,dropper,5835,31,43,56,87,43
3268,4b722b60e5ddf456ac71ba7f0f7cce21afb7046ae8e6f697f532135c48019cb7,dropper,5834,28,62,61,89,62
3269,4bc012506606271e93c2c54e7735a61c7029882e33fcdc6a795de610d86d6c5d,dropper,5834,24,39,54,78,39
3270,4c237bc3d8c76f296c637d14c18b988d00b06ae72a7a7e7cabbd5f04c95a86a3,dropper,5833,34,52,42,76,52
3271,4c3651d33d80390007396b307fa55bb905db223184b29707269f280176870989,dropper,5834,18,42,46,64,42
3272,4cef7b38cdec5ade22428dc0e831583b28012983edcdb172970fac87e6c80485,dropper,5836,20,43,42,62,43
3273,4cfc10648aef938c535bf5c0d26b0748a1abfe501d1ddb80ae220a94e826099e,dropper,5835,28,55,55,83,55
3274,4d43667c0fc761b0efe46bf257d20b216631e9600088d7e770f4771aea0c9ccf,dropper,5835,28,53,45,73,53
3275,4d89daa4d7499ef6220816dc38bab2f1550189fab699df3ecd4d838f20a82ddc,dropper,5834,21,58,44,65,58
3276,4db2d43445bee68d492ff0d5207795e3a798fab5990b2e12531a1f9e2662caca,dropper,5836,29,57,56,85,57
3277,4ddd86f33004ae90a60b96a04ece394e94f65ff64d642296ecd57b2eed40f919,dropper,5835,24,42,47,71,42
3278,4e4b95ef8a8d681307f99096775427a3d9d13f2a43d70b9eeebd7e86d608158a,dropper,5828,33,53,41,74,53
3279,4e70154f56f380dd9cf789945f2904433d81fc60b14ddabd68bc65bee83cbd75,dropper,5834,24,53,44,68,53
3280,4f5827df8527d23e1c7ec641ddc31d7839bdd02aa141d195c074151fc53bdadc,dropper,5835,22,47,54,76,47
3281,4f5db74bbc0ec4900d7ed7b02a573fdb9140b298071b267ca91d0b5e3f8eb25b,dropper,5835,31,53,55,86,53
3282,4f752ef3a580463d9a8abed1fd9fd26dfc50adeba3482040915721ab8a27ba2f,dropper,5834,25,43,47,72,43
3283,4f896ad0fc9eea1925d7ac07af8d6796b8e2e42083b67b4e3262a8cebd087395,dropper,5833,27,60,59,86,60
3284,4f9e2ecde9fcc1bbc964491adb863893a55e29b267ec58d60a36820f4c3cf0b6,dropper,5835,29,59,55,84,59
3285,4fd7a57b9c9e8292a32470a55297c7d9dac1d5581346887bf65ec2f907d3d3ed,dropper,5076053,19769,39469,39638,59407,39469
3286,4fe0ee363c00d940229dd775b072ad887eefe18caf5e1519ed7431b361637089,dropper,527540,2151,4012,4037,6188,4012
3287,501275ebb9dabe93203ccf4d8aed748c097ffb3b4b5effe7f323ffae5c13ece8,dropper,5834,26,37,45,71,37
3288,50d8bd7160a0915c6d39da8ee3a863a6ba4b91198f1f22285ea3f04fb1f21ef3,dropper,5832,32,62,47,79,62
3289,514d94f7d1d958419fde22027cff1497088a18b0307e3b4f3227cee1a92c4d24,dropper,5834,25,46,51,76,46
3290,51c2529d9be7bed9e461f8ea26d3286a1ddc61ff2ef556c8c6bbe06de3386ce3,dropper,5833,36,57,47,83,57
3291,51e1a513e549d58ad4eb034f4f2e408c7040c49ef651bcf5e9b8d6700da04e49,dropper,5830,26,54,53,79,54
3292,5274846ccbc7664969b7af70f5d96a10f2b47cbea342fb5be8e7bb3a8b7933fc,dropper,5835,27,60,61,88,60
3293,52ed6c896266ef2a0c199eb1e6fd643ff116e63caff751a01c24e77d305bcc3c,dropper,5833,29,36,51,80,36
3294,534ee94173e96c06ac08196409f600bfe1fea4d2e8ed4a2efe9a42e260dd9e97,dropper,5834,25,51,60,85,51
3295,53d175a9b248b0d3ed618858e4de67ed93361b59a8c565de5e86b272b999c669,dropper,5834,25,53,50,75,53
3296,542826b221fa569a41b83abbd4104f3604939097aaa85f4b1b88c1f45d81bfec,dropper,5834,23,42,48,71,42
3297,545a279e824f286fc6372b136424451deab5ed25580ae056042df504b72ef0dd,dropper,580090,2304,4542,4663,6967,4542
3298,54c2f2e9319080501055c9562a9b4109c9cf4b1d1e8af1bf29b0bf57348abcca,dropper,5835,20,40,57,77,40
3299,54f6bc7713fd48078079756f2e57b16973b0a575779ca997d4498f6c3863699a,dropper,5834,26,45,45,71,45
3300,54f96144ba251057414348cab22a4626eb4aa0451ac555922fd029b284a63036,dropper,5835,26,65,49,75,65
3301,5517c3d0d96b6b98fffd72ae0f5e40f25c18b33f916b0d55842e38ffeef8ba20,dropper,5835,23,48,52,75,48
3302,5662097df0b8bb53e0c01b8f187a41f23c8a7b4ea67dd72872fa651849c1977c,dropper,579147,2357,4541,4691,7048,4541
3303,567dd085f048863c778b1825285f0a9c47712323c68fb6c059632834600b4dd5,dropper,5834,22,51,49,71,51
3304,56827bfb8df9729368a17be443306a81ebdfa0d21f3f77228c7585f4c465edd5,dropper,5834,27,58,48,75,58
3305,56913721c7c7ae9e2a5bb93f14d3d6f1546bdde20adbff9dff9915e09f254f0f,dropper,5834,25,46,51,76,46
3306,56a8cabca13d4644512473b134d92a511595c6f265fcff1a954efa6fc9659962,dropper,5833,21,55,56,77,55
3307,56fb16eacd535d2c0622d1c71952b770edd10e300fdacf2ae7504061069ca958,dropper,5834,18,49,54,72,49
3308,572bcc9d56c9684d64d4c033570b48a31dd29ef210a994d0631f635620f7297e,dropper,5834,21,48,49,70,48
3309,57571b02d39b457471360d454636d736ce42993a8fe37d4f23c3cacbfbfba969,dropper,5835,26,47,58,84,47
3310,57887891d74b05a5d80a914d2e51cf4233cc5d4e41d7c4e403ba245db22c716a,dropper,5835,28,40,50,78,40
3311,57f4fe6147585379275d1a5bebdf8d49f459140eaaf8ccf94c2076f60f106a8f,dropper,5834,26,49,55,81,49
3312,58057d2f591736fc6f96d168005cdff35518dd358f2f33a0cb774202b0b2fb91,dropper,5834,23,55,56,79,55
3313,58162bff55246db8909551175022fa74645ec71d72a94a7619fae7009efc9397,dropper,5835,23,49,58,81,49
3314,5832bd9c01dc8412c0f29f1339e4c674f0080001fd695abc842db76a00d0525f,dropper,5835,21,51,48,69,51
3315,58505cc4c3f35bf0aaf5519c3f0ede07a77e01072777d748f867e58370ae499b,dropper,5829,25,37,56,81,37
3316,593ba5fe30779292115a19d5502fa91c58dc64df524a9677a39a45331d054763,dropper,491955,1982,3935,3888,5870,3935
3317,59b6f43121e98e4ceb0d3a9526e409bbabb7eb9e1745b3b7746b3fe2a6929930,dropper,5833,25,47,50,75,47
3318,5a15d35b9f08b16413c3526af710c0d4288cef969281aa3f2f900058bcf6d414,dropper,5835,29,43,32,61,43
3319,5a193929e89b1f2ae1a17c9ff64e0990fa4b5f266d17060d401f26619fcae25d,dropper,5834,27,52,42,69,52
3320,5abfebd1be354dcc3c2254d410d4c7cb953b6079dc298e35a395ec0e86fc43a3,dropper,5834,25,42,47,72,42
3321,5ad9212269802dd1dc911a07867e92c15bae73a26825f3ed221b39ae41c6a7c8,dropper,5835,29,55,46,75,55
3322,5b3194df83240573ae6106b7e95469e73fd4a4627a987fa8f3f86ea813c6bb19,dropper,5833,31,51,49,80,51
3323,5b44d36b2d81c9abb425b6f5cbec6f7be63506e1efc7f61e7d44116b515ba20b,dropper,5835,22,40,63,85,40
3324,5bbe12b409c92a94746592b24daad57cd210b91e6bc3d1ef3b16ce42c3f70087,dropper,5835,35,54,59,94,54
3325,5bec0181cdcc704a3b2507cfbabaa8a3f4449e86dbbe9dd94e624cd316581736,dropper,5833,32,55,46,78,55
3326,5c440e307a2f6bcc2faa9ac5863da76806a3d3fa4f265e037d0e7e509c5066b0,dropper,5832,21,41,49,70,41
3327,5c652e6c997a1b1a0dc48bd23316c66ef7f4cfbc57b0acedfc98d0c1a04f0765,dropper,5834,22,59,46,68,59
3328,5cb3f1462043ca8de9fe26dd7355440ce4840a38f0d18d9eb7d51b4e6c7628a2,dropper,5833,22,50,53,75,50
3329,5cc75dc9a53716bab5eaef90fafe240c6e377855a1fb793c8472f2a4bebb0268,dropper,581148,2396,4448,4573,6969,4448
3330,5ccf635fd0af88d1eb2f61bdee92921476754e1825fa2c1183507b9f5de0e8f2,dropper,579088,2264,4459,4502,6766,4459
3331,5cdaaf7ffa17dc7f3500a1ff5099cda7c508f1d5cb0b16d26b15099e5eba9fcc,dropper,5834,23,46,43,66,46
3332,5ce1252c98dfbc25143d5ac3b47d6d0191a81cab39f37fd67494699550642c6d,dropper,5834,29,55,45,74,55
3333,5d158996fdc05c1028f0dfe65186bde5e1111145e02ea09052d39cfb09cde568,dropper,5834,25,42,48,73,42
3334,5d2b949fff3e8dbbaaea0109cfcb7409f2a59cf27f2122e071ca6236044c5867,dropper,5834,25,51,41,66,51
3335,5d31c46331e5e0d4f05b99b9802c715ddb6796125b48ba451e3c16779ca35ccd,dropper,5834,30,47,37,67,47
3336,5e159d2c9f7452e0167854681f8d11f365101751d996d9d056f45effc4f75cb0,dropper,5834,24,52,42,66,52
3337,5e737d848e7d63cc79ce0ec318f786b78c58968e4bd471f1dd05e19dfe472d47,dropper,5834,22,42,62,84,42
3338,5e9fefc262e3b12379dea5a589456f1081da8e4fbc0ed8d6301fc210113ed22f,dropper,5833,24,48,48,72,48
3339,5ecb45d15cc6bfe8f86787ddceedf538640e04c8130883031921b38ff525db7b,dropper,5834,23,45,45,68,45
3340,5ed63f53411dabb1704bb4134c8378533fc87018fa9e4af2c9a2e5ada4336f57,dropper,5833,24,43,47,71,43
3341,5f2facb9fa9ed310fc42bfcc8c9f4609cf1e0adb25a690a1490f617926edccef,dropper,5834,26,49,44,70,49
3342,5fa853807b194beb6d35ff2a9190678bda94162d3a37d257d7c3a54c97e35d78,dropper,5834,29,49,47,76,49
3343,5faaa51572d3d9ec46e41d2d93e07db97763514cb01135f76c52eabfd394b050,dropper,5835,24,42,47,71,42
3344,5fccc7f330474691f7e0e10a3e77cb04b3ef5e0b753e5ddb8f703db2c51075cf,dropper,5835,29,48,47,76,48
3345,600e061fde2a9807fc0bdee5dd51ce1a73c85c1d0e39c357e12d4def61726eae,dropper,5834,31,57,46,77,57
3346,6015cf4cf98c30bc3675192ff1114e598cf357bdf538fec4b42fae3f2b70449a,dropper,5834,23,47,52,75,47
3347,6017e173ad84c6e78aca3326d159184abe88bf2b63b36d718d3129394d9dc8bf,dropper,5835,31,44,54,85,44
3348,6053e6fb1fa580637a9eb7d975277dc8a7a345b74880c5f224c85b9d9b6613ff,dropper,5832,24,51,53,77,51
3349,607d84e005f68cc8cdfbd0c7cae3b75740297c4f84aa698ead901ab9b07f226a,dropper,5835,30,50,59,89,50
3350,60880078fa3e1df47e6a14e7140108e172457655f1a4be84241cec0cb281272f,dropper,1683279,6688,13201,13549,20237,13201
3351,608db67643858d1a114768215d94208bded5fc4f8c815a470b46070c32ca4405,dropper,5834,13,40,42,55,40
3352,60d7c504813c469d823ce2a74afeb0903c1cda12aef958a122fa1a01796c5a22,dropper,5832,22,39,51,73,39
3353,6105bd5146e19a0238ba185135d432fb4b29477ec922e5e597d8af0a6aa1a3b3,dropper,5827,27,51,48,75,51
3354,61ea36aac55cd3e6a6b4f569ea2bc9f28a11ab21a59db172779949b31cf56f3a,dropper,5833,22,47,46,68,47
3355,62459328b6cca5c0e8b7131d46fc9e706502c6fc8a7cd21bad6e4503156a8e88,dropper,5835,25,42,52,77,42
3356,6275e188dbf759379db2a37c74cc73a140043ae3161b08a1f6aa6175d1c94d2a,dropper,5834,23,53,58,81,53
3357,62b4408cc6019e8af0553872feab784f54febb3e02b56cdcbd9c7034a2b6924d,dropper,5834,25,42,52,77,42
3358,62f05f1d30fa017f24dac26012cfd84f72bcb9f4187fdd3ae35faa7820ddbc03,dropper,5835,27,53,54,81,53
3359,63363758a62fb20240ab8127dcc5f34fcd28538b732563b8f671de380592f4f6,dropper,2012168,7922,16024,15959,23881,16024
3360,634252bd6b7e886f5f42f0bd72f35c6458cd838e9b31a3f1180ad519cdb099c6,dropper,5835,27,46,51,78,46
3361,638890dcf552cc15b8d4752a5c36fe5fb4271ab6d382b0d95c4d3b3c4c1f1b9b,dropper,5833,26,54,44,70,54
3362,63e0fbfb2bb47312a5ae6cd9b3f55db2356bd19168f58f40ead0864a7df75bb2,dropper,5835,29,53,46,75,53
3363,63eb6da84de606c797b280e51451700c0f264c706434d5fa3ef080eaf108fb62,dropper,5835,28,50,45,73,50
3364,6472029b06b5fdcbdc7a41d7fda44a0d721f1d3daecfcc18f4cd517028700028,dropper,5833,25,66,39,64,66
3365,64b6ad352039febb8d9fce73ed6abd38ff05640e3529ab132a5378a4b714d734,dropper,5834,26,53,52,78,53
3366,64c05e7ba0f154a1f4209634320437ee4dbcf148849656d7fd4c6f537395e0ae,dropper,5835,28,38,49,77,38
3367,64e79ca0b679580693392f0319939a4c374f20ea488df3cd6011ea27cd5a5b85,dropper,5835,29,55,45,74,55
3368,65392b6948a7fb6dffe8475679eb9a3647dee9c6ff4b521a3fd9b24d3af505ff,dropper,5834,24,50,47,71,50
3369,65766f13fa2b4a956bbc0d00c2cf2568a079fa1d32347b895bc827fe1b7ae4ae,dropper,5835,30,44,57,87,44
3370,65acef46505d0d93d19471eca2d2f7a144d92ae3c6c34ced86ee70a900bb27cf,dropper,5834,24,44,54,78,44
3371,6732f89407c6952d188609faa7c86acae1df7bce0946a064fcbb4124672b9d40,dropper,5834,22,42,56,78,42
3372,68514d5cb0d866353e6372bf29b2573228d8235f67693895bb9dc2ac573c176e,dropper,5835,27,44,52,79,44
3373,68a6f596735e10c6de8adc2d6883095d9a387f2150d1b722a2d7f3b9cdfa3e27,dropper,354432,1424,2877,2807,4231,2877
3374,68adbc03f3fbfcfd6ff8635ad1b150559fd5fe0ab103a55a830bda575d33d281,dropper,5824659,22314,45815,47760,70074,45815
3375,68f487397fd28b4a3e3eafa4828f503db7d4a5ab9ba691f66309b6789f2b8c53,dropper,5834,23,40,45,68,40
3376,69560a7655623ba6a658e84e0ede10857842385a21d02d93a376fb4f008dbd8d,dropper,5834,28,53,55,83,53
3377,69855282eee52bb502fff80d917848b1df0cbf384e4a74a8ce96e6d53e67a6a9,dropper,5834,31,40,46,77,40
3378,6a527d4ff66aab6f9295accb4e325b529269f2535fad72894fd33d6381e1fefb,dropper,5833,25,66,39,64,66
3379,6a5f98e13ad24aa77d9436d7ab9ee8554b81c549f31c5c9f30ebe5cddc1621f3,dropper,5835,19,55,53,72,55
3380,6ad531729529803f863ef955e6e71c9d230169cbde7ea543f7f1fff6786ec249,dropper,578782,2248,4510,4584,6832,4510
3381,6ba114a3207a31389f85570043b795c0ff12a9839b362882b5a3397fbd4999b9,dropper,5835,22,60,53,75,60
3382,6bece4f317585845d7dbc335ebf488f0af78aabcc4565d9690aa8155a108490b,dropper,5834,21,51,45,66,51
3383,6c2d16787d53fa63e9ff7ac14dbc8433b11ebc43e7af8d8623e5a402eba820dc,dropper,5834,28,49,40,68,49
3384,6c435b572c199d22ef674789e558cf6237cbc74d7f38ecf6f0e95b4e6db5e26d,dropper,5830,30,45,50,80,45
3385,6cb08a8c793080e1709510676c1b24d56bdad9e1f6147fac9aa0f1962486a2d0,dropper,5835,32,44,50,82,44
3386,6cc9ed007e3b44e7be240138bb87b60ae0be1aea8027697060d351a6d3dbe0fc,dropper,5834,23,38,52,75,38
3387,6ccefe520c291b195388fbd93922a0f7985ac6efbce8ab9085714bbaf42d8963,dropper,5834,25,48,42,67,48
3388,6cec4e195bf5db964d082b75fb6c06582098661e396516a0e7d1c8fcf168335d,dropper,5834,20,60,53,73,60
3389,6ceda96cc156257ceac1f917bb61f2a37f90152f2ec5e3bebdd68c9c0928ebc4,dropper,5835,26,36,36,62,36
3390,6d036e7aaca2b7e171a6f6a550f65839e3dae15ca2391c9d31eb9b1d7f766ecb,dropper,5835,26,43,47,73,43
3391,6d5881b8cddcd324a843be7e405751684f9fdf69a49366fa6470ebffb2a45d77,dropper,5834,13,40,43,56,40
3392,6d9af11917284f71cdb26b8d871683c7797f66ae164677be7ead10fc49fc54ea,dropper,5834,28,62,54,82,62
3393,6de77bb001db6a0576f1e5b5088cad155c6e3150c78ab31fe2325ae5e538d23b,dropper,5833,33,57,42,75,57
3394,6deb4c8a3193296b8b3db3e2e394af977336ab7f8d4d7842ad343804f6d919ab,dropper,5835,23,51,42,65,51
3395,6ded7662bb7c8df0a3b3ef36f2cdad52992c500c88640594772f1a7166a848d0,dropper,5833,32,60,46,78,60
3396,6e106c41f6550a9f6aa4982078710f93772aac891ea6091881c6c3fb91a3783b,dropper,5835,30,51,45,75,51
3397,6efd75ca03dea29a266964a398259efb2bcd16805cf5326ef4607f600c77286a,dropper,529706,2120,4243,4206,6326,4243
3398,6f39cc9ac77ab2367f2476df8ba8006b7792c13ec641e3c090a97e4c12e0d46b,dropper,5834,25,51,41,66,51
3399,703460fd9b63018325491129f3ab571b1e79c4662e983f811853d8d1cde5b0cf,dropper,5834,25,47,56,81,47
3400,709d648570f0098df3a278a69227dd484fd27c90dca0daab223df3ff4bbaacd6,dropper,492068,2009,3935,3876,5885,3935
3401,70cf5fd7218578ed7f651ad8b7ae7325b19102215bc577130d4ea0cb583fe22d,dropper,5834,18,43,44,62,43
3402,7164f9037e214ea8230b3d3ff50509b74d7da7a5c7244f0dc0337da07ece6fb2,dropper,5835,24,56,47,71,56
3403,71a0c33b7071d445885c14bd8431f0c644b806faa24963cab4fe390852000dd4,dropper,5835,14,53,34,48,53
3404,7251e63d19f20a3bc690dc3bc7487deb6a31aed7f25cb05a3c0ef263106c036a,dropper,5834,26,51,52,78,51
3405,725220231fe4f0e08ff1e79fed022d9e3242e0c81d23a87a660215b0ba9d8344,dropper,5835,22,61,53,75,61
3406,725b549c1e62e60f645e9ea1254a96729f1bbec8f9418a4a6c04b79f37cc8500,dropper,5835,27,46,46,73,46
3407,727ab27c444cb16aa3b42446f0efef30e25347828e5ab1a02ce102e42a5f85d9,dropper,5835,25,55,60,85,55
3408,7292a6a3f6f060303881b77921933b6df89bd51072d6f420eea435ce97f83d95,dropper,5835,28,52,45,73,52
3409,72ad00f66d273bb82d2cd2c267bd9ec129bcee7eb3ce0c3ee2e0813063f17de5,dropper,5835,25,43,51,76,43
3410,72bb47776c824e5cc8798b63417d8970162e29139bdaa4c8595512f16ea88213,dropper,5834,26,64,42,68,64
3411,72beaac774a65cb88befbe863d67e73d281faf9d7dcd10126633553b4c5242d4,dropper,5835,28,49,56,84,49
3412,73315090a1e3bedef86d4b645e2c8b824dd96ace303184611e8c463ff2eae1c5,dropper,5834,27,31,46,73,31
3413,7374d8754076c52c0a4aa4d442d8b4c8fd535c34ed9db395049130b63d56ddad,dropper,5833,26,53,42,68,53
3414,7375ec0d19f0f4f006f09f9d979732af67d0b32f945405cd24d223664d38acdb,dropper,5834,33,48,43,76,48
3415,7393818bcc59e9837e82e063f599e30e4f215a929e068da11ba55299765f08e2,dropper,5834,32,54,49,81,54
3416,73a098c6bd968fc3b36d652344ca84c0df48e04b3dd7d5b8e920310a3c0faeaf,dropper,5833,25,47,41,66,47
3417,740d6d4126e824c8e06b80a398d6e2905b3da23ca502c5e440d50da28b35648c,dropper,579311,2351,4591,4596,6947,4591
3418,7419b59fad17a94d615635be9d2eeb9097c319eaf4b7f9904e4814d9655b43b2,dropper,5835,23,50,60,83,50
3419,744db3dad4abb847911c7824e464b56468955fb1d83fd7d34321bef81cfc1b74,dropper,5833,41,36,55,96,36
3420,74977c2deef907ea03c4f671b93278ba52be78fafac305251eb0153ea33e5037,dropper,5835,27,32,46,73,32
3421,749a80542756b8770eb78761d29472051473a8e5c5e0acb7246f838b216359d1,dropper,5835,26,37,59,85,37
3422,74b7482459fe8d5e24f1124d076b66d14ce59aea8aebab86306b31c21fbdd86e,dropper,5834,18,48,43,61,48
3423,74ff2c9917408cca3aede39c85ea6b55d8627d25c39fcde9bf336a9c13b344ef,dropper,5835,27,60,47,74,60
3424,75736e0f7ad4ca84b2d85f6e7e2e4784f755fac1891dcc27ee93c26bf918a41e,dropper,307177,1219,2482,2411,3630,2482
3425,75dcc776f65777126dbb5d189f493392a85d21bbd770dea234b02b68366c5ca2,dropper,5833,28,48,59,87,48
3426,760167832126030117411c7abdb3986979d771e4cb09e150f4ca5ee61d4713f4,dropper,5833,23,45,61,84,45
3427,760d7ca3ff7dc17414bab52b5d2564b8ae10f8c0bd254f8fbf16213e8272148c,dropper,5834,34,58,48,82,58
3428,766ef8cdb9d95ebcdf19648d174f63225d6183ee72547cd96136d6c0a93502ec,dropper,5834,33,46,42,75,46
3429,76d4a46fd1c5e55bfc0fd8d4e9bc8908d9ffa1a08e7f14e0361fa491fc302bee,dropper,5835,29,48,47,76,48
3430,76dd9286dccf1582833e34fcb3e4769cf7b8f5919c5d1f284ca5ec3035965aec,dropper,5835,28,32,47,75,32
3431,76e352b3827351461e540487d1a1c8b04c8acfea235731348a8804da14a0b5ca,dropper,5832,25,43,47,72,43
3432,7766c2c4b67e0ef49bf4cbf1757e6c98b377321fdc69b41eb815ff728d0fc4eb,dropper,5103881,19287,40613,41306,60593,40613
3433,7774513c8143d4746bc8f20b99922a7fa10b257ce860c14b23d4925259e847ce,dropper,5834,31,33,45,76,33
3434,779dd7f857116f347663a0e8c680a4cd1de0124a7e20f62930fc6a9095c961d7,dropper,5835,24,51,39,63,51
3435,77aa111415e3a63bd49c1997ee4ba8416fafaee042224b7588b7632de50efa98,dropper,5833,29,49,47,76,49
3436,77b5aaa343bc758f953aa1903f0bd8c185be12735ba55f4dcd2dcd36a181e692,dropper,5835,22,47,51,73,47
3437,77b8f583be00f7d26d642ecd278ddd09c028d1f656ae56eff6e0652a64084554,dropper,5835,22,39,55,77,39
3438,7808e956c26a39c7feeed0e5f85a3088b298e6f02817d0b356f653459d040162,dropper,5834,27,41,41,68,41
3439,782c38514d8c1b325620fda65a00e9fb48583b41bd979c4997c3c9ec48110398,dropper,5077323,19967,39699,40039,60006,39699
3440,7841564612771f97e7bb7ab11050bccb13e69f76092b047a2280b9611e31c6f0,dropper,5831,22,38,48,70,38
3441,787d9ecbc2a29d0c50d2bbcaf3870a1ae9a654b86afe59e342494b74fe6a0ea3,dropper,500168,2039,3992,3935,5974,3992
3442,78b0e06f7e9e517518b3071fa2605341e412832c5fe951b85b8978f954265a6c,dropper,5835,28,61,55,83,61
3443,78f7bb988c4b02d9e739aa8ba08627d902342a870ba72293c33f3814f11ecd28,dropper,5834,22,40,49,71,40
3444,7968565ad9f437fe483fc9638ded81a0cf357f5cd9c984e9664d41a5cf83bc94,dropper,5834,33,47,38,71,47
3445,7996753c1eb29d97ec336edd793ab314ee6e3f3d65515542c6c9bb60f5c807e8,dropper,5829,24,45,47,71,45
3446,79c7d9d65892dea1a0c8fb21397e069fff3ecbafdb9f51186bfe09aea4939af1,dropper,5834,23,43,51,74,43
3447,79cbe5b96ea8243e44d3cb96eb8e67fecdf9f57e9b4d614abd0c38062a966329,dropper,5835,25,44,47,72,44
3448,79f2056371c61868f03e91ff23bfaa52a456fc9212e35123d7922840198dd528,dropper,5834,24,45,51,75,45
3449,7a0c7989bd626aadf4bdb12066d519a646af25d93fd4a7e545e97bb4df47d827,dropper,5833,21,50,60,81,50
3450,7a3c086e9bea5354f15eacbb11f261431ac55da99da6ed9cb0cabc6a01173c38,dropper,5834,23,45,49,72,45
3451,7aa955292333418f6dea1b84da6a7199fe29596e9f45f3d038319e8c55a03588,dropper,5834,25,52,50,75,52
3452,7abeae0fde4d49a89e9e87983bf7f44224736e5eae13f482bd4edefaf3426142,dropper,5835,27,32,47,74,32
3453,7ac104ec6a7d3af289eae3353a3a5f6eaed68f0190bba5e430af98c8ba22150d,dropper,5834,26,46,45,71,46
3454,7ad6da67589c20fc5d3a0b6addc9d1eb98b1ee85731e7b976a2a9532aa2c084a,dropper,5834,30,43,50,80,43
3455,7afbb27ffc27cb1ea50f1663fbb6c97a9e594170ac821269f7049a23879858b9,dropper,5830,24,65,52,76,65
3456,7b284ad81fcf5a723343ef1b1d5b24893f354e4338753f8c80369b05e3dc53bf,dropper,5830,27,37,48,75,37
3457,7c92f63cbf8e514a7848e4d5591d91359848e26c4a3d5e87c35fc166be330313,dropper,656626,2687,5129,5298,7985,5129
3458,7caa52dc9d84765b452b107b435c9825180a6fe08f21fee3fc16767088146eb6,dropper,5834,27,46,51,78,46
3459,7d1b332164591613a22ac90d57d39d44d4517528388ffda4df0b200feb694f30,dropper,5834,23,51,59,82,51
3460,7d5878dfbdc3494c1b6d33fbd10eccbfd8d0f4e759e74e5c6352fc3e8f93802f,dropper,5834,28,38,48,76,38
3461,7d6b241d1e671819b271a878a036a37e2d458fb2a57367593763c17f04b1541b,dropper,5835,25,38,50,75,38
3462,7de05cbc442e6cdca07b65563321ef08a6fe3f722d83f012dfd562e73acb3789,dropper,5832,34,50,47,81,50
3463,7dec341ecd8887a9bba181d05d0e78be7ba9d879a1f3256ad7ef32c4e797790b,dropper,527536,2141,4024,4037,6178,4024
3464,7df99f038ed975129e9eb9709980dd4e20ba575c2302137668fb56d798a55e1f,dropper,5834,36,45,51,87,45
3465,7e4da441b111967992ce0c2002447eeba268fbc3e4763604024f5bed33526449,dropper,5834,20,41,69,89,41
3466,7e5fb05e25e1428d6959a241eb0faf81364e16603a78e9d23df1271f42b37c5f,dropper,5834,26,53,45,71,53
3467,7ed3a89402ff1d263e8ef6949a172308683e1bc8cc0b334179975e09840c5771,dropper,5834,22,39,51,73,39
3468,7f02c31b65e5171772046bb738756f104637b1dc621ab1f46c5c620c98116186,dropper,5834,22,48,45,67,48
3469,7f3a7501093b23365cc0bb50cc821553c04f07814dc7c0b877f90c71c87e8270,dropper,5834,18,41,45,63,41
3470,7f487ffd45d097d4720f66e761fe824afad6ca164230ab78a673d98465a589b1,dropper,5833,23,48,45,68,48
3471,7f9ffa626dfeb941d03b6429c65f3ec11833e53d73aa796a9052e601ffad11f7,dropper,5834,20,50,48,68,50
3472,8003f981c1ab7bc6c51398e00c8df59ea79e625667d934673653af25733e18be,dropper,5834,19,48,54,73,48
3473,800fabf9329655d812f48bfd4868505feda54e91679c6f023f5b878f03263f64,dropper,5835,24,33,57,81,33
3474,801580f98ed1887b9450b6f2cb00b8d5e64732e37d79a963e80308162176c34f,dropper,5835,32,60,47,79,60
3475,80196ff4eb51aa3d630b4f028ea702f7bc502d1dff26fd758748225b7e746197,dropper,5835,20,41,42,62,41
3476,8086e3b90457b52c25f3e5e9c31aad45466e3ffbb27507d15d647d9e21ab994f,dropper,580093,2293,4549,4688,6981,4549
3477,80c650bf726e3e00b77afe0f408a6ae72a7e2226e55a78d20f908babbe0dca06,dropper,5834,28,53,42,70,53
3478,80f1fdd54acd331d829fccdd5d9f413ffa8286cc39647d8a060b4b1fc0b56233,dropper,5832,22,60,53,75,60
3479,815d74363888d873f84d5ea088204e8167c6ba258c33bb75be470fdf4459f2b3,dropper,5833,23,62,46,69,62
3480,81c3eadfda441789e19b197e57c6faee76a3a662ed9fb0be5b34239281351425,dropper,5835,25,42,53,78,42
3481,8209c6cebb0e8e21e136b0311e5e127ee4e6cb51076f23bc153d2e3e7622c327,dropper,5834,19,42,56,75,42
3482,82122128538c33e0608121c3c5bca55ae545d038f9299c0ae76d2f2d6a2fd911,dropper,5829,24,44,47,71,44
3483,822a5ac5d051f9f129773c9eb334ec5c8619143cc6bf647fcca97cecd1cfa37f,dropper,5835,23,60,46,69,60
3484,823e901f5e2fcd3aac79657ca449b67b549596e632ef2485f6d20a9c66a16110,dropper,5834,30,47,43,73,47
3485,82504e346355bbc1f743361fbd53c594f053ea381d433f05ab830e14eb730f7d,dropper,5834,23,38,53,76,38
3486,82856fe98de5d57f07968137e3ff339e073d1f2e7b97ca92ee163766668235c0,dropper,5834,24,40,53,77,40
3487,8300dbee1082f95ea625f7afc30957e608c6018e402470a1ad5ea4491776622d,dropper,21159,69,168,148,217,168
3488,8334c3303efdec335b79c656e45b8ecc53a96fc2d740b07411def5588c39bb00,dropper,5834,28,53,55,83,53
3489,83414314966f48e6424e1d23b6856ba24f0382399f2782195d3c7c79ea86721f,dropper,5834,22,40,49,71,40
3490,83506178c0b244074340e772ab9b8d9f00b194ed121514a4f0c27733306a82e9,dropper,5835,26,58,40,66,58
3491,8373469c506cca527fd7e549196811bab77bdf4f3bb50d8391a911b3dd012653,dropper,5834,26,50,53,79,50
3492,83b828331aa0135a67ec6ff234d955f8f402cbce28abf23af3cc37c58949b18e,dropper,5834,25,52,60,85,52
3493,840babf888d90cf02fc24814149524866d056e3bface06622156980dca9a30ff,dropper,5835,34,50,52,86,50
3494,8453fca01378787bd99676e8070bc68fe788671fda0b005d487ac1ed219147f1,dropper,5834,23,48,46,69,48
3495,84c7fa9aa741bd6054fab54a62c35a29a37be45d25bd3e78deb3c74ac934ef5c,dropper,312825,1267,2492,2515,3782,2492
3496,84d616b7b0e2f21154c48cf5451aa78df0a9d9f901be804b012d2652f055cb3d,dropper,5834,31,48,38,69,48
3497,84efa9551e75459a7a9d384ea7bf137731d20915f3f3f8669fb57fca1e753aef,dropper,5835,27,60,38,65,60
3498,85084ae1ffae7b232e59fa5707169135735bdd4422b81a5e578ab22df956fa43,dropper,5834,26,54,45,71,54
3499,850ad6ffb7e9b4d972426d5cf399044c193ade2dc9042a482245ea360036e867,dropper,5832,20,39,43,63,39
3500,851f5eec84cf9b8f2b7f404cdf65d9d8df8fb0a73de7c616195bc8a8c22181a9,dropper,5835,29,46,34,63,46
3501,852a9e3d33d415d818dc263221de37f082ad179dbaed07e2f3bfcd8ae9d2a130,dropper,5835,29,48,42,71,48
3502,856965195cd6357fd66b87a1250c92fd5d38625c9ccfe2f8c2f84c4068d618d7,dropper,5835,23,42,56,79,42
3503,85c841f619391d1463bd3ad17b3cf8225307c9bb3a9238ceee608bf406737ca1,dropper,5835,14,53,58,72,53
3504,866bf6ec8a1e9451172120412492a5717330c6838fa686e01d1e8ac073797a66,dropper,5834,26,52,52,78,52
3505,86b6edc234f8877c54729607adec5b90c7e9363ca32494ec30a5625ccd936fbf,dropper,5835,32,51,53,85,51
3506,86b7cbabc007d81883383077844217262e83a05236f957db375db6cda0fb5491,dropper,5835,23,44,36,59,44
3507,86b994cac5a6574bcd3045e2f1abe54bd08e52ae75adb970419ec4625d2a3f91,dropper,5835,29,51,54,83,51
3508,86cc093911bef2cf1bec097c9134429cddf26e00564e0a9078c8a857a46f8037,dropper,5833,19,41,56,75,41
3509,86dd086d31d31451c923e7761251156cd8c24d2f3313f1808870b72b3fece8f6,dropper,5829,24,47,49,73,47
3510,8711b1b6f0b9171c28ff05da6a8f95c80a8c698e3857a63fb0daeca8c9ec78f2,dropper,5833,30,48,53,83,48
3511,876b87fea44d9c4bc990a36caf59d4637bce3c0a74d64eafdad5d5f87d8ddbea,dropper,5834,21,50,59,80,50
3512,87e887aa6526a2608132da69672d7bc528b035d283a4d8d92b99c17a0f501117,dropper,5835,27,61,59,86,61
3513,885fa11e5ca865340617b91e0c1ffcd7a04829917f7bcc04c0860e023e88f207,dropper,5835,17,44,52,69,44
3514,88ef4ec822f8fc1840970ebe27080033e0abe6eb3f8dd9c12eb49fdb43a6a9c1,dropper,5835,29,55,48,77,55
3515,8927da7192a52e8da22592272ed2d15eda43527621feb5d337ea4a11e2a384ea,dropper,5834,34,56,48,82,56
3516,89402bb69188b4b19eec235d77919782d5b58d1ea970ccb2da7f9c796e6b65d3,dropper,5834,29,55,45,74,55
3517,895d4a5bff20f6a469eebc136e2d017a88387e8860683de5a3a36b86f72fd550,dropper,5834,26,43,41,67,43
3518,8999daa66e2fc382c62c01d957e368f452eb467f066939a735e1829d2637c2c2,dropper,5834,25,47,42,67,47
3519,89c2bf1d29f9982404fa55efe119ef91f973748cfb629047c7c3fe06d013eaf4,dropper,5833,29,38,50,79,38
3520,89cac82099492202d8ec9214281e8a08e6a610e24646da3cb162464e5b96d836,dropper,5835,32,48,60,92,48
3521,8a2347bcd7bbcb660a29b7d6ed9505ef302345e64af3ffbb3893843e3475ef38,dropper,5831,26,65,49,75,65
3522,8a2ec4ee07a73b7b65f4779ef238ef6e775de27f02a51c8b298364b3f3b2844e,dropper,5833,22,43,48,70,43
3523,8a935957e03a68e3e59cc5f66f0dfc62c3dc405d405728ad8b174ab71d97a87d,dropper,5833,20,45,50,70,45
3524,8ad4ea54eae9774eff5bac71aa4ab3d823041b6d03825a1adab1ebe0a42e2c30,dropper,1580629,6113,12745,13389,19502,12745
3525,8ae92a3fdf5956d2cc56b4f5f26c27c77e3b91847148f0487577d55c02434f8f,dropper,5832,26,54,52,78,54
3526,8b060a6236e8dbee3645619eb0f689b5ef307f3a812559e0afa91833fb2d221c,dropper,595297,2330,4705,4713,7043,4705
3527,8b21d21e84344dade7768cb934ad42e3a6decdebc5a47d12d4b21d431c5f7124,dropper,5834,25,62,38,63,62
3528,8b68f97284800d4356a2ac0857b750ae88c3ec6d2cc618b7cc0a49b7075a6e0d,dropper,5834,25,47,50,75,47
3529,8b8c152061d5dd04b3583c2cbb00a04c8c86d8fd5ee054637deade71800f46bb,dropper,5835,30,48,54,84,48
3530,8bc409d513e5b64ad5363030ddb489c4c5c915538881fd9f906a225dd7f46891,dropper,496516,2019,3986,3911,5930,3986
3531,8c41a07152bd4aab8bbf5180e521924431dab51e041741abec7006f6bcbf76da,dropper,5834,25,51,41,66,51
3532,8c46d832c3927b9698b737310e10526681c32e09537197c0613305450cccf90c,dropper,1504096,5978,11791,12014,17992,11791
3533,8c56a76cc54b3c56af7c54644c11440f2a1ed6cb787c5047b7350deb65911aaa,dropper,578511,2386,4547,4501,6887,4547
3534,8cf091d64e26c8b4fca3654932740aef88e1355572265bc5afc50e6238f16164,dropper,5833,32,50,54,86,50
3535,8d5d17f72fc32cfd838e38e2821e6341fe5a3296b8006d83793de1f242a53396,dropper,5836,32,47,61,93,47
3536,8d732836ccea1d64462719c7f7bfa6f5ad883d9986d951b9ecaa35629e7ce7fc,dropper,5077044,19876,39549,39628,59504,39549
3537,8d87df7e510ed4b29ab5099f4384066f8390f9372c509ef4f6f4aeec1f8f82db,dropper,5834,18,56,51,69,56
3538,8db8d4632ba278b0b692153b932b6e70c4e05d341a8dbd5fd1f6f57bc891e439,dropper,5835,29,41,50,79,41
3539,8dcd3773aac844fa52d4577a6c6040c8dd18954b3fd1f0a0fdd6ad3d6e620c64,dropper,5833,22,40,54,76,40
3540,8deae19b28a49514dbdb472c5ff4f4c48eee1eea043640937ddbe2b4088f9254,dropper,5834,27,47,40,67,47
3541,8e18ffc565944d63b511453486a91bbe719926d95addd2483b1ebfc2340e2836,dropper,5834,21,37,47,68,37
3542,8e7ca36fb9f3e1f8f2b9aba88837ba992b0342f80c818ce7015b8fc397818b17,dropper,527475,2191,4180,4162,6353,4180
3543,8ef4e1b77fcf61f7e73c7aae708173d36dc74642d3dec160c8d28fae4d7374cf,dropper,527534,2139,4008,4028,6167,4008
3544,8f35f78d6351f25aa5d0187d8bd1b65cc8b5c3e9c02260f20470d0b54affdf7b,dropper,5835,20,42,46,66,42
3545,8f6b9c69ef34b9e691683303b8c53b047dcb3bfd5c41148a676a4cd99215785d,dropper,5834,26,52,52,78,52
3546,905182bfb0ca71729b1c65585fcf622202085ff64699b8171c3a2c86768d282c,dropper,5835,28,50,42,70,50
3547,90543f7f97d0698e450cba6c736630fa5893e73466cd5b21b679f7f331fd8c80,dropper,5835,29,48,47,76,48
3548,9077a217e62a3da401789fa1cae70f502ead277ab173a7bd5341582a60591b58,dropper,5835,33,65,49,82,65
3549,90d50ce0639e5bfbbd8f3121f17ceeb807edddf87df977cf90ced35099901492,dropper,5834,25,54,50,75,54
3550,9105a2ae36bd867c9421d8688ecd3eb12ccefd33ced6d63ea8e56d058b923aa1,dropper,5835,29,49,45,74,49
3551,915324afaf3fabcafbffec76e962846c4dbc6afc6416c7a5105dbc2edb4273b0,dropper,5835,28,50,45,73,50
3552,9154def4a9df46af28f9c7a4bbd4023f02bfd7f946fe9ef379dee642ba1dffca,dropper,5834,23,47,63,86,47
3553,917e89c6888362cf5f930b95ce8ffcea356d26f39f555af67c55e712bfa301f5,dropper,5834,26,50,52,78,50
3554,919ecefb198a50874d20b41a99e82735765bcfd24464c3e16b15c436a71458c3,dropper,5835,29,49,55,84,49
3555,92008bdb21cc888a58ce6292ddb81a0eaf00fdad9d8ca8aa23f945446e364496,dropper,5834,23,50,46,69,50
3556,923dfa9a2ae3dc7883494428255e750490f7933a4aafe93416d512a9b21cd571,dropper,5829,21,57,45,66,57
3557,92a225800ce021da43f14c80cb462c87654af8e5351462adc2e2235c98e941d7,dropper,5835,25,51,48,73,51
3558,92bf911b04fe0e64c1714a249f96bbdcb39cbe43f84529bcbca4019cf26c3714,dropper,5835,28,43,50,78,43
3559,92d481df840e3007d7d1da12da48cf49c631db7b9d61574c3e949fb9191ba7a9,dropper,527540,2147,4017,4032,6179,4017
3560,92f9740cf398dbe10caa8198e22093e9bd59cb6158dd7a1ff96606b9094a1386,dropper,5834,27,47,51,78,47
3561,9312822fd724e9874da5a1fe290c7427dfbec24864aa150ac065529c72d6d414,dropper,5835,25,41,53,78,41
3562,933f3787089fbd3d227fa77c6c5b1c5c93053ce83df662f172755ea9415f5776,dropper,5834,31,42,44,75,42
3563,938fa75ccfc3830a4eaccceb52d0f0c99747f96c6dbec6eed7b92f1e8b38373c,dropper,5834,33,46,35,68,46
3564,93966bc57e210910a2b0a0d67e601f42c695b62c25c7cc80d2d193e23955b609,dropper,5834,22,44,50,72,44
3565,9401d6b8808f8d3ebd1d2a8b754f0d7be4ba7878480604008decc98e206a174e,dropper,5835,33,61,49,82,61
3566,94306be4044c2f58ff9fdb2f6c5eef501d3e27ceec69274becc399b9c7103bb4,dropper,5835,32,40,42,74,40
3567,94415ed2e6f6f0036e3df246c3578dd93768b5a6d260543b063a17fd936e22ca,dropper,5828,26,50,44,70,50
3568,947c00a2654946e9ce1212fe13c5f2747579058f88568d649c77a70d47e2250e,dropper,5835,23,44,35,58,44
3569,947d776b61e15c7f0c991c7c2d76dd81719d6fd4ce2c512f302baf85cc229cfd,dropper,5834,28,50,49,77,50
3570,9490c46f080a187c3827152283de10f5fae687370417c1927f57aa4513a56289,dropper,5834,19,42,41,60,42
3571,94d82dfd1194a3f8e38af57a3c21b51159c9aeac6ccee761c7d3bd8df78d71fd,dropper,5834,30,46,37,67,46
3572,956f0482061946b09a587053caf75cf961469933d264ddcd3e0a07afb40c7c76,dropper,5829,31,44,47,78,44
3573,957ec9c04a74a39e52e090d275cedb449021bb6ef40cd4bc5580764fd01b5de3,dropper,5833,25,54,50,75,54
3574,95b16e83329dc897161d873466a6a52571aebdd71f66ee2a1befdf81e3cb176e,dropper,5835,29,59,55,84,59
3575,95e2571b984fdee174921645b88ff41db41e0d54cf0a2c8d28f53cd8f39b9987,dropper,5834,28,47,46,74,47
3576,95e26b7389842fb439b472f96157c34b0c7aff3e78ab486f38019a469f290555,dropper,5835,34,56,49,83,56
3577,965c12ba3af1afa99cc12a853b98f86c8e6ecf858d1af4b3f9c36cec58ca8add,dropper,5830,28,45,44,72,45
3578,966436be9e23f2094213aa3bca2fcfbacd801fbd9235d36496edb758fafa1bed,dropper,5835,26,45,64,90,45
3579,970f41dfa79649fe593431b6aa0b0983624f67d423129b55a9605786240bcb53,dropper,5835,26,51,51,77,51
3580,976d0589d4a3f4417dc24d2c14f1b06aa793b773b16c775704254cd370f6b517,dropper,5829,17,51,49,66,51
3581,9888222502fc1bdaf120e60d42608a7c63d551d39de4a4433ad51b2b6e5920bf,dropper,5835,21,47,52,73,47
3582,9892a63cdd84c6ae7948e5c225ea49b742e0c659d3d7b2d7af2451a40e9a5e38,dropper,5834,17,47,46,63,47
3583,991fdec4d6efbe369d23694dfc2d34563d7908d97aaa5f3f8a39a69792e71e9b,dropper,5834,22,50,50,72,50
3584,99325c5882edd90eb8f91d088015455fd4abe0e8402658b8fef68c94718adc57,dropper,5833,29,40,45,74,40
3585,9946b52530844750265368cd5e878a4217341a0c8368a93c5470eb0490720a1e,dropper,5834,22,45,43,65,45
3586,997467aad18118b538d54a55e93d47f67b2c158402dabe66d7d24cb08ad076d5,dropper,5834,23,47,44,67,47
3587,997f7832a66d2686b0322109f05e6189152a6d7e3ef892e11b841c15e9bb9810,dropper,5833,26,43,45,71,43
3588,99b93a3c0849d2f4e824ab3586885b2e68bf40ace87689b70016e92ccf5f1c19,dropper,5833,32,56,51,83,56
3589,99eb56065bed03fa969f3cbaeeb9db744c52f4614cec81ea4fa88fbfece48f03,dropper,5835,30,43,41,71,43
3590,9a77e248639c36630117ca6cc85367ac157e2dd434eea6d489cf630bc5a499c8,dropper,5834,28,53,42,70,53
3591,9a80ddd987658d1eaef5597454e7b7782d28101ed20c4e34eb2b6790b96435b0,dropper,5835,23,50,60,83,50
3592,9aa28936a2411b2f051ed0b3c1b6fac4c58a84ea8fd212dd5ab58075e9346564,dropper,5834,26,53,52,78,53
3593,9af337c654d0900e8c8d7f5db535303adfcad920fc18f1de0a94275a51843541,dropper,526907,2040,4065,4122,6162,4065
3594,9af55ecc2254cfc787b92f2bceb949158b7c5f1717b59051989d54d980e78832,dropper,491770,1993,3936,3858,5851,3936
3595,9b0246ceb07b0341dde2cdd707328b619b391a16f49be628d1858217b53105bc,dropper,527489,2100,4082,4192,6292,4082
3596,9b66823ee35f77a0a18ebd295a0c35d7d371698995cdb0a35fbc4b55dfb99b82,dropper,5835,30,57,60,90,57
3597,9b7b7cbe245e860a7e96d18ecdf2cef908bc47d53aa37739a509e1867f4c8b7f,dropper,5834,16,39,50,66,39
3598,9bf31850fdd527d33f429d11a0cda11abe3699e30c1f7bd67129fb36a70f37f6,dropper,5835,27,34,53,80,34
3599,9c1c871bf33c87ffade6d85f9f9099df1af1d929fd5091eed967130904df897c,dropper,5832,22,49,54,76,49
3600,9c3f011c61b28c4cc1d21d00f495636d23ad8020cba50b0662368ae55ac951b8,dropper,5834,33,56,39,72,56
3601,9c57c626f3c597d87f9441dd4320179d1f958f67a7f472bd69aebff09e8d5572,dropper,5832,24,53,55,79,53
3602,9d3aaa13a97b34c9610e4dd34d704c7431ab2e5282db129f680931548df4a5b1,dropper,5834,23,45,40,63,45
3603,9d54e31337dadb647e4cf3f812c756dd9c4ac86a26f27a4bcf005da57404aafe,dropper,5833,29,45,47,76,45
3604,9d6bd1a474f0c7143163d53eee8c3c33ab97a13b97867df50b6cfb8321e4700e,dropper,5833,30,49,54,84,49
3605,9def18a648226dcead1b6d73401d75cabea903a5ed22dc5dc1c300f441cc80e7,dropper,178281,711,1354,1449,2160,1354
3606,9e2d6760333988d8ed2102d4f1939d2b7f64c92f2899abdc8979eae526cee9f0,dropper,5835,29,48,47,76,48
3607,9e6a758b94775ec94aedd7244f17eceda8de03f39b906626b7b83948fd38de48,dropper,5835,26,46,65,91,46
3608,9edd0191c0ed3d5cc0eadd13d76f0f9243981db4dc55ce0c9dbbe71394b5a7de,dropper,566916,2242,4389,4499,6741,4389
3609,9ef37d1b7843bf044dad2dbbab8e254a22ac6897f6ada8d028c570c0c27e6f4e,dropper,5834,22,46,51,73,46
3610,9f0d5924c4a2020e64ff377dc240bf404183219af45e8dcb70ffb93b18cadd10,dropper,5833,25,66,40,65,66
3611,9f1d396ed268f33fe9ab282489aff5583343e8c50a78e811e1406e53c28102fe,dropper,5834,16,56,37,53,56
3612,9f24271a9b246f17dc73e14fed1294f837e0b76b6a15b8b495cdc3996311f257,dropper,5834,21,53,52,73,53
3613,9f2e6192c50c42afe78e39224987ebb8350bd599a51f46f1f74ff664f1f26bef,dropper,5828,25,47,56,81,47
3614,9f890bd3ead2d83a10830e0b63097f46d93111e6b04e714c88a22cacc9aca3bd,dropper,5835,25,51,60,85,51
3615,9f93329a97033be0d3faa61ce05b844f8dbb4977987bdcda069a9d034bd649b7,dropper,5834,22,48,42,64,48
3616,a0005de38bfe8db46e5ab33381f7fcc768dfe25a484e55846a563f047d514770,dropper,5835,22,50,51,73,50
3617,a05657b87c132153352ddd1051920b0ea1a97279999f91c8f3be85acddbeea05,dropper,5835,22,42,49,71,42
3618,a1467536fce8e817b6d005528f5b2dcb5155bc23427c4c540203571ff409dc4d,dropper,5834,31,50,42,73,50
3619,a1b4701b99fab5a5ba328393eb2effea613bc9d850cda641ad0b8fb2b5e8a054,dropper,5834,26,46,45,71,46
3620,a1d02f1653c7acca178fae1bc9f7ed8cfd50dae0ff33466a0ba17426f6064edc,dropper,5835,29,46,46,75,46
3621,a2489c8aa2951089bdeee2c053d7b75f7975175d85015745b1cf9d103ef70d56,dropper,1138919,4317,9011,8928,13245,9011
3622,a267c73dcdf682ae329432e8a911ddabfdb6ecc6187da327de928c3c7d4539fa,dropper,1832799,7167,14328,14211,21378,14328
3623,a268e1b67e17152f99be93b389e48d3091989b557f791e70d345e5f564ffd1bd,dropper,5834,22,50,49,71,50
3624,a27bb85093c103e314c648a6753a7462d14b9984fce00f470a1c26c6be678c6b,dropper,5835,18,43,53,71,43
3625,a288ad9a4f2a3561ba8c48dc21e14fca33ed124c4ead0433e1c6b7a72307a322,dropper,5835,25,38,57,82,38
3626,a2ca23931c9269f8f9bed957f4026805cf430fae3c6cb400af31bc98f36db020,dropper,5834,25,43,53,78,43
3627,a2e94ad9f62589950fa614de3d71338cdf82bfefc632856e8b74175fb7828e5f,dropper,5834,27,58,49,76,58
3628,a33124c14bc28d1cada1fb663ce3a2c696d929c83e1d7498c3a403abf55caa0a,dropper,5835,25,38,51,76,38
3629,a343372e5b1969bdfeec3e21af4c001f6949553e52e58df08604b38bc47734ce,dropper,5834,27,55,58,85,55
3630,a346b5796a7f8d3dc1b9127c2fb4d0de6da842480cb3c5f936307a9432bd7ea1,dropper,5834,26,62,49,75,62
3631,a3a0e03665b73a61338219c038c805c88181c6571421ec355847bdabf9b1497d,dropper,5833,27,49,50,77,49
3632,a3a19b036d531f67b8a17e84f91716d8e1c8d7cc588804fbcae44044f395f50b,dropper,5834,25,43,45,70,43
3633,a41c56688559e4f36296d6fa8d68c3ada1c3acd6273c0ca4207b8c59f8b579ba,dropper,5834,21,53,44,65,53
3634,a487a4ac6176a5e05d4d21b93a9ce4660a503b7458de019d1bc015efcb3161f6,dropper,5835,25,39,40,65,39
3635,a4b1920f4813a4f683d9907fc53a4b405cfb5e1e096e74c43296df2c16ec8fa2,dropper,5835,22,42,50,72,42
3636,a4faf3c16287b8a12a5986014c946f165249efa5381bcb82ec437f91cdf54480,dropper,5834,33,61,49,82,61
3637,a5122a188855eb66a660de80ed7319bc8b39202736191416515dccb3eb3bdc5a,dropper,5835,28,53,65,93,53
3638,a55c36bed38991a047d7ced9ed949ac85b4b57f89489966e9dbe5a7064e97b32,dropper,5834,29,51,54,83,51
3639,a580a096f39d04815fd87840a3f07a4088e58883b977f55f2e0e771343d9e389,dropper,5834,25,42,47,72,42
3640,a5c30987b4b4a93b511a2db7ae4d807e19ff208cd31874c053b78781503babd2,dropper,5835,15,47,51,66,47
3641,a5cc1a695ca95fa7c324c765efc7ce2627ddcf8d149b7ab56ce12f4794222d9d,dropper,5834,24,48,47,71,48
3642,a5efae4be08efd5c79aa1433881f6cc9d75e606bce6c971df06ac8b69c5889e2,dropper,5835,38,66,27,65,66
3643,a6114422355a8ef96102730e57325e9f3824e8e1ce62ee7816d4a19884bb8c5f,dropper,5834,20,46,49,69,46
3644,a6430062de1877079c393351ffb878d5cfec4088d313e2b6ef938ad1676a81e2,dropper,5833,29,59,46,75,59
3645,a6da83b29906b02b28982e4033614f67133e97f06bff933ee28cd647995201aa,dropper,5833,40,37,55,95,37
3646,a71e8bd60894b6c3596342edb09ffa4517044dd936e81fde7cf6853a87305091,dropper,5832,22,48,53,75,48
3647,a72522afe5bb20f626a1c5d805d99d8c9f01dff0a0668dd64db26f8742bde797,dropper,5834,24,41,47,71,41
3648,a7c4ea29e285d1caf646d4803b7bc2266473b1954c618bf6ba3269a0245f34ba,dropper,5835,30,45,56,86,45
3649,a89f47336d51a1b2005ac2929c05894db61d95f6bcbdd126a68b2e36f620994e,dropper,5833,25,48,43,68,48
3650,a8a1b95aa1b7a9404a66d5799c84c2bbfbac5629af46901026306f9b631d2b12,dropper,5835,19,42,59,78,42
3651,a8ccf684ad031ec5abc23dd779434e7483322ad1fff00c99135de86ac4977070,dropper,5834,23,37,52,75,37
3652,a8e50d4dfc52c17be4670589afd438626b277b516910802619715cf068dfb919,dropper,5835,28,48,46,74,48
3653,a9393b3a912300942f95a8213ce9b79f8abad5d3286f28a1967bf5f5895600cd,dropper,5836,29,59,55,84,59
3654,a954d0d9e836bc4882551f45de6f554cbab819c68e24858c869cda96325d84d8,dropper,5835,32,60,46,78,60
3655,a97ac8ec68b445c6847d8574169ab7d5940ace40c69dc630d92ab2e2f17d7c00,dropper,5835,27,49,53,80,49
3656,a9f1d4c5ce3380b8617446829416dac6b6553d91ac814d268356b1cca32c3dfa,dropper,5834,14,42,54,68,42
3657,a9fd76625825f5c9f947b8ba0722c79b4d8cce15eb47867499795d1401151979,dropper,5834,26,54,53,79,54
3658,aa2b2629d52840e0a95e0cb15bd60fb35e93e7b6f7e9de7e30fd10ad17742ac3,dropper,5833,31,51,48,79,51
3659,aa94558d2c9bb8a1112dd3fd99614965a827843ce7d723e863ade1d4bff0d041,dropper,5835,31,40,41,72,40
3660,aad8b0446e5ba56ac3bb40eb1e13d780e86ef613cf956444163ce250e922a3a6,dropper,5834,17,48,46,63,48
3661,aad931a5b7539eac6e577979c12b9ac0e19f690b4f878de7f4bed89319432754,dropper,5834,26,62,38,64,62
3662,aaf633f32034932b9c88a4de59481285c61709ede02d36127ca32000d4a8a06a,dropper,5834,23,47,45,68,47
3663,ab34323bc2c52b848a6c9f5344fccff770ebf079db06a88e5de1eead39589d24,dropper,5834,33,39,38,71,39
3664,abc1f4a56cda8be7f6a292fe2caa743fabb48131eed00757703f328fa0804af0,dropper,5834,28,31,50,78,31
3665,ac308d1fa0acab1c51c4f059e9a721d3f68759cb59238356e17d2b09c79720ff,dropper,5834,20,49,49,69,49
3666,ac6ec30d4cc50303faa24e2f683293a1e581ddb37d16d8633f9a1dff88683da3,dropper,5833,29,51,54,83,51
3667,acd645e27c27f2849e565be7081f4e2c188d69ac30c467e134a0b9943c269e66,dropper,5834,25,46,56,81,46
3668,ad4c8a59288e7f119a921593109d6db0ba183304876e6811260c2540946628fe,dropper,5834,17,43,42,59,43
3669,ad77c52ac6fe3573e1c89411bc92dee98f3978f88e00df7756269d4e87e5974f,dropper,5834,23,53,58,81,53
3670,adf38771dd59e8f99a615a53fbdf4bd437047a1d4351efb9e37da9dee91705e9,dropper,5834,23,69,57,80,69
3671,ae0723353867f15c3b378473cce5132e6f652c1ac6a0f5cf3ab9796383b0762a,dropper,5834,27,47,53,80,47
3672,ae1f102ccf34c9f575ac81f2fa23cd92789d967a038e5c4636282c9b2891cc10,dropper,5835,24,36,43,67,36
3673,ae257e28e5c8c8d05b52ba0d7ba70092e6b1a16023d5d41389093569eba58988,dropper,5834,32,41,50,82,41
3674,aed8ec0e886631738620e0d6b82c17c2b2561c9709bd8c389b1df03f7d68082d,dropper,5834,22,52,55,77,52
3675,af186a3c9cb3996a82c8c6daba12c17c8777014647df8671308cabeb4b382f9a,dropper,5834,27,46,51,78,46
3676,af723217a388ec52dee70156c1a7f3f1c9336cce58eb31502de2b659750d840a,dropper,5830,21,48,39,60,48
3677,af79b753a27da67b6e92106c827808fefc038eea45ff400dd6bbbba6771af56f,dropper,565594,2253,4395,4453,6706,4395
3678,afcb65a413f2adc8d722ad9bad535255cad400496450fc58e4948d2e3e920072,dropper,5835,23,50,54,77,50
3679,b01f696acae1973fa96fb0b4cded29fe35b313a8a04c33e038a8e819adb5eb4d,dropper,564806,2188,4576,4370,6558,4576
3680,b0210577804f45c25030f8d2a4f8c91efedeb6deb8b3f53eada43bd381309688,dropper,5835,35,53,59,94,53
3681,b060a1b70fdc4333e97e98a4918a9ccc3c62565da08dfdec2a902b07990b1346,dropper,5834,26,64,44,70,64
3682,b07dc7027fd8e96ffcceeaae56d0db436633a0f623a369135c1db8f2a583d6e5,dropper,5835,22,43,51,73,43
3683,b0edda0313701d63cbc84ee26cf091258dca658a3cd45a891a7e477e40094195,dropper,5835,21,36,54,75,36
3684,b155a3b145a3300fd04266f9850326a0a618382762e98403b6a74f4165c03005,dropper,5832,30,50,59,89,50
3685,b174aa161d16288a03771e8f0486261015cd322e9eee1151c0f790e1bea07b6e,dropper,6826084,25461,53887,55819,81280,53887
3686,b180aa050dd425d45f2a918a0e19f99a1a8a73499ba9eecf7f27df83b93c2f3a,dropper,5835,30,45,55,85,45
3687,b1906ad4b10d42ecb85c4f069d83345d6d9b1b61342cdf0848686dadfb1442bf,dropper,5834,35,43,60,95,43
3688,b1a074b1789d29ce99445fd21a75dfb384d35f459cb4aa42e4dba8837ea201f1,dropper,5834,30,48,41,71,48
3689,b1cc5084c2c0900667ec759c456f5fa8ba5d1800e2c690b11570a107283eb83e,dropper,5834,25,48,38,63,48
3690,b27a171da1e9c0249a4ab379c2f00400bfbffc455c58ed821a8fc559c8094529,dropper,5835,20,41,56,76,41
3691,b2bdfaf355e5bd8f592c5aef1acdfdb8e164a72efcedc3fc00401d924ce0baa0,dropper,5835,25,41,53,78,41
3692,b32bddab34183079113998a527cc83cc655b25a1e7dd327c15dcce68ffd45f76,dropper,5835,29,48,48,77,48
3693,b3bc6d1ad006c562da4e58104f7a0d7c10b3b8fcdbc9398f95e5d8285525957f,dropper,5832,30,52,63,93,52
3694,b42e526f9e7dabe337088732d5fbab39a15bcec3e7185e577358bcd191d6e691,dropper,5835,33,62,49,82,62
3695,b4449e5a945aa58bde02aa73cdc7af67a2c8b7ee40011d9883cad8523e8be234,dropper,5835,26,66,50,76,66
3696,b4db6a02803b565b4203ef14e1e57202c063474b9d51a5f12e99afd3edb33c42,dropper,5831,31,51,48,79,51
3697,b4f96ab3ba920e2170ba4246912df34fa628963952863c5d7a35205c7c402917,dropper,5835,26,45,58,84,45
3698,b5541b81e88081554d54cb814cd1476d149d5e5047f5ee24e4a79515e74bbda3,dropper,5829,16,55,41,57,55
3699,b57246f5d7eed499454af67b82c4cf2169d6e58098a3d9d91f73facd881ea890,dropper,5834,22,54,52,74,54
3700,b59705bd0a92dccb3e5b80eb89d01c5dd2d1e56dfa47af8fa2220d1ed45d4336,dropper,5834,36,50,50,86,50
3701,b5e62f237b0c0e749ec9b2fbe2b7e367a1a4b6c46e5a6d9952800041d435d910,dropper,5835,17,58,49,66,58
3702,b5fcb3112353295bac10ecbbc35be95a9fd181dc40739ec7cf508e163151d31b,dropper,5835,20,37,52,72,37
3703,b602dab1927fbd1489ff1a509251f04963fe92ac75c4b76eb0f7f546c75b0b02,dropper,5834,30,48,42,72,48
3704,b6209367c0670963fae6e43461e4aec6f428ebf600010c55aa4ac07d84f22a84,dropper,5834,20,50,48,68,50
3705,b624e01de2fc925beb43cc4d1bec0fb5eaac566de3960c1794c999db24cf20f2,dropper,565760,2234,4497,4428,6662,4497
3706,b67fee1d3c9b1319c4aeca8942749cff86536598ce54ed611b60cae8bfc3d9e6,dropper,5834,30,52,51,81,52
3707,b68a40f05db72e6115754415f2ef75376efa71befed440872e5c65f9c5b3dc96,dropper,5835,29,50,46,75,50
3708,b6921779f334f8ae7946eb9e4ef0bcc67e3c4bffa838c87f03e7ded732800b0b,dropper,5834,28,53,55,83,53
3709,b717ac93e13340a7ced9716f9610fa438313c1fb52e6bfd95c38d1863d4e973d,dropper,5834,24,58,49,73,58
3710,b7482a021bb75dc5d48a899abc4ed58afce651248b4d63a6a7bbecd975fe7207,dropper,5834,24,43,42,66,43
3711,b7ce413f6d54c3375a9ca97886539398d1bd42d56f3e9513ef7ce46471f2e22b,dropper,5834,37,51,49,86,51
3712,b7d93c6ceddb613c80e2f1d74c277362c9565dfe8383f2796605c3ca9a104bfb,dropper,5834,33,31,58,91,31
3713,b81297638e54cdcf98bc4058d2244df6338bba7636e45b759340c3884d37605c,dropper,5834,26,50,51,77,50
3714,b8664a91c1090111b7b6dcdb7d5cc8927a3a72326a7055d7228a75967a42b84f,dropper,5835,25,50,59,84,50
3715,b8b542c178843d4da2e2e65b0fc854e50efda96b535a462c867657cfce07a43f,dropper,5834,34,46,46,80,46
3716,b8d8c31d9b1a9a140d2bd9e1e75c56da48d4985dcc32c10493df14459e59d383,dropper,5835,22,47,45,67,47
3717,b953ed9173f97130bed262a4e031c2bf89437b27c364c74a5a4d951705616c30,dropper,527538,2140,4007,4061,6201,4007
3718,b95a0c9923b153a3801b821e8fdfec43ae2ca3cb22d6d6c8713c2a73a060f5b4,dropper,5836,30,51,38,68,51
3719,b9b106bc2766fd66a2dfb0ddac8a9acb39b5dd269cbdcbb0d0b0c73f0adc2ffa,dropper,5834,24,49,53,77,49
3720,b9ce2b66d9a0e66e8aafebdd510505f8445c16517e3098b90ebac44e44c80c37,dropper,5834,26,45,51,77,45
3721,b9dd2c2bfbaeb1094375257149626518373cc974c5101936725991d02f70623c,dropper,720319,2737,5360,5910,8647,5360
3722,b9e4f0d4a2ebfa420c10d6514215ee51bd9d9b673c5428786356a75d1e88eb1b,dropper,58042,244,430,472,716,430
3723,ba3ceeafb3ce04f8f14948a145589592faf80dfd363e0641c14521bd2ec16645,dropper,496206,2030,3956,3905,5935,3956
3724,ba82a41ea8f25bafc2ba6668bd7864c23ae56d9a00f9e462fb11565f34db3041,dropper,5835,32,48,54,86,48
3725,baff9f1a7f6c572f64f3f9c7c7802986c551140c42522b0299ce0758434fee38,dropper,5835,20,49,50,70,49
3726,bb058f109c605539ad9ac54a7726ba64807e95d630ce9f4d316519c6eada5968,dropper,5834,20,39,56,76,39
3727,bb35bc1500cec9244161e75078396b7e4a09128914106eced9b8be92946e7c97,dropper,5834,23,44,48,71,44
3728,bb8d7cf35d6a9919c8895840032d2caf4334b39f5d9e4120df54deea32798cf3,dropper,5831,31,37,43,74,37
3729,bb9887c4149d27bb77c8f3922be7ddd54d486cecb66a2a95f5edc6a9d5c52e10,dropper,5835,27,45,46,73,45
3730,bbe03332a493b64679ecdec788c7c41f508d2b7775cedca0452af4a097a6cc50,dropper,5832,17,58,40,57,58
3731,bc85287265a8c47390883cbd3fb7a0930368c22ad1d66d9a816c975f66bf0896,dropper,5834,30,46,37,67,46
3732,bc8738db54ce2903164785302782828b39ba048638284269292193ff35616dc2,dropper,5835,21,50,59,80,50
3733,bc9c9ea9e6e609710c9be97eebd6c1b80b6699327f043b566331b10ac8ced22a,dropper,5834,20,46,49,69,46
3734,bd186978ce7adf73b532feac4b83810b59f7b818239161d172e5e1de1acdddbb,dropper,5834,20,49,51,71,49
3735,bd6b9b3d827cee9a7f9443dd1cbac0783e2c9a68b00ef1aca9ff4edaacf52640,dropper,5835,22,41,71,93,41
3736,bda2acd0c23365372c15433fe5ee81883ea5334da74cafd37d0b1397a80a8f74,dropper,5833,23,55,54,77,55
3737,bdb6852d85b09943bf98830c3b5f01e90f68e4764824423762133e78051b100f,dropper,5834,27,40,50,77,40
3738,be01efbf9348e36c83613226745389c8c231a2c3c6fbaaddcf5ca5fa0675dd43,dropper,5835,26,37,43,69,37
3739,be36fd7f009d693993de7da025422941ee56351a84d0c0c176a207b2372a2fcf,dropper,5834,33,53,42,75,53
3740,bee7d8ec1f456950822d869a17a3e79d0d1f2d8a036ab1c297b69c68596b6dd1,dropper,5834,30,42,42,72,42
3741,bf0c5fc11685764b6eda8050cc03c6a801a1d9ede06bd5d2e19fa747cbe4e5aa,dropper,5828,29,54,47,76,54
3742,bf1afc4eb6baa94956c0127e3a00a68ae094ff2e0e6a50477edb817e8b986f03,dropper,5834,20,49,37,57,49
3743,bf7ba33aff44238df51827126d1721e3a513f6647e02df0e9f2a9c8f767c3819,dropper,5835,32,59,51,83,59
3744,bfa4bf0f3de5222c62e50617f7b091fdaffb93e6cef7098522e7525a0479faad,dropper,579175,2331,4584,4565,6896,4584
3745,bfbcf0c1f98e97df0e01959d11c8068b77c4a7c453d00b5143bb131fb2e2c26c,dropper,5834,22,49,49,71,49
3746,c01a8a2918e651c9b8bcce0ca7eceba32e0ec99a80eca2557ffaaef4540a8ccd,dropper,5834,32,38,62,94,38
3747,c07aeb21bdf096eb0f0db12d5e7b629a0329ed3a971f7186088896856b771a94,dropper,5834,27,58,48,75,58
3748,c0c0656f3643fd781797634b1f9e54c0078c805b13c4a1ef33d42bd9877a1abc,dropper,5835,27,55,53,80,55
3749,c104230fbeeb71963798db33dfcc7939d58f693b712a22cc496e7b705abb26e1,dropper,5835,25,37,43,68,37
3750,c12da15b512d9ca2f2ded594dadda4258a83b35c819fcb671f86dd0aebcbcf17,dropper,5835,25,50,50,75,50
3751,c1394081e7a2727da1de4aaa2d241cd5ab386129a774405e4d17adfc79b65668,dropper,5834,20,39,56,76,39
3752,c146cf6d1b31d2876384ada9de092b5272edc9c43d7c3238e05c994688bd1fb4,dropper,5079909,19943,39933,39462,59405,39933
3753,c190a03da7b284c5a187b4d12c6a0efa9c579b4e7e702cfd77437a74792e75e3,dropper,5834,30,54,68,98,54
3754,c1a50bc6f1e35d35f4fbe476aa6fb9ada7027590657a0654c63c30880bd0ddc9,dropper,5835,29,56,45,74,56
3755,c1f30d44ce32c9545084e1873493c9c41a225988aea06ef17b5af1f312cb3b29,dropper,5835,27,47,41,68,47
3756,c1f540dfa420c3083c6b35ccfb0d7438df7dae65ff7097324f7fdf11090ce21b,dropper,5835,24,49,40,64,49
3757,c271190cbbc63825193f41c84a39320c47d38cb363abdf5350d54d605b311bf4,dropper,5834,26,44,42,68,44
3758,c2a6a068a0328db8bc303c91d0c457d712f911b65c45251b545d9815e0f3f5c0,dropper,5834,32,59,52,84,59
3759,c3178b9c8905e721bad0334a18d03a3a410f0d71af7269d26d4cc8b82817abd3,dropper,5075509,19889,39563,39739,59628,39563
3760,c32846f0fbcffc34e914f883d226013c681e2886b970dba9deba4110514eadcd,dropper,5833,23,62,42,65,62
3761,c3b59942366b64cb676427d791833e78ae0de3172c095b71271b152b97d22322,dropper,5834,25,53,44,69,53
3762,c43889394e93f949a8d3a7a93b067b0751faddd0923ae13d8d862c0a526072cf,dropper,5835,24,42,47,71,42
3763,c44e527f08493b3e98058bfeb9d374d9d116721beea029237ca27436b951f46f,dropper,5830,19,45,42,61,45
3764,c49284606bb94c2604d16fad8e6d9d23356132e955a15f85b42cb0f31dbcfb60,dropper,5835,25,37,42,67,37
3765,c5af09d46e4121a394f51f974401a71707f693a6c55a11c96ba0283db1517521,dropper,5834,29,42,44,73,42
3766,c5de2e7a17764c1b0bc6cbdafd60542a22ec8e9e62be5917c766186f51bd7e1e,dropper,5834,28,53,55,83,53
3767,c5f82f4ff37cc67ecb9bb4d2d34b4ac1a4930fa8e72c381ddc7404583a70d0dc,dropper,5834,27,50,53,80,50
3768,c7935aabb9021de3cd391341b43c3e24cbd01d8e938fd02f266a097aae3bfbb2,dropper,5835,26,44,48,74,44
3769,c7d9cb26a0de69ac158e3f49551634808f590f76b8e7777ae4eb2636b1b4c4b7,dropper,5834,30,48,50,80,48
3770,c7ece1bd447dee3519e06d434d3ff7d35625962fee23b4a13f505abc257dd1c3,dropper,5835,24,38,56,80,38
3771,c80b20a1f67eae032e085584101faa19a3fba866c6754be4ad71896798daef45,dropper,5829,24,54,45,69,54
3772,c8432facfbdff3c0471440319073a5464ecf4ac6b10533ad5c4d518b91cbd632,dropper,5834,28,54,55,83,54
3773,c94a7b12c09b3f359511aabbbe9f0d5a15b02a3ac5c252c5ad9fe98672745d50,dropper,5835,29,40,45,74,40
3774,c9888477203ac403b343e1d2f0e7f7336299ae43df5f58d2557c7cb938da4545,dropper,577686,2305,4467,4539,6844,4467
3775,c9ebcca1b1765648ad3bb5afc99162c658ae2604f8ff36f28b8501063a0ce5cc,dropper,5834,27,41,50,77,41
3776,ca129c0068c09d559549e83f355dd303e15738cd2674c568df2619b3b78b233c,dropper,558399,2267,4190,4419,6686,4190
3777,ca12dbb080242adbdde542323cae68d085f62d36c2e6c4bf5682d69a03d20137,dropper,5834,21,54,56,77,54
3778,cb40da385d82e28552f7cbb4277290ab75ba92e463264fe56e3104090217de17,dropper,2903967,11352,22848,22812,34164,22848
3779,cba0efa31c51dacdf84b91b1e3f6ac55321260eb0d15cc205268f62d5bfcc583,dropper,5835,26,53,53,79,53
3780,cc03caa0f5584f14092caa76f1ccfb50f3d08c80e56b7c8b5c71fe45af69b76b,dropper,5834,25,45,54,79,45
3781,cc2d03969b4fa2db9e97cd17baaaeb925cd362b26e1f9eed3f551b0dd8a78948,dropper,5834,26,61,58,84,61
3782,cc2ee8eb0a5e515bcee6efe4553995864c0fffe7a1916359af1c6f90da40207c,dropper,5833,23,47,60,83,47
3783,cc671c3dffbed6461758c771a4db4bf2dce921439e3328b1ecdccf722f62106e,dropper,5072626,19735,39468,39776,59511,39468
3784,cc84099e33965bca06b4c8d777ce33c08dc13b12eb2b9b471996d70d6d77cece,dropper,5828,23,46,50,73,46
3785,cc98fcbebde9845b2484951c74007abcb8be0bb2e24f932cccc7e4726c77a564,dropper,5832,30,49,42,72,49
3786,ccc438963bffbb9f6a355da3985430dd7fd5a1e9b6894f1c43aa48c8f70137e2,dropper,578512,2380,4547,4486,6866,4547
3787,cd991ca0d398b9d5fa2c0cc3fadd3b5d315412c537512ab5ca6fbdea5ae7c3c4,dropper,5834,27,46,46,73,46
3788,cde23a5aa217547c88e78f4be75dc30bc5c707b1c0750ba7fdf800ac1965efe7,dropper,5835,29,59,55,84,59
3789,ce31bf07787a16b8b032e087a27e6954d07ed1703dcbeb09bd3252eb66dcd54e,dropper,5834,28,50,39,67,50
3790,ce74ef27464c22ee9012c3c47758d4255e12656e7afb4de1ce39ba7d87a4d539,dropper,5834,23,49,45,68,49
3791,ce76e76a81af4f2cc4883cf782fe0d8f9a042294f43343a01f59c3837388d4c0,dropper,5834,28,56,55,83,56
3792,ce8a3a08478b61f8fe9058ad190ba0e22b14d963e06ca346cd5728492afb4d47,dropper,5834,26,53,48,74,53
3793,cf0ecf9ab39317ef6ce3468ec7519dd74a612964740c76dfa8220f4d8dfc69d2,dropper,527536,2145,4020,4029,6174,4020
3794,cf1858435e7e6395d28c19ee5bb6e0f4ae7679f5c4986068053ce8b17ec8454f,dropper,5835,26,50,41,67,50
3795,cf9439960272e5dcd7b4d2f7b7e764d9d5da9a370406dcab80a639d42526dba2,dropper,5834,23,40,51,74,40
3796,cfa6830f462e387ce3d906002f24688a5e0060d9c116fbca85d59426dbb9dca9,dropper,5386060,20957,42928,43648,64605,42928
3797,d060d6aa860d2d5b7f21d5103a0665e3fe7cfa5bc541a2e9be4322a779ed8226,dropper,38096,142,278,333,475,278
3798,d0eab617c6d842c7885b7dbc7f5711db3c04e9d15fda04832b3a5636ca4f7821,dropper,5835,23,47,41,64,47
3799,d0f60a961a6dd2470c12591609e4b2971a8f889560f8d46c59be9fba6c5f0f67,dropper,5834,21,55,45,66,55
3800,d219cc14bf414c3bbbed6a95758ae8f159cd238730d3645f45bb294229047ea2,dropper,5075996,19671,39712,39582,59253,39712
3801,d21b653b66e11a95d01b36e6c39466dada5147906af54798907198176802e60c,dropper,5834,25,52,50,75,52
3802,d26fd7f7c28dba29c7b742d5a4202c5dfbe2dc405968e4bcf7780b91268d13f6,dropper,527534,2138,4038,4046,6184,4038
3803,d28d52d2a04f06c871b0352de38c11742265c1e5c618ee3162e1573a2f57a4ed,dropper,5834,34,35,46,80,35
3804,d29c212fcc70551bfa277564b0edce3acfcadeb998268f3af40032e48e01add6,dropper,5834,33,54,59,92,54
3805,d2d6fb6cb26f78b2bcb25ab84c646bd6dadd2faaefc34fe3df82b2788bd87537,dropper,5834,30,33,48,78,33
3806,d2d8a4ba20150380750f04d19d244a17800ff9a12b9a81215e95d297e2839047,dropper,5832,31,50,40,71,50
3807,d2dbb20078e44ad2d35aa4d08907904e85c3a6248821d5449b37538562e303ea,dropper,5835,29,44,38,67,44
3808,d307128db297a4e8303404321b430ec9425c27fb35372b09299635d8a2422eeb,dropper,5835,24,41,53,77,41
3809,d358a635aa3553d12aa43eb33eb09437d5dc4240dac6cb1c1b85b90d5c2035d1,dropper,532253,2038,4126,4222,6260,4126
3810,d363390cb366bb12640a761ff16dd9d0641e6e19535c6cd842de85680dfd667f,dropper,5834,26,54,52,78,54
3811,d453faec27a904b5ea42dfc0dcb2bd9fbdc514061ce5ead426df3604f091abea,dropper,5703789,22013,44808,47046,69059,44808
3812,d49e2c2428eda20197e0be48fad0ffeb02e0ae40a290ffe707f3b79197453cd0,dropper,5834,28,51,45,73,51
3813,d5087fb72d243b5e0a48c8a2e4f38e0af5f314327cdb78462f819ffb9b32e732,dropper,5834,34,57,48,82,57
3814,d513b3b03de1f01c13a788b9e3699154f28b78d299c7a1f01f8c7add87d35a81,dropper,5833,18,48,43,61,48
3815,d5175f2405b9589a3b2fad8329bd172a2a24246dfbdcc778c412b257dd7a0656,dropper,5834,22,55,54,76,55
3816,d57c2e59fc199ea852844906e2087ccce731cda09a3e0736cfa826a411fb15c6,dropper,5834,30,33,48,78,33
3817,d58389c6fc4e77194eb423ab1c9ce30f3d778f490ccddfc7183085c8b28e6bc2,dropper,5834,26,44,57,83,44
3818,d584db9308c59174e39619c1f8b799043f66c3ab6339d897b4a89a7db2c8e8b0,dropper,5836,30,50,40,70,50
3819,d67c02de66d7d06b99da979cc575eafc92b6f143e1a18450267f66b8aca39027,dropper,5835,32,60,46,78,60
3820,d67d56ef6a44da9fc5fbd26dbdefbdf4a5f8058d9a3120c93ec0fac07357d505,dropper,5834,29,59,57,86,59
3821,d7624fc64e83ce3bed6fc030cbc5ec78d2bd3ab19b7085badb2f4cb5c4936dca,dropper,5832,33,46,34,67,46
3822,d7c0f30b169e7b532f1aa76789ef4ec58770c8e48ca52fde9a46623896f0fe93,dropper,565762,2237,4484,4424,6661,4484
3823,d87d5c95c6cecae40e638ba2c1ee94ca38cd47f4edbf1d55d0744057f80a1751,dropper,674636,2737,5338,5536,8273,5338
3824,d87e5a8230e91677e82693481b390865c7529d67b4800aa0aafadb16025725a7,dropper,5835,34,57,48,82,57
3825,d8b68335517dbab9d578a111a8a35bddd9a79193d5abdf464388a7674f198b2a,dropper,5835,28,52,52,80,52
3826,d94a2c7450c146e9b43eee87cca75dc25f31b9e2bc7185a4b1c9b63d4c99b725,dropper,4213417,16209,32568,33007,49216,32568
3827,d955dd322a058d41576440821b6cde6c873c2faf712312775883df621be85d22,dropper,5833,29,48,35,64,48
3828,d9aca5e6007b0f5acf868e35593c0ac538738341ab0d58257fe3b4e74ce9642d,dropper,5835,20,41,42,62,41
3829,d9c171d04031576838576333e1f89f3a8bb0e289e33981f07be69a333086f49d,dropper,5835,21,59,43,64,59
3830,d9caf8db1d4278904c822d1be59473c015826c0916ef05d12224228c2cd13e10,dropper,5835,21,51,59,80,51
3831,d9e8f7b29a95eae7eee0501192a84083ea0113f04969a7ceb1467a76d6fb3c04,dropper,531672,2145,4230,4185,6330,4230
3832,da2547e08584fc474a998edb146d39c8ec874196ff4e9c11bed09e68608eca28,dropper,5834,31,51,49,80,51
3833,daa3630556d46b95262b3794f210be79046c0b8cff8a2e09cdb81a1bdb8b4030,dropper,5835,25,54,53,78,54
3834,dacdbe7c31359c89992d07f7e228fac0af199011c2b19963f3d051ec94b17ab6,dropper,5835,17,43,42,59,43
3835,daf567847f4d67fe82ca3bbaec5b774a2a4630c56b89b578480e31a49bb0e06f,dropper,5836,29,59,55,84,59
3836,db19df0fbfda05e9d1ec9bd70cfcd555c0ea6c621950c6383fc32932b4780f2a,dropper,5835,28,55,54,82,55
3837,db1f53695585ec6d2a73b1161e6c83e596a3c5dbb6b3680833b7da195b4483ae,dropper,5834,28,49,44,72,49
3838,db3354cec29575efd9c1359dc6c857b6004945208d153b1a974c71676cbca9f7,dropper,5835,23,56,40,63,56
3839,db9d27fc2a6e5675aa2833a7d803f9d795925fca58bf105ac4d46c1fb1968aa8,dropper,5829,21,50,44,65,50
3840,dbfb9cc68e13e8b70d94b4c8c3bc60cda303070d7c996a314c68ff8dda103bae,dropper,10887845,40014,86189,95451,135465,86189
3841,dc149feee126f1fb68327600420b67afc473f3c331fffb50358e82e2c2172144,dropper,5834,22,52,43,65,52
3842,dc1ef208c43e1cb00aa20b65bab65fa6b2c7434e062d5494435483bec026c32b,dropper,5834,16,34,43,59,34
3843,dd1344cdf35e2270d729bb4f7c2324da08acb90ee78b5f34f63dd30c2bedc7ff,dropper,5834,28,46,52,80,46
3844,dd1732059ae2d14c14868059d755ca8f8c4904a9148010ed29dcecf9c80c206e,dropper,5834,18,50,53,71,50
3845,dd1d07811c10a948b6ae3320839e5b526a65dfe20a42c008e2e52d195e01290e,dropper,527987,2126,4036,4249,6375,4036
3846,dd57eb8c126042ffc348cf39550c1315f88d985457094c69b251579e2c167106,dropper,5834,29,50,45,74,50
3847,dd85ada793d8f1596bd9b283db2d53cda825199aacacce0d0af17c4a1f51dd17,dropper,5834,28,52,42,70,52
3848,de368b9aa72ebba3a3a502d6d7d084cacd6792cd52378474a73e0db8b09c46fc,dropper,5834,28,63,55,83,63
3849,de3bf7034747ad73fdfc9d58c7022158ff6d0921efb1f563c5b03ecc356d2c32,dropper,5835,17,47,46,63,47
3850,de588b9eff4c82e61361e5e86f10c26e4c351fc2fe7a92a5c516271e052f165b,dropper,5834,25,52,61,86,52
3851,de668c96e786fdb6acf583fb2e16c905528eb86f80c44662ba7882df933772ee,dropper,5835,22,47,45,67,47
3852,de67486a5cb986ba2220664895c9646068c413368e59732e16f2259c2a1f34b4,dropper,5834,32,60,50,82,60
3853,de9c7462572995d4c8ab94f7be6a8ea820add3302fe41f7167073e69f3cf3c07,dropper,5828,24,52,56,80,52
3854,deced8543eacc4e11f71ee7c61ad4515eb64b2ce7b6f3faf5eee8d4f7e9bc766,dropper,5835,25,46,53,78,46
3855,df0750eac01ac2c1521067e83543823bafc4c3f04b77d7164a4e792d9ab5611f,dropper,5834,23,50,53,76,50
3856,df0ab02fa1026a68f404b67380279b97fedaf2c72c7eaf44876f990508ebd8b4,dropper,5834,22,47,52,74,47
3857,df135ecefb651d096c861a2251f9e65df5669ff078695d09db8018ad951c832a,dropper,5833,28,46,39,67,46
3858,df6d5e9981b2c469841be51a0fbd5e43d9bdc4275a113a3ba4bf76c968ba72da,dropper,5834,24,48,44,68,48
3859,df8077e846786b4940fa208bfa7f6f2d2ac13ea5658e1c242ba5d7a428fb94e8,dropper,5833,32,50,45,77,50
3860,df937d307c69777018d701e7c16ba2eb7ebcc86a3695339964cbf76d8437965c,dropper,5835,20,43,43,63,43
3861,df9566c160b1d5065636707faea8f89e6f467501eea846d72ad6dce83df45985,dropper,5829,18,43,42,60,43
3862,e033e122599710a0674e2cb6d6b3a1d927a03067e6a4c40ec6780192eaa6b829,dropper,5835,25,47,51,76,47
3863,e0acf3e54486d89132b89fd3b53f876aa324aaa3f3c52689a51e0e692d9343aa,dropper,5835,27,41,42,69,41
3864,e0deaaa598aca546115427b9ae558317bae63de16b49409aa7b5e5a5295a532e,dropper,5835,22,47,57,79,47
3865,e13c1006257654c4b9eb2707440eea441e0abe60df0d12803865f6781a331f06,dropper,5834,22,44,50,72,44
3866,e1a591e8eb772e528de7d75334087c83cd8ad16ddb9c27ff243127f174a86c25,dropper,437833,1757,3391,3311,5068,3391
3867,e1a8ab5369978344d7c000c8d5b418fd877e2fd5ce40a120668c22d7e0eda40f,dropper,5835,27,33,39,66,33
3868,e1edd87a7db4cfaae835fe8dcdf35d9cec614876ddf92162d6ee0a5a3ec459b5,dropper,5833,25,47,49,74,47
3869,e1fec0a8e5cc2f9f4b82a5a2931180db79f52fb98c6a857306c1fb964e9fa966,dropper,5835,24,40,54,78,40
3870,e2c32313e77eaabcd0759b789f02e47dafe4042333a18f704a7c768877d5d737,dropper,5834,22,49,41,63,49
3871,e3467df98c49320b76ef81132325b03de12802030850e39bf064f4088f8e5f27,dropper,5834,26,46,58,84,46
3872,e3692a7297b038ddbee5b3b17595786f87af5ca1cd7cf2d1f39afba98b687d99,dropper,5835,27,51,52,79,51
3873,e3db7cb089674d8ea0da957d686ff297d9d363cee7d2726425607edd05f75ad1,dropper,5833,23,55,54,77,55
3874,e413e67d00be467ab3b21107b975920602ba781bad88dba55335c6538f8a01f8,dropper,5834,25,44,54,79,44
3875,e4325138ffbfc066cd6c255109d675b498ad162fdfdc4e3a008842bc64930b95,dropper,132333,508,1079,1094,1602,1079
3876,e575429b7cf3e0a830bff2dfe56f0c985b1230b5691975ab7a55520bb4483cd9,dropper,5829,24,62,47,71,62
3877,e6701e9945e0da80f9505d1844df5bbfc569e8330259448107f2153d73d05922,dropper,5834,22,51,50,72,51
3878,e7483de09312fd9ea415757b18b3096035bb3c0569e7a077b58b699114f4bed7,dropper,5835,24,40,53,77,40
3879,e76a09e4aff588b53dc894b65249487de985991e5bb58c4d786695bba8fd6075,dropper,5835,28,54,54,82,54
3880,e7767c4e0de124a9e120949534b7f6026ee63fd289d041b82a76ac2d3a4254d2,dropper,5830,25,42,49,74,42
3881,e783c104243b50fea3289426c0bf6dc6e96b3329c0bc1bd91d906ddfbc74f725,dropper,5834,28,51,42,70,51
3882,e7c646de9b199ec71f8cad5f5702644e4dae62438eaddfbd1060d67ca6d10e08,dropper,5834,25,42,56,81,42
3883,e7f4ae8239d5ba1fe6bc4b76935a2887a74c9db700d764be23541e438c1c301a,dropper,5829,29,50,38,67,50
3884,e884b296fc7cb18e832aca8973630fdc5b7ae27136ba81290a870f8c88342b65,dropper,5834,28,59,60,88,59
3885,e8a2e2d931dcf6e3a7ad7f11c48695b2c3a11fc6cac397c0c2b809b9c17be7fc,dropper,5834,34,41,49,83,41
3886,e8bd93ee88f9ef1fbfe901a9082ffcb446a2f363236d5bd6cac83b1cdca3df5d,dropper,5833,33,61,49,82,61
3887,e8f1b79ca3b8cf3c6324f8f48ac047237e4a3aba60652c77714824cf74947718,dropper,5833,40,37,55,95,37
3888,e94666613424aec7c719eb7d71550a2522ab9223cc30a9c652a32910613425d7,dropper,5834,22,57,44,66,57
3889,e9593c032e15141e4cd5223c313ae13bb0813d9677379dca5c4dbe3022a6f66f,dropper,5834,25,45,47,72,45
3890,e960e9a52545de469da4d5db794e1fb7031b439a5997af1ca48a33591b46b425,dropper,5834,28,48,57,85,48
3891,e9ac863b99fc20e7f2d69d61f77afaf1b6ea7e6453ac36c662033232b070524e,dropper,5830,25,52,45,70,52
3892,e9aee4bd044f2e761952d5e9b6ef32021c9a8d15aa27da278f7a3c3ba24e0eff,dropper,5835,17,47,48,65,47
3893,e9b8c35e1399a857af2ea661a4a1b200f48a4f12ec3d39075c45177ec2b6f12b,dropper,5835,31,54,33,64,54
3894,e9d92cf3cf1225a9b06f1fd14151d582bc133f3db7eb08a6b0482bf850cc7f43,dropper,5834,30,54,32,62,54
3895,ea51a6979bfe6589ad99a5d0d7538adeb529d82dcd4cf5f9107f3a8d6cb81716,dropper,5835,30,44,57,87,44
3896,eade548b273a66eae70b41ca37837ce9b2f14c84b1f85cee86f3761880633229,dropper,527538,2139,4020,4044,6183,4020
3897,eaee5cde5599947604b0bb09c6aef45ecb30093cfce3871c087d568e1ee56262,dropper,5834,24,38,40,64,38
3898,eb55b5f164e46588c883ee0ea1190a0b08268f72964edf2bd63ab8b0040202c3,dropper,5835,23,50,59,82,50
3899,eb853cc44b45e860e585636f4747811e0dbb3b4150f39aa27d3973d334369822,dropper,5834,29,52,51,80,52
3900,eba86ed94c8d583577aaa7cc2697b754fb76f62ec3809e8fa04d0aaf7fe24a6d,dropper,5834,27,45,46,73,45
3901,ebb87b35145dbccaa7b96217c96ee7f9f61027c9d1d98b498dcbe7173bc6a34c,dropper,5835,17,44,52,69,44
3902,ebc7c3ebccf186ca3a2fa52c050344dcf5ddf198ef1f537b8361a131961d414c,dropper,5829,23,46,51,74,46
3903,ec3959c16d1b1b5d77ee452d683558b0267c545293b335934a2fe82fa1cbb163,dropper,5835,27,58,48,75,58
3904,ec43f400212a0645fff7c43cc81680b154bbb4747b5a47d9089dadd918650767,dropper,1099139,4328,8660,8782,13110,8660
3905,eca13ff5cbe0c62de3bbde5eeefde0a69ffeb57a37c637fbc064ca075cd1d4ee,dropper,5834,24,53,49,73,53
3906,eccb9d41807593753186d20500223cc24b479ffe428668abceb82454870b3751,dropper,5835,25,49,60,85,49
3907,ed06c65607616ac53a4eca7f35cda5065c22d74b6dbb83f6317c0d593bb1360f,dropper,578458,2352,4568,4601,6953,4568
3908,edf8e070ea43aa32edbfed58e6bf2175dcafc1f9c656c110cae55d40f5305a8a,dropper,579088,2263,4464,4482,6745,4464
3909,ee0476b1954a43e82c1c2270ed6b8f82e5e6c43e2d4010dc67c82802e73292cd,dropper,580096,2304,4535,4678,6982,4535
3910,ee43e62b91012f2f3bc80f9f7a6a41a9d90675380ed83f09b025328f1308b81d,dropper,5836,25,43,55,80,43
3911,ee647dd72dc248811d93e72c9dbb9e3770a40b66ae914d321c13a2287e945585,dropper,5836,30,52,38,68,52
3912,eea855add86934b601026f37d96f30cada4c6e7486f03be836f460a843d8bc11,dropper,5834,29,32,40,69,32
3913,eec5c0fe28ea37c64d809f1b1c43bc7b97e1fb54691ef27f5e7bc4baf086bf4a,dropper,5834,24,43,47,71,43
3914,eef6b75a51e210fb4d1e5fe641fae1e960add115749fac8604d567562edb0beb,dropper,5835,26,46,57,83,46
3915,ef0ceb8d3550099ba71d876731ba64aaa1fc430f14f3a2264b2399925b65d0f9,dropper,5829,29,47,53,82,47
3916,ef5b82981bbf4bd21add1c87e8239e5708e10a027f819df5584f31db7b99a745,dropper,5834,18,57,48,66,57
3917,ef9f3e7dbcd1827981f4628b1e95bdff997dfa2600ce5aac438aad93fa7c7bda,dropper,5833,31,57,47,78,57
3918,efe9738a8922532c399a5e3f1658a181a270a0033dda0d43968c9a7c5497af8a,dropper,5833,33,50,42,75,50
3919,f01ab58a578ea6cb288f382042973041e546b9b2167e3b49d40d0eaac38a0b24,dropper,5833,22,57,53,75,57
3920,f02e16232b778c02a9aae61ba0397b86ec13a427bb5f0fc4277fc939f463a1e5,dropper,5834,28,40,61,89,40
3921,f049d5a42acdd7cb873448c61a7a79743b57d8b528a1972d89d957e19e0455cd,dropper,5834,27,44,40,67,44
3922,f0acb5379caea9e6fb81a20bd463c6c55009aea0d9ee054007b70639bb29d422,dropper,5835,20,44,46,66,44
3923,f0c54c47f7c609f9978c43516fc7317cf3fb2ac988fa1a9fb85b41127fca5d95,dropper,5833,24,42,46,70,42
3924,f0cb74603460f832a9894bac04a1a4a911481f74d5876937d2f8fd230fc2884d,dropper,5834,29,50,55,84,50
3925,f0f08c3a002888d17925130fde2cbc4ba87ca1fcc41fb0bbc7be0856295aadf9,dropper,5829,23,46,50,73,46
3926,f10b758b39337809a8b9475a810ce718e52b6b2993a974b9b00df1f2f236378e,dropper,5834,20,49,50,70,49
3927,f1578bf4bf4321af8bb6cd80d2c2de8c2c487b38e36a877445ae2288259a09fe,dropper,5833,25,43,44,69,43
3928,f16a84fceb1b6d0141e3967c5fdb5a95dcece349bd3e4d9d47c2f24f4839283d,dropper,5836,20,48,44,64,48
3929,f1edc53f99d6a529c39f808d4c034775940806d51c2bcffbab7f8f556deb3d00,dropper,5835,25,50,59,84,50
3930,f2253afe1e49480ab63acd0d41643483696653338916668b8691b7ac281849d4,dropper,5834,25,53,60,85,53
3931,f24ca1d4c7e21a1b836c4fd32304b89d3ed9e19a7d4b168570b088d874a9220c,dropper,5835,29,49,48,77,49
3932,f25d1ff2798dd8abfae1540bb1c55a770beba9bf5a47a52587da2e983f377d4b,dropper,5834,30,45,66,96,45
3933,f2971676ea5e86471b645847e1c1e7c12f5bb7c25221647c82a71e6c92994009,dropper,5834,34,46,48,82,46
3934,f2d884aa984375f7c01278a412e3cde0ff85487c9b78bb2165da73fa1e590dcb,dropper,486209,1910,3882,3918,5828,3882
3935,f301e7f3ea5450cbe1b7d1a28647497ab1a51c4a0d518e28d5101c725d168d98,dropper,5832,24,41,55,79,41
3936,f339a09a76b77b8dbea9064b2dc467eee2b0a3712180119b2cfecee5e2d06b2b,dropper,579180,2350,4574,4559,6909,4574
3937,f35a8b53bfd0e880a71f8c28b8fa56be3641638edacbd5540f527bdbc1714b70,dropper,5834,24,52,46,70,52
3938,f38c6a65ddd714f514e20e76682539c2393054308eead48dd16a3e11cd0ac533,dropper,5835,28,38,50,78,38
3939,f406814d52bba78984e809dd5aea062d2bce50d73fc6e47d7a853d5e31973388,dropper,5833,24,43,48,72,43
3940,f46ad422dc6883d02135f58ad61dcfd76980e9f8cca06eb1a86df62323809122,dropper,5829,28,52,53,81,52
3941,f4e9bdcdcbc086c54e3ed7b6d4f0632ea60cd7ced6fb4a94f977ea1ad219c23f,dropper,5828,23,52,41,64,52
3942,f51e792900723a6e2a241c8ac37eba08201b423c816ab9ffe9cd2f05a96d3154,dropper,5834,29,36,45,74,36
3943,f53edad653062d3697d8acace252ea418c7492ea753027da452084a114755193,dropper,5835,27,59,48,75,59
3944,f5cd60f77ff1e1864f547eb1855caddc1b3a0977c31dceec5afcc26a7c54ab38,dropper,5834,27,46,53,80,46
3945,f5e929202bc5c65eeff90e2b24599c32b4ab8304f0425a518301490f2f5f88dd,dropper,5832,24,40,53,77,40
3946,f5fe74a585dc999a84c2d4828ee614336a175c3bc9c67195a8c218143e9f5fb5,dropper,5834,30,46,56,86,46
3947,f6891adb996d33b6ffffc9b7208b48bfca29bf5d5aedfd4fceae2e24eb692971,dropper,5834,23,44,36,59,44
3948,f6b0a13f7445685c7b30d9b3af0e6940cb77536266fbc1d1bb054c8647c547b5,dropper,5835,26,39,59,85,39
3949,f6b9b75526b902f85b3e041e53359211fd4571857c07ce56a48ee29dd9753b28,dropper,5834,22,61,53,75,61
3950,f6ccdf641eb8c36fa996ebd804e51e613589fedd4d4b097fb56ecc2b66cef281,dropper,5829,26,62,54,80,62
3951,f6cee821ef776096931e5f36e989862f4e210bf702d60cc26884aa6a39e9db00,dropper,5834,25,46,56,81,46
3952,f6e97609955b2aef1e7eebdce5fee31a92b7e340e9826293a821ea270d91c44a,dropper,5834,27,47,39,66,47
3953,f731a0920a5ecca097ed1d0cd554ed17d8e70fe155f8eda9178854239db31893,dropper,5835,25,38,50,75,38
3954,f74029b71284f1c54dc2b5109b6b5892d5f4e47e8c1ea38e934d002368c7f4f3,dropper,5835,29,39,43,72,39
3955,f74f3fa7016e7bc646a8fbec8c99626534a38ceee6eabec868cc2c821d73720e,dropper,5833,15,38,53,68,38
3956,f76d84111c5cc574c1248e3dafee624ca4628e17a363be88527195bfe8232206,dropper,5834,25,52,44,69,52
3957,f9048a78aef0330a0917ecc552c786209a8a85e937404b4af3412ca6b02f799c,dropper,5834,28,47,44,72,47
3958,f908ce76cedeb718f55cebcf0fec8d79a8581910d4ffe22fa7745f5e97aa657e,dropper,5835,17,45,40,57,45
3959,f9e476261c3e9a72efa0ef8143a466e6a187fa848b866353934d72f9a9dacb6f,dropper,5835,24,39,54,78,39
3960,fa02315db933a79bb629c38700c3e198f410a4a32beae886dd96f0ccf59ff23f,dropper,5833,20,63,44,64,63
3961,fa03e26ede1599611fece08d04318b7c2958607f5594746406e7bf06dd2829c2,dropper,5834,26,50,52,78,50
3962,fa40450af4e29921369f3ea7de1a46ad6bc535f89a94fc94384e93e157373500,dropper,5835,33,62,50,83,62
3963,fa6401cfbcdcefc2e064b876f056512d2afb203b7ead31319e695cb1f148ae07,dropper,5835,32,61,46,78,61
3964,fac6c80a609dbdfeb63c48fcc8fe3f77b16de12735fd7b9011131b31a38c8ecd,dropper,5835,26,50,47,73,50
3965,faeca3dbb2b02030843243d85ab57c7615a8a0363be626d3f80902977f51280e,dropper,5833,24,50,48,72,50
3966,fb63ee59aa03a046d149e3d4fb45e6c1678c1e4307f046c68e699558a5fddc59,dropper,5834,35,50,62,97,50
3967,fb78426c6c1c286789220dc1fcd718c34493f6f69d7696d8a2d4bf5959d902f5,dropper,494143,2004,3944,3888,5892,3944
3968,fb9b61c27585cee51883022b36b11c1ab4b1634d9c5f43d46ea83b7773859025,dropper,5835,27,34,53,80,34
3969,fb9ca03d9fc8f4ec52d83e9724a0561cf4e37f6aaf27c147c36ddc31b938c7d9,dropper,5834,23,39,53,76,39
3970,fbadf939055372a8e919c0ba1664c1e800a556dae9a443ebf178b31da09e306a,dropper,5835,32,59,44,76,59
3971,fbc0faae7d50002e55b0de96be5c161d6eb82a874490815bec60eaa04178bdfb,dropper,731501,3138,5782,5662,8800,5782
3972,fbc9a2abcf7bcbfc2768def862349ee247a215add28a8c6804398f3f18b9d528,dropper,5834,32,47,55,87,47
3973,fbf617102841779576e569383337d6c623607db9e994c9f2f65f0ac141d48d1e,dropper,5833,23,47,45,68,47
3974,fc07007ac55bd39f75b0aad4f3c867e9242c9780f838e904751b133fa52573ab,dropper,5834,28,53,55,83,53
3975,fcb93f2d5a52c6d07ac852ef4cef225408687d7fb174d1be8fdfdfc771bd968c,dropper,5834,22,41,49,71,41
3976,fd1cfd86803bd06aaf9862f79223509ce61a6efa108c415864cccc987fd5b618,dropper,5835,22,51,50,72,51
3977,fd42124e059d9e2bc98f749825b17d06f034c09e2ac281e3ffadb77b1c141713,dropper,5828,26,52,43,69,52
3978,fe021c58dba82cb5b0b4fc9744224005b539491da000bb117e7c76ee2b7870a2,dropper,5835,23,53,44,67,53
3979,fe3b8ad072e37e2344410e521947b84e22670432fc84c12ac1bb27de49803dd1,dropper,5834,21,49,48,69,49
3980,fe52a470d00eba8c09b7817c8f27c523210608749a608b24078e54de9cf05e7c,dropper,578361,2229,4665,4486,6715,4665
3981,fe554cc464baeb98fc6dbb8e974b88949986b2e218a540a8a484f5b2e45a4af9,dropper,5832,22,56,52,74,56
3982,fe5e1a5e6538f56ab70aa623457cca87aff7e186cf9f34f14f1dd2cac91a8226,dropper,5835,29,51,54,83,51
3983,fe9dced825b2d618281ed635fe5ccbc8cd0ee88695c02c4c06539b40d1a67cc6,dropper,498361,2052,3981,3910,5962,3981
3984,feb1882560d6f2aa69f5289e69a236d70cd2f753da7a56e8755baafe51cfc0d2,dropper,5835,24,45,45,69,45
3985,feb91cd90d8beab910b75de4306feff96e9af84c69564f611e88cacd77d9ccf2,dropper,5835,30,52,59,89,52
3986,fed7c78167e02e8d1dbc12c9d878be980f327fa8a9e7a28a89c8d543accf16fc,dropper,5834,30,44,56,86,44
3987,fedf47afa7dc0888933215c61da9657f548f11dd8aabf7fe532b9fc0b3fc36dc,dropper,5834,23,38,52,75,38
3988,000410b2bfdfe2a4230ef5eef68170244e517341ab51539f7fffc864e2d43202,file_infector,135610,521,1032,1078,1599,1032
3989,0018418a745a6d0144c49d9331c286eb879a4e7b9ea5e279d3176cad7dcaced0,file_infector,287735,1210,2296,2289,3499,2296
3990,0024016b48e4c1e6b4b68f370f37ce36c11ac4154379f1e18b237306464f6d79,file_infector,21285,88,153,171,259,153
3991,0099ef76b90a58bf015950a0156a8941492ff01d977838143eaed9e612146a79,file_infector,39830,155,307,294,449,307
3992,00e69042edd8da112ae14385a5e6073921b6d1596a2cd1faf7ece409036bf365,file_infector,28766,124,214,254,378,214
3993,016d9d61bc3c8043b7d8750cf9ca5d1e2bf1716b943593bb194a0df4db099bba,file_infector,35173,162,246,272,434,246
3994,01726e6781d3146cd3dd968238c54f0e9ba1b98ade1aa9b96299f5b36026829c,file_infector,57171,224,458,487,711,458
3995,01a3d0c2a41d4bc52c3b34a58cc1933c1cf37d4ef88f2293ddec3ca184da1419,file_infector,20312,85,172,147,232,172
3996,01bd0fa2f4b79e3a616d22e8c6dd3af4b113aee3418c71aa11e0f2c95b3c8b50,file_infector,25803,116,237,213,329,237
3997,02dfb6d5f6fcd3984da362cbbb0787cdff3baeae70bfc5bf2d0a26b28594bafb,file_infector,20918,80,153,178,258,153
3998,030eee54cbb503dc8fdc148564983accea6885a562576e697398759088b4f2f5,file_infector,21656,124,167,156,280,167
3999,03986b8336149283c4b9ea69aa58f9230a5abab793f321e7f55aca2ef42cc43d,file_infector,53425,216,424,444,660,424
4000,0414108591d67a1a400717a459cae254a6c4caf414e887dd0ac9028e103d000e,file_infector,83614,342,625,692,1034,625
4001,04335ad82a927e62981d0ea76f6a2456d35b6319cb314db035941d795b6484d1,file_infector,251052,986,2066,1989,2975,2066
4002,0466830dcaff0bc86d47e16ea88824248bbe3e23d32cf5efe3744091a18552ec,file_infector,54524,230,420,430,660,420
4003,04703c6658be2a72cc16b7d59aec30917b8191cca32bc63f8cea5800846da1de,file_infector,35233,139,275,267,406,275
4004,04708ce6d94abd6cc9b3791ec827ccf4fd436022d09a90fd920c92adcd252e24,file_infector,35382,143,273,285,428,273
4005,0489456488c1d07950dea762308e97c986a33a5243ac17545032ee47501d32ce,file_infector,26591,104,203,223,327,203
4006,0495003488d21e400f02740af4ef125fc62441e81fb16728cd655c12d2016734,file_infector,28807,135,241,241,376,241
4007,0496ece2cf567fd3afc13a67ec7cd28df5fb890baf1bfaa3f49f69e606c03d12,file_infector,194801,849,1524,1607,2456,1524
4008,04d8594204702c3bed12d29df9864905e280d6dbb7530509681c24054932f399,file_infector,251011,1028,2089,1999,3027,2089
4009,0559d7683fd90af97e9cb962f9d740a43e322d4e0814eae7d400e7015a117c5a,file_infector,52816,217,421,439,656,421
4010,058e1327f703cf976043a1ee5c98b1fab1646fc71cb5f74d71c2117b574dfe49,file_infector,26293,87,231,205,292,231
4011,0593fc4dabf6b9a7f0cd85f5753597f5daed891203c7f896480e9859c126d47d,file_infector,1571490,6312,12111,12241,18553,12111
4012,05fdd180e24d6dbe34e8022fdbc87e529df705e6975ee2a0dcd58541e62114d1,file_infector,19524,86,147,139,225,147
4013,0617626a76dce046cc23e3775f23beb2dc9b6f497802b5041787c70d70be6291,file_infector,38015,151,315,311,462,315
4014,06353e5597bc7b6a7b4881a6f3fdf3ab75b937676a064199fe516a2a6596dc2a,file_infector,22058,98,163,166,264,163
4015,0722cd2a549a2d0b8e4b22a9d69034fc239d70aa135972e0ecf81cf275bcab6d,file_infector,35717,139,292,304,443,292
4016,075c1c73fcac4f27e2d1f55cacd44f6caaa7c75e874de1343944c11d1646942e,file_infector,35763,160,290,263,423,290
4017,0766f1573bbdb3037ed202d7a7781ec6c70085bc73f593750a46caa25101cb67,file_infector,251228,1034,2016,1934,2968,2016
4018,076c9a60c613c139fa929b5d3ba5d43e5dacda74147f06ede3d943acd6a813f7,file_infector,38061,152,298,293,445,298
4019,077abfc33fa24c03a89d8c321f92bfed77ad6b0c29fc954b7cd90a064bd6dd8d,file_infector,28804,115,207,213,328,207
4020,07af6eeec357b16b396e7ab8b533c6466bbe23a05de26fbeb18f080eaa4bebf3,file_infector,53398,202,394,445,647,394
4021,07b562c8762e92a5e0ca07bd084f096834db23f7e1fd5aaee6bd675bb8aea622,file_infector,57061,220,450,464,684,450
4022,08175bdc2337bdfc9e7dee0103b1a10eb07f6f49ce4d82d3bbf0ab45aad4308e,file_infector,440061,1718,3486,3530,5248,3486
4023,089dad31bd440062b90ca8e6c5ccf0ba858d195cd21c56fdc3e5314cf2b9cd75,file_infector,19116,76,142,105,181,142
4024,08b03bc304858f2885b6c5478be1bdf2bab3e1baac54f1c3c000a43cdbe1af75,file_infector,35543,129,282,289,418,282
4025,094d57895d196456123fedada6befc465d102ffc7c35869d92b923230f7f6ddb,file_infector,34006,122,240,311,433,240
4026,096abdc06b1f051823bf04f2562511e07f0a912e63f093e7bf9b69f639d52346,file_infector,132793,549,1056,1074,1623,1056
4027,09ddc6e3193c1ee03895e9c876c83df4f0b20b52963b7ea587cb93853bd5f9a5,file_infector,57216,196,465,453,649,465
4028,0a2483b1741b160c41abdb8f3b780e3f80996b0bf4d8fd7c0e54013652fac519,file_infector,37971,136,292,333,469,292
4029,0abd6cef5fa6683ddffe50ff91fa0461bcc8ed518468c65e29d95e00fe80385e,file_infector,20542,82,149,158,240,149
4030,0ac4ea47635ae8da0cc499e4b05a04c1c7f0f50acfb0a772eaf702cfa4ce6154,file_infector,28764,103,243,253,356,243
4031,0b0d893c74646358a13c7a9ffbd31bd1ba33a157336422af807a2a3e15f075eb,file_infector,105268,444,941,851,1295,941
4032,0b208762a9cb08d4e4c5c4b20795f4bc7e6cb2075a6248aee0efefaff45cebb4,file_infector,154761,661,1118,1260,1921,1118
4033,0b2615b9a43d022f17cdf1df9d90502441b8fb9b620c22ea009b77724f2e7f77,file_infector,33842,112,231,303,415,231
4034,0ba01db3ca572e133f7c5e07ae8034edc412f15da093d2c71a619de450b40584,file_infector,28407,102,232,216,318,232
4035,0c35f83753d044c84dc46bb617cace17b72177d67b95bbe063fc551b3d8a996d,file_infector,251212,1092,2052,1903,2995,2052
4036,0c922c11c5150465cdcda47c4f9bbebe9c9d27ee446c829b5e1add0ab21ac488,file_infector,21830,113,140,194,307,140
4037,0d398c3d7ed53cb42e60bbab164d2ca2147402a82c64894b88030ab53f4a5934,file_infector,58718,241,482,437,678,482
4038,0d45d02a60c0a0ac424652b394981ce90cc6ac1ee8d7235f06c52079a9ef9985,file_infector,349571,1383,2741,2739,4122,2741
4039,0ee3c55712b72b7e2a7a8fbeb57eb4593a6dcd88d421177be24abdc6e95b1696,file_infector,56970,255,472,488,743,472
4040,0ee8076b8fb6ef750311076eaa64b20d7e124a81366c9f66bd683290a0241884,file_infector,54679,221,422,474,695,422
4041,0f4720423680650854116a9c6b704f60b5dd43c5add8a4df49250b7bae26e0c7,file_infector,250855,1100,1966,1946,3046,1966
4042,0fa35e284ad238721ad0d5b32bed132fcaca766efec899415df103eeee297754,file_infector,529260,2168,4253,4388,6556,4253
4043,0fadcbd0e2b0aae1fdf672517788b2c8d42ea15b36bcf6877021c2054e170ef2,file_infector,37992,137,284,307,444,284
4044,0fbf50609f56d6c990f53755f1f23353b442236b203755b4927a0eba7fb1e443,file_infector,57029,205,483,498,703,483
4045,0fda0cddfbc7898c9302783e5418e05164cd3a105795f5d19284a110e514e3cb,file_infector,34787,139,253,275,414,253
4046,0ffba02d1d5f0f3caf7f7ee014a2dd6e3ac6c98ee201f7079ac7e023d2c69932,file_infector,1571418,6358,12262,12281,18639,12262
4047,105f478a901b1c67cea20e8cfd660ac1872c8442b3fa79df7f31eca34ea7af49,file_infector,1571304,6344,12302,12223,18567,12302
4048,106f9375d7f1888ae610499c6ebf183abbb4389ef2d6a7f8c9fad6fcd4daf202,file_infector,21139,85,159,156,241,159
4049,1076152789d40075e3aae71d3cd0e5693754a3042254c19832c93e8a5fc19d15,file_infector,251153,1019,2040,1914,2933,2040
4050,10a7dc51537ceeef0c713a86bcf641978d05ca242ba28ebbc15382de296fa4c1,file_infector,83556,331,645,714,1045,645
4051,10bcc042bb426a90adbbc0ae8219b769fd00cec095887e57476787efbac7afb0,file_infector,22090,105,148,182,287,148
4052,1135581b1dc5e3ccc7357ac6e4ec2f69cd5be9abd564e30670a4901e4581ef04,file_infector,19086,63,155,145,208,155
4053,11faaea7bd4c7767b68726fc8db5b5c703f5e8c509f5f14774cbe042a64b532e,file_infector,53521,220,422,459,679,422
4054,12158d97bdf573514b7e5848cc2d9ba6591bea539136ef0afcf7439ac15bb684,file_infector,22526,74,151,183,257,151
4055,12aac42ff29b05e0caadfc16e1d60d8074b5ed7b807494a51867167e901c4a3c,file_infector,38086,121,299,328,449,299
4056,1348be95c2e723a029a6dc34250eba62682cb3339dd4851efad8fdab5bf66443,file_infector,28947,106,224,216,322,224
4057,136c1d1ec0d97ab5f5231b6f407f0426adcd3642b2c97454267d5bbc5c989e92,file_infector,105244,456,916,873,1329,916
4058,13983363a25f6ce0486c725895552c52e4319e32f5e67bbb595ab546f0d8f319,file_infector,57807,216,494,470,686,494
4059,13e22aab0f98ea1704b40592c43c3e74375b0730ab6098584f887b53418881b4,file_infector,28952,144,257,227,371,257
4060,140a7ea6cfacf7a2a740bbaf537768a30c2e01580458bac37e0fada52fdc80ec,file_infector,24699,92,205,218,310,205
4061,141f272d791ed26e71a4b21f252f96f6a8fbf707b0f7e061fc5c04c89cd6765d,file_infector,251169,1006,2104,2004,3010,2104
4062,1451b83c5eee49dec0831d2403c556f90f835b3c71074a622317dd19b9fc3fba,file_infector,37971,134,287,338,472,287
4063,1459ef42ec73ad6680c550e5916d3468f46cd5c7c08cbadee887d9a56b59fcf3,file_infector,21586,99,153,203,302,153
4064,14775d25b64ad6c78cc54dc10e8e733b1b1f311549b5d24a51ad0c05187f2c9c,file_infector,20590,87,160,182,269,160
4065,1486048ad2cf12cfc020ef3e7e253602f7d849a2e425fef0cb6761ecd1eebb39,file_infector,24407,94,185,205,299,185
4066,149ea1e87200ad9b968c228698434f2d33a26ebe7c2671177d4543193b8c7b77,file_infector,34979,138,292,282,420,292
4067,149fa1144ad06570b1a35b31add15a19b946910e356772c3113720b7a44aa917,file_infector,21911,79,153,161,240,153
4068,14c742daf12be49903a374bdf078cf63b737b2328d684f57d94118d3a0e8df23,file_infector,24961,87,206,206,293,206
4069,14efdad41d67e67d9963d483491534d462e440658e28a5407c97ecf94a6c95b9,file_infector,83593,371,674,724,1095,674
4070,14f28d7fdd3c5822d4b1a2a6476aa905a3cce4f2c5e3017c7dfd82f8f1ff960b,file_infector,38023,135,284,313,448,284
4071,15038ca2e8a8b5bfe58b2b6042bac65b7d4bdc001143ce7005b84cc71e2b0b52,file_infector,1571377,6356,12333,12277,18633,12333
4072,156cfeef0b1c17102fc7bc82fe49cea5986a138a2d3502f3f3dc4f7ca5bb66bb,file_infector,20904,75,198,153,228,198
4073,1651e9ee6669b987ad61cbf83446f0a70ce5dc5fe5f0b423231d7ca81b128553,file_infector,22685,120,177,190,310,177
4074,16b9be7a81ca4e89c57e49c0760bddaba1c4ebb1032d5d98f38e8f1fda14a12e,file_infector,50517,232,418,388,620,418
4075,16c910aa5301a03a7a1a34715bb1290c0db405d18625e35530d315d2a40703c7,file_infector,36950,149,303,324,473,303
4076,16e400dad1a04b6913dd568a7f6df5e28078d7da8e590009d21f65f87856b422,file_infector,24725,110,204,213,323,204
4077,16e5d11187e9cf701cbee658367afe1ecc38903c6727316c01dc3321b0b48799,file_infector,251091,1008,2069,1991,2999,2069
4078,1747640adbeedf105c7543693a298f40e7657f9c5ffd81958c9cf0efcaad30d4,file_infector,48935,183,355,376,559,355
4079,1794b041fa131417f6c82a22979ffa1390d6b53eb317f7015e66df4f52ee8ea7,file_infector,26765,96,229,209,305,229
4080,17b4e96689ea1952db24e0477ba6b845d2d7f194019478f0c9ee4c025bfaa29f,file_infector,53088,207,427,420,627,427
4081,181257ecd1d66ca7e82a666bc05ba54375648b0057da8101108c7851b4ba2837,file_infector,24561,111,187,186,297,187
4082,1833a7e6278a069139f06650990ffd055e8f1203518da5615878c49e4a951c3f,file_infector,105142,437,910,917,1354,910
4083,18372596a35e6a0775ad210fd86881d03fb8f1741cb6a2753538fdc8bc874c05,file_infector,19004,67,139,143,210,139
4084,184804ccfce3939a76ebb07ce6c3a41d9804abad5d1e9f70c513669dd8bfebee,file_infector,28710,121,237,200,321,237
4085,18484cb360bb0e52652dc88a75f74a5d98500236b8d5e95f299565c72a440880,file_infector,28786,121,214,247,368,214
4086,1861230053c9d644a85a403fb4c39ea40b987be2418b7df62216311f1598d45a,file_infector,112580,473,898,953,1426,898
4087,186d6614a7e1acf124877afc37561add65c0dd88af20e356727ebbc49e897177,file_infector,28849,124,238,236,360,238
4088,18a4a101dfe68906c261b65a1469ab196c3906f5339fb66c7a8a4b2208cdfcba,file_infector,1571283,6281,12321,12282,18563,12321
4089,18a4a54d660d266e0fe3731048682ab9420631b2789063c17a1423d1cada8ce2,file_infector,56037,213,454,490,703,454
4090,18b216e43efde13667d052847d7dab8b557d97f750597f503c6143b2a492649c,file_infector,39596,155,299,319,474,299
4091,18cc10cb3a9d53e58f29a3f2857952bb9516645525eac3f47893a5f2db8746d1,file_infector,28744,120,253,245,365,253
4092,18d6064a7639c8ab106447b18007a947177d60a357a93212cb47e903d6bf0397,file_infector,56926,205,420,468,673,420
4093,192b7b310da9ab2f20d7ec098a43d2b9b566f732280355b62e46bf65397c692a,file_infector,33490,161,243,266,427,243
4094,19665d38093fe96933670611a59440ec59f452b3d26c273803f2a415359ef63f,file_infector,34797,137,277,263,400,277
4095,19b976989ae84b5f2ed217fa8a27c64576cb48f729e9f24c105bb847de172f92,file_infector,23916,98,165,227,325,165
4096,19d57c3f4ddfa84067acf5e14dbd910e1d39a2edb7f8945a1bd9a875c76910c4,file_infector,53272,191,382,435,626,382
4097,1a82f8edaa7408249074c2bbb5f37080370b3ded9f35ef1de96ed268e47e7220,file_infector,350027,1440,2801,2795,4235,2801
4098,1af1e5296904fde31e33477824e427e12afec6193a5c90bee22e118e07f48fd3,file_infector,57116,251,448,485,736,448
4099,1b6a34e18aea5ba66e993c25fb1eb91d508cdee6202b7dbbb6cf3ad375e393c7,file_infector,28738,111,220,244,355,220
4100,1c08d094f916d28ae2082b55d1212c03bcea5bce06d7504b5306b63f36475f63,file_infector,26670,95,204,229,324,204
4101,1c3ef9e84326d1a2715f0d9799411898ec456d1e754cc55dfd3915f253f11432,file_infector,39032,129,302,300,429,302
4102,1ccc4d6ed94765b420a625a5a1475254b096d5b047286a7a9b388347a61a4b82,file_infector,126320,499,984,998,1497,984
4103,1cf7f4aaa1a69feef00cedc4ace4d5c64e064ddd3caaccfff6c3974fc7650c46,file_infector,251081,1031,2118,1984,3015,2118
4104,1d4350d2642e120542de9898a2a62da5f9a5556804dded273482d23c6abe93f9,file_infector,331133,1278,2700,2657,3935,2700
4105,1d616f1d065968ea409c00c5965266527168000cd500a28f4d95da037a2cfa2f,file_infector,1571361,6254,12275,12226,18480,12275
4106,1e1853c897c2d1f2baa768431ae55e1c52949467e88feefb64e4dcf6931b5a69,file_infector,141747,565,1087,1119,1684,1087
4107,1e42e0e21d8364b53c5f8c642692867f7ff351a91a516f0780bee8589884d095,file_infector,58819,210,453,498,708,453
4108,1e49e340367e93648f120ac1a0d47b1fecef51c5e590dd58a3e3eafe368d7293,file_infector,144495,634,1132,1189,1823,1132
4109,1e7509c2347e8d35e9bbdc18dfb8f409f1bbbdd020497a4782c2d9166869ce84,file_infector,57543,229,479,527,756,479
4110,1e96b607355462d89ade25a9f37e61615b436c04f9fa1c8c63b1cb8122d6a9f0,file_infector,349130,1466,2818,2796,4262,2818
4111,1ec76dc23b4c78b406e87d463ebf9c78a5f528f1802fa84e70063f0c512ee7ff,file_infector,26358,105,195,224,329,195
4112,1f0e1c307b5d747b1b1cf3a8c3b85e213681c84de1f98b7a4ff6530b59f0e9f1,file_infector,53390,223,434,409,632,434
4113,1f1c5448bb3e7fa3aa350becb5b58ed9b452214191f5b449d454e6d48eab64cc,file_infector,1571194,6194,12283,12256,18450,12283
4114,1f3bcba68595d5d3c2da78d237662e7729ef6b7797abfaea4a8db851d4b0f395,file_infector,37968,152,274,318,470,274
4115,1f75d7300a732256e5d5f5118fc2f28de8356777193f5831a4d9965eba6382d8,file_infector,58794,184,470,492,676,470
4116,1fe3865e09178a804803b7515bcf0a08c958b2af752b2edb1639b93e002e0bf6,file_infector,37970,131,275,290,421,275
4117,2007855deb504b0e679cf833cf88d1b51c3d799c383bfdbb7642bdbfabd7e7bd,file_infector,108974,434,839,851,1285,839
4118,20123b0eef82b2c32d3a934c1e710add0e5665f723035cd13df5a96a06126c33,file_infector,439956,1686,3529,3447,5133,3529
4119,2021ae1a47b91a5b7d4282c97b853eb982919a257b6b2e42fa71ca265e086d18,file_infector,21535,87,147,172,259,147
4120,207cd3e0b6be65563ac910f37f3212770afba0abeefb430ea7027ad80f4564d9,file_infector,48943,189,399,362,551,399
4121,217c5874047e55b9f51c066cca27c4ec68ea777c4eec7c14e7685ee8bbefef32,file_infector,1571422,6342,12334,12294,18636,12334
4122,21b79cf6aa47074d96a3ba253c44f3cce19377ead0d9692c980df67958c453e9,file_infector,1571297,6322,12311,12312,18634,12311
4123,21c7f252332de55e2bdd066048e104e19d8c7d6b63d51ba9dd8b0e61b29ad75d,file_infector,37986,145,301,318,463,301
4124,22107ccd350a6b8ff6ad7d67145f49a20a0f63e810ebab6cef844fc9322659ee,file_infector,20625,66,182,172,238,182
4125,22583ed3ad5b2ac195e97506c431d7da687e87d15d6b4a31bda93c3bfd71f96a,file_infector,28751,105,257,208,313,257
4126,22a5c29b8b43b289b3c2ae6283dc0e141c91c0e416036e01856b44f9b8dd4541,file_infector,22430,80,170,182,262,170
4127,22ab650652f0f1c4eafa0ef814d21e5620d00d89dcede8676909ef731a1b332b,file_infector,83536,322,655,727,1049,655
4128,23456880a4aa8ee8e894aec92f5bbdb030551814384e3176fac5b78549f3974c,file_infector,57114,230,466,525,755,466
4129,2373d086eae4e34b7dd0021adb5109e6cbecc18721ccc6f9480a87fb0bec1f78,file_infector,21305,84,151,147,231,151
4130,23b2ff18440b3c5e8950f41fff847d8affd906abead82c486e0a703b7faa48e5,file_infector,131348,548,1036,1072,1620,1036
4131,2413dafe79b23c5f9531c6f42ccd18daf997559d7c86780259bf505386b5b7ab,file_infector,116912,490,964,890,1380,964
4132,2446219e9b997317fb387adf9730da70ff167fe295310d057db6062240fc96bd,file_infector,48981,191,385,394,585,385
4133,24b4d979cfbd8e12369592a4c77ce3c7bd2dbc15d0d1bb01225b784bcc6b55ba,file_infector,251156,990,2100,1985,2975,2100
4134,24e690dc2779cc3c01ffed37da52b2aa0199ac7380110cd7cbae966d03992fa8,file_infector,83578,322,682,713,1035,682
4135,24e9c1571abf30e8bfc1b16938925984c2f5e4434a0b9c684c6118f21391b419,file_infector,58728,207,490,469,676,490
4136,25ce6d7b9d081a23e717ce6e6eaa6d22b327e734f23cf92045810f359d7bac43,file_infector,39790,139,287,308,447,287
4137,25fc224a57bab85f1ab33e0f4e84d95a9dee47a43de7d1b96958eb1bc26bec63,file_infector,34703,134,304,275,409,304
4138,269bd2e5c688323303d24c4029b4b78a2a7f31317251702db23b2b67c0b6b4f1,file_infector,24973,92,197,216,308,197
4139,2706536ed78b03308eda1d3d9cda4d4adeaf4243794abea87dec60dee87e0580,file_infector,83523,317,617,719,1036,617
4140,277e108c27a7905cef4707350c30c4504cf9630d501a15c5b29254f1deec67b9,file_infector,35260,165,255,311,476,255
4141,2808bdfb3f8dd6c99fd84728308a6e019462092c841f16e8d125441fe57bdd3f,file_infector,130465,522,963,1042,1564,963
4142,283ece9088162a2ce46e4bad580f2de5f5f9cbd2af78d4383767d741415baa27,file_infector,97010,370,789,811,1181,789
4143,28966323f961571b938ab862a24af362523d2c9cb62575a9bd3fd357d5426b89,file_infector,24689,107,194,211,318,194
4144,28ccf8d336772a6e395f2e1f42505f488a66f04a8136fea3411da3cf49206fdd,file_infector,58741,227,483,454,681,483
4145,28d37683334f6ecdd39870f98aef092060d4a415ff1e207e6159a651d3538750,file_infector,35193,154,257,297,451,257
4146,28ea550ffa81e0adaad4d6f8652cbb861837fdf7f2dedf25201c48617793a5aa,file_infector,28739,121,208,232,353,208
4147,28fd7cb053c80ed73e7017311930d3222f7326c45305abd31ad3072c24ddcce4,file_infector,530569,2110,4148,4380,6490,4148
4148,290911e8e1af82d0ddaa5ae92911d0133e97cf0ff920cb6a2fe34100b07a27b3,file_infector,28742,128,226,249,377,226
4149,290bffa805b4fb4acedee7d538cd7322e84aa20edf75d8eeef7ef354041f0fa4,file_infector,57398,250,468,480,730,468
4150,29284e93e6a29a8eb2760a2e1a2ea8b65a46badfa9da1a5eac363aef1fc5af02,file_infector,57186,263,476,468,731,476
4151,292c2d0081f890914f4c98937ef3323939f8ab318916ed9af06987766a848f24,file_infector,390889,1601,3137,3213,4814,3137
4152,29e6ba03d50879c66106654ba394a2bb191da18f3ccc5d27718e66fd7cba9b02,file_infector,58748,216,492,460,676,492
4153,2a7a6358ebcae745251a465683d29e33ff12b813bfd7197533ea90be9ebbe87c,file_infector,465615,1942,3675,3800,5742,3675
4154,2ab3cbd0ecdde0ba3609d21c8ee43493eef6b784fe8cdc62de62794d03822281,file_infector,1571285,6330,12290,12288,18618,12290
4155,2b30e718bdf0271af21ad5f16c1f1e25d673ba090e9633af85d02b8fdb4a4cdd,file_infector,26311,103,221,207,310,221
4156,2bd366aac5cd747b174fc692d75ad3cea6b6404bbeaf0b78b20638012fc3e5c8,file_infector,346870,1400,2760,2812,4212,2760
4157,2c038e19a64d3146282684f10640fc37d863362a6141d3098328533aef25b149,file_infector,37954,149,286,314,463,286
4158,2c2f4fa6965e5c734c8f24c807c5833ceacf409f332965811454a72847b8e124,file_infector,33968,115,275,256,371,275
4159,2ca6275f52436a03c5a8652ca6015833221a583c6aab706c5fa6e058f140a70d,file_infector,39838,148,307,341,489,307
4160,2d2d5d8a49a2cf1beccd3af61643db5493995e8d3a2ad3a29dc5d68062f761f1,file_infector,35132,154,279,281,435,279
4161,2d368dacf2f5953d1e597930df8a9953e56802336e6ac034933f7b1c7cdcbe60,file_infector,135570,526,1060,1076,1602,1060
4162,2d3e8cb679fc479768a162a024e78a9956fd15a2adcbf0228161bf9710637e60,file_infector,48837,172,363,400,572,363
4163,2dd35df3179bb8c2a5f1c965087e19d7ba8b6f515096fb2e23858b057983ed6d,file_infector,24487,102,187,222,324,187
4164,2e1c646f8c470b00858f60a1bc8e3eaa61129feee803a29a49ea0f90c5585b94,file_infector,173094,774,1294,1434,2208,1294
4165,2e98042259fedeed8f2856dc3b3e9e5b1a6300c7fca29b89ce8600caed1e8745,file_infector,222317,908,1652,1803,2711,1652
4166,2f2fa984edb136481ef76e752ac36a94604f49577813dd36936879d03e73aba3,file_infector,50067,197,383,369,566,383
4167,2f5fdd9be945b649d3ca9bfd5b016216c5e7f8c099c2656879365b679b97081a,file_infector,37973,140,264,315,455,264
4168,2f6c737351250962eeb18a836ded1d0a74b31673eb6842ef82b6941f3fc54991,file_infector,26295,97,181,228,325,181
4169,2fc86a643bd735300b21fa5689bfa891ece47a58e43cfc1cdcf2bf4ae8b82980,file_infector,54653,208,426,446,654,426
4170,305deb0e4bdabca1c9e6b6e0700d647da1bc9211cfa02d94a679bab1224ff066,file_infector,38027,148,272,305,453,272
4171,30adc68f0051369aded82ae1229b44587bbb1e4ed91be9b3f289f18b2c301081,file_infector,20884,85,176,166,251,176
4172,30c2cff93866ff8d3806ec7574ea4eec7d23ae7438c275352dfea864b35a5db9,file_infector,28691,116,210,249,365,210
4173,3162538952d1cb91a3663d9fec120a536834b960475d3cd18ba181a72d14f6fd,file_infector,37981,167,266,308,475,266
4174,31b629e95d611fbcfafb51b4d0825e3e89364cc50fbb811165111806ab90413c,file_infector,48942,206,396,400,606,396
4175,31f273d52eb7286ab5d93c716a5ce29df62ec29d893e9f223ed021b342c2f122,file_infector,39834,157,343,333,490,343
4176,326de061aee6a63bf1a6e3d27e89f3bdbe58e6a40fa4b919f0c17a396ba86477,file_infector,349142,1433,2771,2779,4212,2771
4177,3275b3430b940d6d34ee483d19655071f40ea79d3e1fe121b88351fdfff41c1e,file_infector,57125,242,461,467,709,461
4178,32bf0dfe4883a641e3516247a9b13c4e8e1c68541dc7175f68be05ecdd4c85d3,file_infector,33575,151,272,268,419,272
4179,336db904462ab2bb376e1c80ff775f9e1eddc8edd5a7a475fd0a6402c5026b41,file_infector,38003,141,316,307,448,316
4180,33988fc6a5ecef5136450cd2603c5a90f3d2a34dace8e1dc243dc545b4d0845c,file_infector,28411,111,234,238,349,234
4181,347ac287222b3079c76a9c816044442784e7592f560c9381cfeb1b54902e993c,file_infector,83574,352,676,727,1079,676
4182,35516d44121f1ffd7185016d5db8ee138e7f4cab3f9dfc886b55c8042def9bcf,file_infector,35347,134,285,305,439,285
4183,3560cf04cf9635ddc06a097a47549a725095725ab2509f7feff478250c7f98cd,file_infector,38024,142,310,300,442,310
4184,3685690dc947408c3c40c42ae8531bfb07e059d8aca7b964fce470f1b3acbe8e,file_infector,82456,308,661,660,968,661
4185,36bd36839faf47355e0babc1a233e4da63687f2bd55bd0f9c34a063aceebee2b,file_infector,53278,248,403,406,654,403
4186,3750feb725f0d0b23408d170d6901a666d2f69e590b2debfc77f3b6bc3469321,file_infector,20943,71,154,183,254,154
4187,377b991cb769535a384e5c4612b411c24b7159f10af1cc194b331f839f775e01,file_infector,31364,124,253,263,387,253
4188,37a97f7cf789bea0f8b4e82c6e4502f4bb03533ed4901a7c0fb7ca5020f8ab05,file_infector,1571396,6379,12281,12270,18649,12281
4189,37aa3f8c5587ea05ad816f5f1401972221766a7fb3ff00fff85132b61e7512ea,file_infector,1571401,6306,12277,12349,18655,12277
4190,380eec7c4b66accbe702aa52a390eb3fdf611923be22ebc93ac67ba5a815ad55,file_infector,105139,446,915,865,1311,915
4191,38278eae6d0fa1677d5b8dd721f791b398107ea642cb1df37b8a1aae87cb798a,file_infector,24192,87,198,174,261,198
4192,38491f1e4ca9dabd355db6d48218a6bad9971a825852f801e5575e5828dc6636,file_infector,21395,89,169,192,281,169
4193,384cdf092ae60e7ea97029c975aa1147f7e7e84b96143b65b79c3052896f5728,file_infector,552923,2551,4150,4545,7096,4150
4194,38b961950e4fc4fc0fc572dd317e04ce98ec00c348df36485c91476d9507356d,file_infector,57807,246,475,525,771,475
4195,38ea87b7ff83dca619d2f7503fbeb275bcf18d72d4b60a2640639b0436e6b790,file_infector,38034,137,302,284,421,302
4196,38f2dfe2a65ebfca672e7bba52a245c739dd6f2b86bccd7f09d68a6a2ebf78e8,file_infector,56997,232,449,500,732,449
4197,38f9bae1f4e07b762ba154fdd9514f62fc7cf9c6028549faeb077cda47bf0497,file_infector,42731,184,301,351,535,301
4198,3929ab28648c7282ddd77a755b68883b446a17a02c8cb970ea5e3400501230da,file_infector,28782,112,213,234,346,213
4199,396bd7c9e9b6bdffc5ee1d3c80a4fd0e4235fd20bc5df5dc6bf697f88cc2f404,file_infector,24330,101,183,216,317,183
4200,398f322ea0a819c6385f916e3f1a9aa5c84a90386c5830f0bfd4501e9e437d23,file_infector,1571317,6254,12360,12277,18531,12360
4201,398f4224e024c8de61e4351a5762319592980981570f132f22be0e9983e48620,file_infector,1571309,6325,12312,12251,18576,12312
4202,39c243d9f9fb6f854d2728e7152101616effcaa9f243d50dfd231be59b3ffbae,file_infector,53658,219,414,448,667,414
4203,3a2de92067c19876781a6524e43ddbd50c96a22a5cdaab6909436073007c08a4,file_infector,134748,543,1135,1096,1639,1135
4204,3a630aca1677cd17b80f112ac12bd9c7e6b1973aff58edca18290cab3fa78247,file_infector,21782,78,178,176,254,178
4205,3a86b9152a6a90ba045785d79b473304fc4d527439203746879901986b456827,file_infector,28890,123,225,211,334,225
4206,3aa06ee98d92da87c0d6b41b7f421a89aea86305f64a09edb6b6c7b652d5ca24,file_infector,1571314,6299,12224,12261,18560,12224
4207,3ab62a40006bd48b8c0223aeb6da55b6b16ab9b041c38d643b0a4900635ddf23,file_infector,26114,121,206,208,329,206
4208,3ace654a2322f3bbcf5266065d0166f95bb69da559731c750c4c7efd411217a3,file_infector,24747,109,183,205,314,183
4209,3bfdd9cad25f84b0fafa7d6f07b3d19727362cfdd8c56e9321aa6b284a8b1ea0,file_infector,53676,223,409,402,625,409
4210,3c24ad380770a050dbb4e66bbeb79a261cedf3914de23e55abbd09b7467056e1,file_infector,114582,514,898,888,1402,898
4211,3c3a1cc88258bc28ed1d04a53072f7a154c6fd1639ec178cb20e947efe7cea97,file_infector,31246,143,244,260,403,244
4212,3c4f721cf59f86f6bf3fd89ce46702176f63635fcf38456f13e93ad153e9e6ac,file_infector,1571299,6216,12308,12299,18515,12308
4213,3d5bfe02187f444b088dde21e355b6003fca2818c82968f543049ac26165271b,file_infector,26438,101,223,195,296,223
4214,3da3dabaec1e4884db93f94ad098b6b8a35f872e6be3eedbc80fd60f83b17201,file_infector,26069,94,185,229,323,185
4215,3deaafb3c23f37816e5da7a6eec769b6f482fffd5fdf9d164ec908207182fcde,file_infector,38103,146,286,317,463,286
4216,3e2b9cf43494cd377c4ee8a6f680d70ad52f958a2990601903b4f2145940d680,file_infector,28752,135,226,236,371,226
4217,3e81db845ae57bf630990abf5773a86fecbb0d2acac7af63c50ead5c844895b0,file_infector,251075,1037,2096,2017,3054,2096
4218,3e90aba46229ccdd6340ff793f890f095316d4164c15ca86b3e0d627b6e7fe82,file_infector,33935,126,295,257,383,295
4219,3eb62e886f52ce201cf78a7c6f843276047cdc9efff390b3db1bdad466a5a4e8,file_infector,54648,212,438,505,717,438
4220,3f0dc3ea64562ab20f18d1ea958ef88ad62bc1335ebcb74045ea14c6a260da21,file_infector,24378,85,202,224,309,202
4221,3f6457265c02e06ca5dac5f98ebc41f68b5e0065e0759d23e283808795dd0daa,file_infector,176964,705,1415,1466,2171,1415
4222,3f66d6f7bd892393d4df9aae2854863f7163b31e2ea3d11997372c2ec85d045d,file_infector,83547,339,686,715,1054,686
4223,3fd353969f818a5eeaa3aa2230fbb2960b27519ab163f6830a3447554b594adc,file_infector,26628,103,195,250,353,195
4224,4010eee35eac39752a48fe0a05cb1b73ac0ccc4331acfece55ee6ab2237f6d8a,file_infector,34871,139,289,266,405,289
4225,4081276ea36adac2719c4aa877386f954bbb4b29dcab25382c121a9a4106fb4a,file_infector,56968,228,439,504,732,439
4226,40d87835fa97bef11dedc7f1b284bc72626714c9eed6eaa4189dad86e78fd422,file_infector,26730,101,229,207,308,229
4227,4103308774938ee50dc00cecf5f3451ff7baab418bfce70ee2a2405c0d7f426f,file_infector,29666,120,221,259,379,221
4228,415dfba82c8d7d7bd6ff240a01d320af9d9b4b1d2441b7b3eb1d58aad393ee6f,file_infector,71704,265,588,534,799,588
4229,41e33883d5729f83883532530df653811b4a02b94701e7bc04b6698a9904e567,file_infector,102561,421,822,769,1190,822
4230,42175a64fc38966189995a7e92ca3b99156a1ad96201161584c191a1492458d6,file_infector,35243,160,273,261,421,273
4231,42364d16de97cc5afb2a5e4a601f7c08823c8e654c137a18a5c50eab74c8c2fd,file_infector,28726,108,240,230,338,240
4232,424a06f76b46b2d9a87daec4ccedd3be0d923cad72dd5a78381090277e5bfbbc,file_infector,57155,255,450,466,721,450
4233,42c10b5ce22eaa2e52929a8456f891c5409d6db0bb0ace08386bbf61813ad8a6,file_infector,330990,1318,2761,2726,4044,2761
4234,42e803124ec976a5623a555d74477ba8570723d00ca142608fe88b2e68e88660,file_infector,58743,239,484,444,683,484
4235,437e5d079afc2dc17b19decc45039e14c08285c5101c15d653b8c853252f3c26,file_infector,26117,128,192,194,322,192
4236,43ad0e4a586008cc86fd960d7323e8c86581c824e9f38834ff30ba187c97fa8f,file_infector,37980,160,269,315,475,269
4237,43faae3fffc6e90d0866160674b7be442a402f023905275daad210ac6d4a56f0,file_infector,57069,256,439,475,731,439
4238,4464e823093f5959c4944502e9e5925e6344aeee3a4d90863afc4e531b00e707,file_infector,135441,581,1034,1087,1668,1034
4239,44dd643e4014639624cdcd2138a7e4aba3f47bdea04f437b9713c2bede919eee,file_infector,251046,1041,2005,1943,2984,2005
4240,450802f899a442f96d5415943f76a502f7165497bc27b1b067cc296fa10e6f2e,file_infector,35311,139,250,276,415,250
4241,450a64f20addb589f4386b83dbdedf053fc79478385d5709b0ac03b8f7ab818d,file_infector,38010,127,276,346,473,276
4242,452122fcf9dca35e18d5a19c7357e6e162e61fec64e7fde88069dcec79c68e5e,file_infector,22327,99,158,171,270,158
4243,45b95be3b6d5cbd496a15c66edb7ad7977a8bdd7c4e7ad9ed199b6360b963ce1,file_infector,58768,223,455,497,720,455
4244,45debe45d6549e0412dc3d2bb6f705fe933e224e0708cb190a2c6d301941974d,file_infector,50623,219,390,412,631,390
4245,46057d69eefc8a797e7f342aa6648722345839a57bd614f47f3d51caee99942a,file_infector,20342,84,153,174,258,153
4246,467d2e6847b5e74026ac7e37222fa646098a0ba918138bd23c7c57c5ecec7e22,file_infector,45180,189,361,383,572,361
4247,46bc07d7b756d86322f0196ced46585010afcc3618c3afe2d156483ff8d39e20,file_infector,37993,139,276,300,439,276
4248,470d3447f02e40438c1182f7cd9721b8efa53f1ff470f96c41fe9852fe6f33a8,file_infector,35171,146,287,284,430,287
4249,47803991dd7facdd5ed83e149089f06f6422fc2fb870bc634000a1b2fb012952,file_infector,26353,119,207,220,339,207
4250,486a6be80164ba0618174d761338af3ca84988edda50a710c827ab48dcb6a8c8,file_infector,28720,121,240,218,339,240
4251,48ac8210ed3daf11392f10d6e4d449953b905a757181023f1d1b41f9f2aec00d,file_infector,29730,101,223,232,333,223
4252,48aed9c712714562087347d594b73be0e6d59cbb26889894602af0360c3bf7e9,file_infector,28937,124,252,252,376,252
4253,48ea27fee164833daea02b49f1de58d44d54e6b6597932652bed94d435de8589,file_infector,112288,446,869,874,1320,869
4254,493bb6a99813494269cd13e7edf03c135e9181afad2ab95c8c54d41718cfe8db,file_infector,57241,218,434,533,751,434
4255,495bf572dbebbf597afe4ab81a4c70fc0f7fc9f18373bb0a929bac4f34c70a6d,file_infector,76194,295,577,613,908,577
4256,4998ac01114429e5390124119378dcd5b3862999de57fba8abc8b46b5e3778c9,file_infector,23099,86,192,205,291,192
4257,49a674b8934525edd348c0fa267d0af5fb5debdafb2fa54cbe3a41070378517e,file_infector,38006,153,315,328,481,315
4258,49c6cc294e0c73ff4bc85cbe7ef4fb9394fc0cab9811a679360522535041d2d3,file_infector,251215,1014,2090,1959,2973,2090
4259,49ecd2669231d42c45334d8f867315e3570009410eabf8423fe8ff21f9d01c99,file_infector,28775,127,212,226,353,212
4260,4ae51620282ccdfb58ce016dd2e0360791677e5e305f09b7273cac6e36d50ff1,file_infector,75230,299,595,600,899,595
4261,4ae78f707a187a903f56e8bb029eb9cfbd50d83827218fc98a4a4d92f137f475,file_infector,20697,94,159,187,281,159
4262,4c172de21c0e78d2a6bb69ac5127e7e94aff2c8fbab228fc192ffbb85f9fdb5a,file_infector,142760,600,1134,1173,1773,1134
4263,4c432ce5f59cfe14c11c77f47ef1144594f705ec4c0ee1463c2d150bc102a0b7,file_infector,349762,1431,2798,2828,4259,2798
4264,4c472894188b22412e23b15ac05347486b221204969530dc53b640d9902cf9c2,file_infector,349206,1441,2789,2793,4234,2789
4265,4c8687e36fd3142fd0ed24ccc39d03db4b39c5398435dcaf9ced70944ac7b461,file_infector,53193,197,447,423,620,447
4266,4c8b22be806f99869c3cb30a06921417cdc31c371ff7f6f48e897cd840e1771d,file_infector,350118,1435,2791,2817,4252,2791
4267,4ce897796cc932b57dbfd29b7c7b4fb7eb1e1b024fa3e095fea787c56e55df73,file_infector,30842,101,258,238,339,258
4268,4d764125f71bfb11a44846fe4fee1c91fca8058bbfd8cc88e72b4f8f9060ce8b,file_infector,47855,183,383,462,645,383
4269,4ddb9f0cf2efea82127f35281626742dc0507f869cc5443bc5d984ddf5d4806a,file_infector,251109,1051,2003,1948,2999,2003
4270,4de41512d42a008b057ebc42837d8d1c8e051898e0e9fe8aa059b1659d858cc6,file_infector,25828,108,207,192,300,207
4271,4e2b667e9f4473031fda41b6f2a5d5cbd9ba9d6ff22f69029bddc6ef90801b62,file_infector,440015,1712,3529,3440,5152,3529
4272,4e6fced9e8131ef719623185c1ec9ab72f5cff34b409094f5b40f1b57402e8c6,file_infector,168848,662,1333,1354,2016,1333
4273,4e8130c846d0df428459143a50d95f23a0f33bd5da5d2646cf8a15b0af4a9e3f,file_infector,26366,110,223,217,327,223
4274,4e8a42474e36aac0d8ae8c378707034cf6399688ce73c1f4bb8d66badbbc7f04,file_infector,195560,851,1551,1544,2395,1551
4275,4e8a647e8226ffd122fe7993ca4d65650907c5dc2ad751c9ad8d5b118e84c9be,file_infector,37753,139,297,306,445,297
4276,4f29d44012cd5d0bf497e0395018be6675740fc46fb3786484b31555528ec871,file_infector,20824,90,160,154,244,160
4277,4f3c589cace29bb6cc19219a12e06c78220f0e52ddf7cc92693e81add4a0d96b,file_infector,31153,154,228,257,411,228
4278,4f3c7b20a42d077720955c2c78faadf37a973480b22df281aafcdb09ddc763f7,file_infector,19004,69,141,164,233,141
4279,4f5557a32d6afea3f1413abcb07b28a691681be6ca88884ceabcc2ffb6663cd7,file_infector,83664,366,642,711,1077,642
4280,4f592efc5c68554eeef82027a87d0c59653fdbf766cb64081715d9b628d8e0e7,file_infector,48923,174,412,408,582,412
4281,4f6feabc86a3c044d776db08ce615a0bb0d114c118629e5f7c15aa81d8f6c1e2,file_infector,251112,1043,2100,1975,3018,2100
4282,5020acbc5c4a81f7e2489059e15ae8995b22deab0e57967054df334ba0bbbe22,file_infector,97155,437,838,822,1259,838
4283,502b8b090a5f465725922508b46615fcc132d959ce9f2f3b2ea2f77882f9fd1f,file_infector,57134,240,429,485,725,429
4284,510fe8775daa1bdfcd281826fdd742601b9a07962f0ed70ed7c50398c43ddd6f,file_infector,250767,1095,1970,1969,3064,1970
4285,517dd9121780c01e5fe673e76550edfd33b364177253a09df7c85d80bc93acd6,file_infector,331996,1277,2717,2785,4062,2717
4286,517f323f4af32d8743e8e0007fa6bf7f3fe32d45d055b1b5b36c7ce33b84da0d,file_infector,83516,332,643,659,991,643
4287,51976b4f5a8896a81337cd47a2d2c5a3f43d1311b83d004c0c0f5bb14b735d41,file_infector,39835,183,306,322,505,306
4288,51e01be4006758fd1a2dd95764d4f0643401db6605fb37b9e8819b1904d9982d,file_infector,83551,353,615,714,1067,615
4289,52e684348eca4cbdf611e82573ef8d84afadd79bd6dafdaab7d5c7cf3dc24ad1,file_infector,31180,139,232,257,396,232
4290,52f2b921f32109f1db15869445cc233342ef27bfe9fd0938dcce62af38bb486e,file_infector,54377,242,417,471,713,417
4291,53553057bb719ae2454bb9cc6134b45b583146f04cf1f197e7038f8af933519b,file_infector,49988,185,406,441,626,406
4292,539ab62af0e81e8bd9870c5789e0c0641f02ebae2f6e1dad21a14e85974d09c1,file_infector,20183,83,172,162,245,172
4293,53ba6da539a72005cb35d127a5c4a6fcbbbe0cbde777be8c20dd039a942be87e,file_infector,38021,156,291,337,493,291
4294,5413fe6faf8753765aeeaa888c2d0eafd4a138450685d3756af4f530582658c1,file_infector,300744,1175,2300,2548,3723,2300
4295,54881925e08b09334c38db3a3a7c0523393d95600f97849046498b2905076f76,file_infector,83416,326,689,757,1083,689
4296,548b6b9f616626111935cde733c16f976c593a600ccf48e9433b3ab20c044352,file_infector,251168,1060,2026,1932,2992,2026
4297,54afe923afcafd99c24ca4fd0ec6a2040b466bc2eebbc57e5af836eb2c2758f1,file_infector,58792,209,475,487,696,475
4298,550369c11e51fc34652ea09246fd5fb86fe9cb248e5aced1d8024c0c55cdfea0,file_infector,349881,1506,2854,2641,4147,2854
4299,5509e273b3fb2f30631c5b9797c23fc173771a085471e47843c3d08674dcbe6a,file_infector,25165,98,195,212,310,195
4300,55a29bad5463160ed323165cfd30737e06f936ea20631820882ba938ec30cd38,file_infector,142912,634,1124,1127,1761,1124
4301,55fa88d00c30328a8d331d7d466ca9451d5a89567caa2020e0d0509941dd82c6,file_infector,35809,166,269,276,442,269
4302,565860f5e4f7cb5ce62d1ebb3d70d1e1db2bf6627703737cd7410646f7cc60a8,file_infector,348781,1418,2740,2820,4238,2740
4303,56c21a5aa6b7e45817b0a667f1ca3683a03ad6ac0049a290ec67a9d2421e7624,file_infector,26330,108,218,226,334,218
4304,57a7d3ac4abe499c58777d0a2286a27e958e3ae52dc1b1b154c4f303c95b5e30,file_infector,58730,188,469,481,669,469
4305,57e8788eac884cd4b2d78b1bad4d4b5fac6f062d4e0d304690813e55c8ca8da7,file_infector,24592,87,189,200,287,189
4306,58113ab8396d162109832ce5f74af174a089ff723e84b0d1bec4b868e3184bdb,file_infector,34501,163,272,296,459,272
4307,58355f296bbac7c2118ccd923cbdcea5f850066af7132727528dc8b5cde4ccf9,file_infector,22250,83,176,181,264,176
4308,58794f534f5d82020a3a4111c2f78d1171d48a77c4e4f48d7c1286d54d931e40,file_infector,24314,85,184,199,284,184
4309,58815c8713671e352d9ae75a40b97c7f0303b6fe56f7651f6afeace29154d9c3,file_infector,33518,150,250,284,434,250
4310,593292b5c90bf7a9e32a347b9c27973767d5868096748931be65d0585d0ae1ec,file_infector,25984,95,226,221,316,226
4311,595a5ba6d2cffe7b298b397759eed91c6420e1a86dcaa1677b061e06cd40a004,file_infector,20538,97,166,163,260,166
4312,595d30ecb1d23f998c7ba5f27051dc004d3889c375739c41ed70861d15c849bd,file_infector,144488,614,1167,1157,1771,1167
4313,59a161531919aadf9d1c69c886d00c7d5e5f92ea7fec676639a51f73c6f61e26,file_infector,22005,75,151,174,249,151
4314,59a1abcdc95d4eff2dd6bdb8fbe467856b8ae5286b45f81e96fece5a8a626147,file_infector,39876,163,324,345,508,324
4315,59a3e7b96096065bed1da645459feda53c258c44536b958c143cb0fc3889e746,file_infector,22032,86,154,211,297,154
4316,5a87f5e4741d0742007fd0a4510572e602c3e40f7864bbeb74c6813e7933fdac,file_infector,29378,118,219,215,333,219
4317,5a93899183a3b3c5d0dd8f67ad348e369e4585cadef641c796a3d57ff6acd6a1,file_infector,83357,319,648,695,1014,648
4318,5ac1230d0655b4d0934bb0cd35dd03ab09e241a06a5994df0fe54171e04c9842,file_infector,39823,163,328,333,496,328
4319,5b03d0e200459ed3b57a2847986a0d3e9d3fd37d97202150f603d807b4ce2fdd,file_infector,154720,618,1173,1248,1866,1173
4320,5b39af3969a197fefe83aa273584fc572306582adfae76e67216f8e4fa8435c1,file_infector,83580,375,618,734,1109,618
4321,5b5bace8ab9c91ad9fc079401143d86978959488096be0244bc8881b9ff84185,file_infector,54231,244,415,473,717,415
4322,5b70a548a15ff27eefae906580e6feea3243a729544084b0f3502d33c148addb,file_infector,28820,112,231,223,335,231
4323,5b811df245e96e09e9cb247b48c10ba3db584131718045cd2b3398909a6d1843,file_infector,38002,153,291,313,466,291
4324,5b919a9623a0d98d5e709040978c2f53f9826f8bf89eb25a0c8aae21a0097aa3,file_infector,83475,323,613,714,1037,613
4325,5bb16e7b4d7f6c70542247d25b0ec02aa4aa90cb3fbde4c7c86e37552da8eda6,file_infector,35736,155,265,283,438,265
4326,5bcd1cc80f46955635be2c6c8531fa3c7393a9cb524d5618e7cf47bbb4680eb6,file_infector,24834,92,186,214,306,186
4327,5befce947dd55d76f2a65403943b83000b0bf65bece6d8daa8f63a9a37212ba3,file_infector,38001,125,308,294,419,308
4328,5c182d19bfc4851507efac62d2d8b296ae2666586bbb752dd8615fe78652dd0e,file_infector,37981,160,296,307,467,296
4329,5c21e2ec6fdb9fd27fa7ffddac61cfb1250dfdb9a7387a27e4ab9ece48eda085,file_infector,56981,236,456,463,699,456
4330,5c91e072a0123130f55567bcc132f9a18740b0e4b513e0beb042936f324b96c4,file_infector,83603,332,631,674,1006,631
4331,5cba021eb805ba458778614f04386f1e3ba14287b4c7585d09c1ab5be907d517,file_infector,57142,225,481,485,710,481
4332,5e17fce79749d598094bf2d4d4ddfef256048d80d40a4e26999861e00898b4c1,file_infector,28891,125,230,228,353,230
4333,5e1daf7e08625151dcd5f6391d2fc0bccb7b3ab29cf48bb06bc9c8b2d387b7c8,file_infector,38027,147,301,339,486,301
4334,5ed6346402a7471c823b112191d91bc8d93173fc62ddd7ddbbd036dd29d066a0,file_infector,21178,83,153,153,236,153
4335,5efbd61f813bfdb5c47531b2f714f82063ee3b36149dce5582e73eba7a70f9ce,file_infector,34832,132,287,272,404,287
4336,5f9f306f37e2af9f249872bd721d3df929a870bff5b4659a21aed26ca22cb56c,file_infector,35097,135,281,297,432,281
4337,5fa0b5800df4a89438207dd119b89ed351be0ac736b7a523f42e4e69ecb64a19,file_infector,49921,219,400,416,635,400
4338,5fc4a5b1e101d1882fd81ef31ff69ce8caa43b8bed08009fca099370ee830e6d,file_infector,28855,114,231,250,364,231
4339,5fdbca86b0c785c61e259ba7690991310321e85c39f78bb9d57ddb393724d805,file_infector,96130,378,734,763,1141,734
4340,5fdd9fc32f9019c16054fd62f84551bf60292231d8e605763d25a15f4e4e2e4a,file_infector,51678,215,405,460,675,405
4341,5ff5715191346d28cc0638489668ac7c42a5170e86046d3bb65112524e3b6ba5,file_infector,39893,151,323,328,479,323
4342,600ade63ee551fc3b7b11837a09a8bcd19935c28423d8f2ee082b177c3321b25,file_infector,251175,1027,2057,1985,3012,2057
4343,604b4347a76ff8d9e35e3e013b29903d561dc8f4cd21b878c84147c4b55cbd7a,file_infector,33942,120,262,236,356,262
4344,6082ad3b926e72340fa086239fca5801461a132b4f1663d10fb01e173ecc3fc9,file_infector,56233,252,452,481,733,452
4345,60c1e625def2a0f8245070300c7e201082bac3322f1e60e1272f19d575824b9e,file_infector,251277,1022,1980,1968,2990,1980
4346,60c4f56535be28a359f9f2a40bda680a13b5d4289a2903e955e4a6bb11920aa4,file_infector,56769,252,464,514,766,464
4347,60dcc47a4b8f59e3018c93b07e118351680229943eb9f454b2285f448e78f934,file_infector,1571452,6316,12204,12261,18577,12204
4348,60e741dc756c1ae47344ace83684ad60c69aca0cd45c8af964ca5ffa86a5b79f,file_infector,58751,240,455,465,705,455
4349,6187b548662dcc54fff417cf4349ad0c3ecc7314cde0d7aae1faecd3d3c703fb,file_infector,29609,124,232,235,359,232
4350,61a9f84963a5340ac51061fd929a0dc22bdc4dc89b31ad85b665a49e2efdebed,file_infector,28760,123,220,270,393,220
4351,632a57750c602cc25b3f04f687a5c05c2c54083595e08a7ef71c4ed127156cf5,file_infector,41633,181,350,344,525,350
4352,63928105cc88534fda6a8c80c1d7f304d06eccc68565cd6e969077710692acd3,file_infector,20791,81,154,171,252,154
4353,6434fe70a26c99a30fb591678dc3b7b8412a4437fddd719af2af21474c31f61c,file_infector,21559,69,161,174,243,161
4354,6469208232058538923536ee57f062d9b7131c7db095bc1df381ae340a9cc38e,file_infector,38053,149,300,348,497,300
4355,649404a98645f41d9a3d677fbac1ae3be932f3090406d0a669d70817297098fc,file_infector,33901,132,253,273,405,253
4356,6574412810557063c2bd325a760e1f5a936771a6cffa027c6f9ebe9d8bbf9cf9,file_infector,57073,233,452,467,700,452
4357,65b33b12cc4f15b287a7dfab31504aa8373d52b6349eea929c7817f9f3ffca83,file_infector,439960,1697,3480,3463,5160,3480
4358,669ec30a29d307113ebef2f296812291f0fbca0e10bcca66e208debdffa83453,file_infector,53954,209,426,460,669,426
4359,66e7e82ab8d476a777bc79f3578da96e3c9c7d7763e607fe2e9d5b1762b66d81,file_infector,331416,1224,2673,2764,3988,2673
4360,66eccf2700ad821ad3a23898021a00c67d549a5c153a17a30643e2bcd5cfaa36,file_infector,135544,561,1022,1103,1664,1022
4361,673361c2174940511bda4156c235178c2849de1acd4724cfe3541784d7d1312e,file_infector,38027,136,268,309,445,268
4362,67c2005ae539d9bb2e4c1b2a0f24b9adf11fd2c6507f32ebcaf0a9868fa9fc30,file_infector,24652,109,207,210,319,207
4363,67fa2fd9f968dd17a3aa8fc152f38c04559bbfd4821920c13964d579dd118270,file_infector,38159,151,296,305,456,296
4364,68a69f87015ea07d381dedb20f545663dce6633bff52b959c1f95c6d17c94b03,file_infector,48876,193,384,396,589,384
4365,68b2ac93cb8fb223dc8c0946d88a3ee6c3ed6a161a5d1a2ba5987eaf4db555de,file_infector,62081,224,498,510,734,498
4366,68d6a1bb5f9c3fb0b29c23de2cd97ad2995cb268dbf1922abc8ade3e3cdc6780,file_infector,53421,227,435,456,683,435
4367,691b6218ff309199ece0bbc12196c28b072520330fb925aad8b1a2a40a7d3e9f,file_infector,22065,84,160,189,273,160
4368,69c3f64cd42863b4c0896aa498c803856eefafca09a64fe6b206f528b7cabea9,file_infector,38091,164,281,343,507,281
4369,6a0b4dbbc0e7c0c565ef91438ccb968ae9167d7189b1d926a35fab8aa3bf1bb0,file_infector,244064,976,1839,2077,3053,1839
4370,6a0d1a2f7b6d6e21fae0966cfd861f8ff1ce81743cd5c3cbcb672b82fefd0138,file_infector,25402,96,200,222,318,200
4371,6a6d1278670b8ea555b5114258f7f86c45509f2bf01ac83a43e9a8ce92273257,file_infector,28784,124,216,222,346,216
4372,6aba602bb01165a3c6add1fb25abdd4750f28226650f82d28f86edecc7e2ad08,file_infector,132742,562,1015,1091,1653,1015
4373,6ad1ae5bfcddb0461268ea20a0dd70da5478536f31e061122173519f4e9dcdcd,file_infector,38041,144,300,287,431,300
4374,6b04ebcb210edc52ee0808ca3f29f7da14d56ef4028a5148663f0d55350b5cad,file_infector,38047,132,303,276,408,303
4375,6b183138e8a1fcf62d12694f41d11276b4dd8f8d0660caa807f7eea1594294dd,file_infector,28780,135,226,227,362,226
4376,6bbc9fdc82fa113925e092bd8a601ecb4afc15458c683ef2d186886e8dd866a7,file_infector,39826,172,299,335,507,299
4377,6bec64cf3db4233f066e0a9245f92e7e1e886f3df25b1b545f6aabdfd7dd4e42,file_infector,28760,141,240,223,364,240
4378,6c0ba05325f6e15fa5714e92c58871c1d8d581bad0d9a274a5e76387daf9d14e,file_infector,35055,159,266,284,443,266
4379,6c2864779f6095b77eef3741202d020e4f44e9281370a18d0f034a1a88e7d53d,file_infector,183661,756,1465,1452,2208,1465
4380,6cfe38ff34c76dfe51e6da7421a5945b88535f2764102cae131e3ecd9411ae7e,file_infector,35360,140,272,300,440,272
4381,6d0e496609d0d86fef6b0d9409173f2d72766c33f87aff931868823d5898550c,file_infector,20445,90,156,155,245,156
4382,6d13011d079c8cc1af306b7a76a49039a71a80b61d9676a26ab134ff039e74d4,file_infector,251165,995,2100,1983,2978,2100
4383,6db1549b610246792a3fbc94e7cecf79725532b2c6beff8089481eb06f8b7a3a,file_infector,25003,119,182,199,318,182
4384,6dea7d5f1f923cc58ba58a4f21911010995ab21011b6a9cdc6aba73357c5681c,file_infector,95654,382,739,778,1160,739
4385,6e21480705e818028dfd2349ff00620e31ff07d12918d4b8e3aacb6e0ca574c7,file_infector,26759,110,199,235,345,199
4386,6e3f30c46a816c54b98d567dece25c2f609a83e9e96dd258a5ef4d8f80f7045c,file_infector,83604,366,632,678,1044,632
4387,6ec2df9254a83a36641a68e7da234de63329b6cd141c66c12bf5e6dd4a1c6a3c,file_infector,37940,135,278,303,438,278
4388,6ef4979eed06ebb7581c5c75f5d579385a93f825b9c27b52fd2b12c18ccaa050,file_infector,28823,102,223,221,323,223
4389,6efe5192b5ec23e8e8e558234923943977a0eb864242d47c13ce48cfda35f5b5,file_infector,55063,218,413,445,663,413
4390,6f3bf2058b0be1834d72609db4126658bf69bc2fdf1246d0e2cc9c1d723214f9,file_infector,53162,200,411,446,646,411
4391,6fd99534a2f33e4f695faf6303a84cafec6c7ed124949e4b44f1e3a61f2a912e,file_infector,428179,1773,3350,3455,5228,3350
4392,7053759a1d7cf6d4aa1333ca0ac2fb7a85fc209fef07f832fd2a275b47ec992e,file_infector,21528,84,183,171,255,183
4393,70b3827186cab0565a20600d8784a43013bc32dcd94251a160234f08125c0f66,file_infector,346980,1387,2755,2791,4178,2755
4394,70fb17cb857bb0b8700ed162a1740ec1b21bb29815a12c42e18d5a40cc64a757,file_infector,26324,110,212,233,343,212
4395,712ac63c23957f1a0191b0dfe0bc244e2ccc91d8b207211ca347e61c0cfd5cfc,file_infector,163303,627,1379,1349,1976,1379
4396,71b2fa0f0ff389d1d3bafc6498717a14848c3e76209ba36df8c9514e9f2710b8,file_infector,440014,1776,3433,3500,5276,3433
4397,71d9911f10132822de9d7e0f38c0ebbad0e7e42a5d6635f60777aefa13cb9258,file_infector,83592,345,669,676,1021,669
4398,71e29436865039618dff092adc70be0abfdb9e97a0f13d296dbe47451ce49430,file_infector,440025,1729,3540,3514,5243,3540
4399,71fcdd011e69adec692289677f372c52ed5b9f0501313c72b3d74e22ee6d71c3,file_infector,24518,102,191,176,278,191
4400,7224211ce5d49c854c64dc9d22df0d3ad450681e52bc045e56c4ff933bfd6ca1,file_infector,250807,1095,2003,1952,3047,2003
4401,7256a5544378440d7707d82ad57c996302a074eeb19e833064ded6b3bf65744e,file_infector,96530,355,759,836,1191,759
4402,7264d4fca1b84059e0ad594efedce5f556027c4b3982b820608e9d4a479556b4,file_infector,176811,757,1468,1402,2159,1468
4403,727d7a065af5e1155a34f745758706b87a053e1b0ef0a7cedc0135cb5ae5c6a6,file_infector,33923,158,251,277,435,251
4404,728ffcfbd90758590e6080fba775c6548d9ac3d8c46ed81fd4d8f8a0283161a3,file_infector,28649,108,244,211,319,244
4405,72988d59d0d3e8db5f2cfdf62c98a38ecf3c4faa312830ee46a391ea5a9a64ca,file_infector,38056,143,285,300,443,285
4406,729b65bb4b04eb79029685ae67588291cc8c4315b0bf0f5b6924cf6eaea760c2,file_infector,56287,226,398,463,689,398
4407,72a1324305b59e03d5f4ca99ee514e044d834ed59b53050dfbc78806a87d7539,file_infector,194777,834,1515,1684,2518,1515
4408,72a16f1b757dc8d83fb9ffa5a78279971999f7cac78e0872743849691864bcbb,file_infector,251107,1001,1998,1950,2951,1998
4409,72d6ddc98e635e3dc82ea316277a7b952664fcdde9e7fcf72cda61ed9b1a45e9,file_infector,93148,354,720,670,1024,720
4410,72fcc5b367f58c31f4fa24ffddfbb84da16749889fc256c9f7fefd35bd1d58a7,file_infector,24210,91,201,164,255,201
4411,7301f67e763a1416a72684100121baac552e7dbfa5b66075ec3d0ffccebec021,file_infector,194759,893,1517,1612,2505,1517
4412,730d5e205e35af740b10cf0d97286f27cd37071ecddbdb6f5039ff94ace9057c,file_infector,83555,343,636,699,1042,636
4413,730dc55c4d8094d0bd61ad1b413e65f57726ad328d32b8a88584f35f834b2c1d,file_infector,57273,197,441,464,661,441
4414,731217e7c139065c3a749a2a8fbdffed6b7f03467d637c0b9a55777475269697,file_infector,35223,144,283,270,414,283
4415,731a2571928302a97733306d64deea404daafed75fd4527b55f4c4800bca63ba,file_infector,53160,228,412,416,644,412
4416,73f701c43572cfe731b1cf6ff61f0e16c8b2bc81fc78e2440f4498cc53db05cc,file_infector,26443,114,220,224,338,220
4417,7416cbdf4c170893df78bbb87aacdbe2426409a9ed08fb91114212091be61f82,file_infector,37959,126,294,269,395,294
4418,7456dc45079c0e75783b9f02aabe6cf5896b07d9fb519294306c205179e9b142,file_infector,56294,245,455,493,738,455
4419,7488e5b953ecfe4467bd95d9a70fce91ffacdec7b8dc3b3e65cdbc2616c8c865,file_infector,39709,155,309,341,496,309
4420,74a3b601c59e624e1b427fc7e330d2e4701e5e8647997132cf5ccc286875a9b9,file_infector,58749,229,479,470,699,479
4421,74b8ee033322691713feac3a2be242460d6f4c7dd67e1bde5ee0e08fc2c8cece,file_infector,54150,222,438,453,675,438
4422,74df87bf57fe1b2ad75c5a0e2ca3ae3d40252713afeac29d66a3cd6547678546,file_infector,28420,110,214,228,338,214
4423,74e55d201b117e6063269f35dd8db3e0f25d4d03c79af1f574757bb87cdaaaee,file_infector,58704,216,454,452,668,454
4424,75134b2e961345f8ab3282fc5ea006af36c1d645574cfd1d8ac7cf02ec850413,file_infector,28781,121,216,223,344,216
4425,752b67a7ff5c7ffe65afb38e41b523e16d9f8843def32ba26ec93834e31170d5,file_infector,80412,321,681,639,960,681
4426,75e91db568dc52b0eac90224b6683bf57d75637e8a6193c6310922e175e64674,file_infector,25369,106,228,232,338,228
4427,7608641b233c28c1dd5f5840a42168e1b5e95692d5eed9b1f42842f132916262,file_infector,26160,87,192,193,280,192
4428,76574d5e39c6a0f69ff27913e25aae4dc43f69dc5226594f08d19fdc8d880af1,file_infector,38003,171,299,289,460,299
4429,76749560ba5840669744e9f58a1be52bc9f7a21a13f305f3a5b1a59cef37c8c5,file_infector,54438,225,415,493,718,415
4430,76a1a0ca1d65fa83adbfd35889b88ebeacd333ca632a74a66222658b868e4570,file_infector,83535,321,630,752,1073,630
4431,76b3d699ea99ffc27be8114a3c61fb1aa4f6d5771ee900e7e87862d01402c46e,file_infector,135933,612,1025,1057,1669,1025
4432,7777b40ee16653eaba27e06a65dc5af2da27a367561222117db9f05741dfd707,file_infector,38077,147,280,291,438,280
4433,779258c5e02d8e8b484b31c441381b72c97d3cc41ce6327d1f1485bb968cb04b,file_infector,50466,228,400,369,597,400
4434,779f40b2cbe24f878c161f5524ea0764e194754159070bae6d98b3d069364583,file_infector,330991,1315,2751,2730,4045,2751
4435,780b5c4578011da9bace0da587df65d9c325c7011132a284798fa53809710705,file_infector,135025,539,998,1154,1693,998
4436,78611388521c652b8b295a38cac7db5a90de8a95eb41195b9d5de22549894c97,file_infector,1571292,6296,12242,12250,18546,12242
4437,78e00829e276148a82db3998e07be4ccf7c71520bfe3c2ec3371e1605bbb556e,file_infector,35620,155,264,304,459,264
4438,78e184ac45f3e8b182f038680c7fe8aede2a222cbfb7df425fa4d9845d63a516,file_infector,28765,120,230,213,333,230
4439,78e5e05fc2fd62439ba2fd7d9f73a2eaf3893ff6b0c85b6323bb572d75d33cc5,file_infector,21731,83,157,187,270,157
4440,79125bd06ecc9a989fd0cb514ba20d683bd8788d6d3728dc3313eb40ea154073,file_infector,21302,90,178,163,253,178
4441,794e423d0e6e5107475c44f298be117bf8e04b7238d6e110adcb330aff26c5cc,file_infector,31303,135,241,244,379,241
4442,79b46bf718c8f3cfb75b0018f8621248006053b115fb41209d28a60c9c87b829,file_infector,50438,211,400,381,592,400
4443,7ac842ee3c01fc9ca210bd02d4b43693402bac45644029998ed372d507828850,file_infector,56523,225,425,456,681,425
4444,7b0c36b8e4a01def74427684852b91232648c1890b5ec7d0c963092af66ddf99,file_infector,31170,139,224,249,388,224
4445,7b48be575c50168cc5a3fcd8a74c13966f337b8f63ad07c31ae31a09b3d868f0,file_infector,21138,97,191,173,270,191
4446,7b91e8c4ea2f53d386ffcc6f0bcf63b78187f9974ca160bf66d65c5af956891a,file_infector,364098,1528,2783,2857,4385,2783
4447,7c6862db32eac5d586a66d400974fe5c025ecc126cda3ae9910355cdb537a2cd,file_infector,35272,159,282,278,437,282
4448,7c6e4b28aa6267c7b37b02a0a556a5e32ab9fb5cbb0e1c6303f055e043df0198,file_infector,48871,173,392,409,582,392
4449,7c9baf7092b8610fb2403ad8823310cb2edb82c76b5a5ad16d709376d7987766,file_infector,19525,73,160,159,232,160
4450,7cd68102c1816041264990a6ac001dc07e53a08f4389b40e313a5b84c2ce1697,file_infector,24291,97,211,211,308,211
4451,7d2d403cd9f6cafbb42f1c79a97f4de8f08475a938c52a5e40fbd6b05fb58622,file_infector,28956,110,244,247,357,244
4452,7db94aa404f8ddf5468a54483d92bc0043ed5d64fbeb3d9e728f423bbc522f5c,file_infector,424128,1689,3352,3536,5225,3352
4453,7dcae5436eded98f174c43fa7acc88fc5f9655fe1600fa48c0eff71df77a924b,file_infector,78566,290,648,647,937,648
4454,7dfdef293544c6f0f992b1ccc47be869f0a9cb7416ef36e3d973133e0367ed8b,file_infector,1571485,6315,12312,12348,18663,12312
4455,7e61fe31faf8a312ee9d8fd2d7af9b38bb1a275fb40be088daaf4d662c938ee9,file_infector,90491,341,733,696,1037,733
4456,7ee09280b7f05d12314f4b893703a248e0a2dced3e7bf0f36d210eec76120698,file_infector,28730,128,238,231,359,238
4457,7f1c97d118cf7c2987e3627d5b1caae4e87c87e83d39b68e54156aa5ff0d091f,file_infector,34966,131,296,276,407,296
4458,7f1d3a7e4adb51a6794696ba3c07878311c4a1859109e988009a74c26a954503,file_infector,34657,159,295,244,403,295
4459,7f32dcdd30f879ca7091e462aa5cf9a7ed34c8f284d22694e1dbca7ada72db05,file_infector,28784,98,228,233,331,228
4460,7f45aab94b14a3ff6d2ef78897a6c3352a5bab1c23842dacd6a51190022e3442,file_infector,35088,142,305,282,424,305
4461,7f61d7c6b3987a5131221586ea08663fad7bb2ff227ce7e75539355c0883617e,file_infector,83405,346,659,712,1058,659
4462,7f6bde7a755d1848958eb95b69d5ecb5bf585be6733c4509532539c5413146c8,file_infector,251153,1031,1976,1953,2984,1976
4463,7f900361f71101a3af0804681b6bcea169af43b00dbccf8b62cc23dfadb247a7,file_infector,50406,231,396,434,665,396
4464,7f9f2525ebb99c4b17fcc9c8e1a95d61996c78064ec298f82eeb0548c65cc5a9,file_infector,49875,194,367,451,645,367
4465,7fed52c98bb134eca1ca570bf99a49532f31e2aa5ec05d7a77c3658b80d0747b,file_infector,56354,198,455,458,656,455
4466,7ffe3fb2ba3989549447ce58763f358338a3aae6f07969628c795c6b8b0fdc89,file_infector,53143,235,377,437,672,377
4467,804e6b609f4920f601ffe594e2d9ca8c6b2dfd73ac8ed61a17e35f2ce4f2864c,file_infector,28762,119,231,228,347,231
4468,8072aa5602398cebcf51f50e4c98040691b9214b32dfd6f622ce911e79453d7a,file_infector,19939,70,178,140,210,178
4469,80abec7e17c8c0d542f7589a23b225fcf5d865b5adbb965711f2c5d182fa47f6,file_infector,118644,522,931,975,1497,931
4470,814407c3c55ddf4b88c3d4334529e008f0d1166fb3abf5745598fb0e582fba89,file_infector,251039,1038,1983,1905,2943,1983
4471,81c62ed8a70b23885a8f8d7e1828d879d24d265c3ada4af867da237d0de06d23,file_infector,53202,239,424,432,671,424
4472,821e32053aed5e19282052e00614cf8b29b8fdc893c7ac29e33555c7ba947740,file_infector,38024,140,288,330,470,288
4473,82a5c6359f3bce03f68bb5f195aa58b28d1256b8a623ecf11eec1cb5f8dfbc05,file_infector,47033,187,365,350,537,365
4474,83404a85df3bd291c6349ca0e69d10aa0f830024b3cadde805b1a34353c5e6f0,file_infector,440094,1739,3542,3506,5245,3542
4475,838a7493cb212d336604457b13e99166b960ac570bb8c4e85280401d9d45e28c,file_infector,34524,156,267,293,449,267
4476,838bc8021d1db01e2916e8290d2d476c3f5dd47833392eda52b79919666bbb02,file_infector,211420,832,1695,1910,2742,1695
4477,83d0fcb7d60d77f4af3136de6fc20b6c948a4c3139eb3a62414f75b7aa86b850,file_infector,34452,163,307,264,427,307
4478,8400c371df27f3ae189a1f42a6aedad33d4d7b5c82cbce213476fb0d65243ef0,file_infector,58524,197,466,447,644,466
4479,840f555247a553f038baee615b5a64502518824719a9421cb162ea5db6adf9e4,file_infector,269692,1129,2145,2213,3342,2145
4480,841cfde5e4f0c4fe6b07f9d9996c5943a0551e0fb43e5436fa1492999a1e854d,file_infector,23958,91,201,200,291,201
4481,8436152269c508a9e2a53a471aced69764ea9bc79d4282d5852479d16bfe510d,file_infector,26880,90,225,202,292,225
4482,843f2a71e0477450060d253e510927853cb65466e89fc27916c13dae2db17bf8,file_infector,57024,244,412,492,736,412
4483,848cb4ab5a626d5eaf9c316cd16450b58c4aa1da331b45c5276e62b231cfb063,file_infector,194796,865,1525,1691,2556,1525
4484,84a0749d22031787b664457643b50f7a9a3d0d03495cbed4194a260ffd22717b,file_infector,53635,189,397,446,635,397
4485,853f0c4dfe97b837dfeaf094260bd9f56b418435336acd1195887f7d94363f96,file_infector,349048,1431,2739,2805,4236,2739
4486,8594f90e31d5f9278ca3811c3e05eaf0eab57bae864c6af0710bce3ebf738ac7,file_infector,19523,90,150,132,222,150
4487,85f1b8b90c53bb0f951b797edcffdf796560fa990cb35bb19c6757e48f864266,file_infector,57222,247,453,491,738,453
4488,861e14953f74bf58ddacfe2ccf068fe335f6e8558d951502069979892dbfc937,file_infector,251133,1041,1983,1949,2990,1983
4489,861ebf36b84322028acf756b695b5266ea70d41890dfcdb5fb1d80e6c433b5a6,file_infector,26380,103,216,247,350,216
4490,86a0ea43f5b96f42b04cf31aac10052d2c605ddc8499f50b03c384ce97ccff96,file_infector,20638,84,164,160,244,164
4491,86c2d12b2ed9eb0a177189b7736a4b6e13cf6f6e490a7d78893fc02c59313502,file_infector,439807,1721,3526,3558,5279,3526
4492,86e3c9f1396e7d1c554973a1848efa6b529dc652f8b0313aed2131d8704248d6,file_infector,38020,147,294,314,461,294
4493,86e95efc343041c98d5d5258b3b0ceba20543608a14e283198afac0e6abdd8f2,file_infector,35343,163,292,310,473,292
4494,86ff10ca33750e939c5d753c50111244c0ea94ec90d6f319fdecfcee2c746b15,file_infector,440079,1760,3506,3513,5273,3506
4495,872a183e0ed7fcf42e85f31d30bdfaf9ec94a8b315108c0d955ebc33cffff792,file_infector,57101,215,433,504,719,433
4496,877b10b3affcdb23023cd4a7367bd066672d8fb2209fcceb3af1cabead14c6ab,file_infector,275590,1108,2225,2163,3271,2225
4497,878bbe5e7f6cd17f201b4cb7bea2ef9ba908695d733de1d6d3f66ba6bd5ae8e4,file_infector,28668,104,228,243,347,228
4498,87addb1a0384f43e9c69f11a040aeaf244f693d5f6fe6224540484a5f7583032,file_infector,135055,570,1089,1087,1657,1089
4499,87c264771a816ab1f3f121ccaada93648602d689688873ab64ad380ef079eb69,file_infector,33539,132,261,251,383,261
4500,8819dd0d4b8ed2c9e90dd5b11b80bea40753955b4fe9cf3b8538a463a05df5f7,file_infector,25960,110,210,208,318,210
4501,8821155ff68c35c06c64706b6b0833b9e8c79015bd8f0fc03f6885eefe628994,file_infector,21950,82,149,184,266,149
4502,88afac0f099d28276b7256fdbc2d1f6e98c8faf14ed9c77e110601ef9cdd41c8,file_infector,24014,103,190,218,321,190
4503,88dd47fc3048a518e1ea774b1dedf3326a78144c66ef8b4e71828936cb1554df,file_infector,28755,111,235,224,335,235
4504,89387bcbee623d217a69ef7a2227867550051303ccae7db2d04cf9291384eab9,file_infector,28817,103,239,256,359,239
4505,899a5cb3e9922eee1e1311ffd55f5cde91d5fbd5d9a3cdd89d74c5a384f60b2b,file_infector,57171,223,480,480,703,480
4506,89ab4c20a467b6a08de5ced67365926c15136a287e2525c0d33bd4f644d2e343,file_infector,622701,2519,4923,5208,7727,4923
4507,89e18b024b6183ea3fead0726e21c666a840c67d5aabe60066fa17e490e45a93,file_infector,348582,1424,2779,2796,4220,2779
4508,89e69c0ecd8efdb213b22a6d568ffc3148ce364508be2d72d8fea6cb4161f14d,file_infector,35637,157,259,313,470,259
4509,89f658e16322234e2a905af491fd2788664ecdca5f62725741a54d781a904c7d,file_infector,1571330,6356,12246,12360,18716,12246
4510,8aa013310c13b38d4a2daeaa26ef9cc3f5a726a9ba971ef8d78dd1524e7aa06d,file_infector,194755,827,1572,1648,2475,1572
4511,8ac4b79468881b41ba9d2c7208830e90714bfccb4970cd2976a45bc22b8d6ea8,file_infector,57229,229,487,486,715,487
4512,8b1822efed65a6b768a8f9edb7f3396623c378d5b78023ab9bfdf263df6636f5,file_infector,58780,220,460,463,683,460
4513,8bd46bf05bca6b19f44cd829ff1e4e0b6642d30b3ca546415f49b2148d332954,file_infector,502956,2086,4009,3965,6051,4009
4514,8c8e95025b5f6630fc54ae9b3123d903bfbba9ab5d5b46601dce6ee9fd0dc9f5,file_infector,57074,232,457,468,700,457
4515,8cd01ca66bda231d2edc7a423ab28324d01f4fa13d3c5676fe7b048bdf30becd,file_infector,26185,114,204,227,341,204
4516,8ce539868334f99d07f00f30202ad6c29d0d1b3dab401f2e62c37e20fcad8709,file_infector,349899,1411,2736,2857,4268,2736
4517,8cfbaa000219ba86540ef18f3457d653e7815bc36f349cb7dcb48bdbb88045f2,file_infector,273672,1144,2163,2221,3365,2163
4518,8d2b4ecc8ad21934ffdbedc749c74c28fe2b6420fafefd25fc583319c8fcf732,file_infector,22014,95,169,183,278,169
4519,8d34799a7babb05618255bb44df7518a1d69646d649016ce39d0cc3c1ed9a352,file_infector,37945,166,284,327,493,284
4520,8d347eb687c9cc191ec97d3401d71a65804d425a345deae9b47bfa76ef48876a,file_infector,135476,517,1033,1033,1550,1033
4521,8d5bced01f0b05842b1aabd958772dfeb439a49e3315583dcdd2184c99498df9,file_infector,29615,109,205,219,328,205
4522,8d9a3dfca0652b27a5980a29cd81adaf1675024a463c84140d22d852244c62e8,file_infector,293301,1160,2335,2379,3539,2335
4523,8d9ffc465e46f127e82f5cee4f9c24e40d6a852f84cff703364f0814e28186de,file_infector,28725,111,213,252,363,213
4524,8dd8bbcfa836bb38cf12e6f238ae74ae7fe9461a2faeeef3d3f9ff039b8e9afb,file_infector,21601,82,159,167,249,159
4525,8edb1dd0d86e1ef53f0d6fcedf8e94efcb8b7766b6dd6d0c098f2134463e5e70,file_infector,24718,92,205,207,299,205
4526,8f069c63ad4d348e049169830e64355ea13582573a5677f11a626f01d7fd1fc4,file_infector,26110,100,227,208,308,227
4527,8f14c22bcc648da7c47e64de391013589e6a7b52f69d8f0d309a2fc4c6d5ca65,file_infector,25111,97,198,199,296,198
4528,8f8506fe4686f1ccf59c5641a1423718c443498154b4195e28c3f016f18568a5,file_infector,251086,1009,2070,1987,2996,2070
4529,8f9e1de88c345d4ce61fb26da1680cffd6dc9e86fcc2a1214a8652d2305d1452,file_infector,21891,100,180,165,265,180
4530,8fab80cb8bbafc23ac8cd94443c72c9d7a8aaf6987e70c03a54ecff82c4dc96d,file_infector,28720,111,232,241,352,232
4531,8feb391fd176c5b5b93dbadd631dddd4aef32bac6269aefcc0b2fc74ded30295,file_infector,25717,112,226,208,320,226
4532,8fec2ad42c7c019683206738b3e97792cdf868443d9621d8993b01e11375a2cb,file_infector,32998,130,256,270,400,256
4533,8fecfc4ce979a58bd8fcd02a8c6d256dbc43c9abab7f940d586ade86b4fdd4ac,file_infector,34798,127,277,298,425,277
4534,90c610f6e0cccbafc8cafa3e44fb9d6187a5cbd955d1e07c91f89d3f99c7089e,file_infector,24840,92,188,195,287,188
4535,914084a1a32ec48ae3b3318e855d7e1ed0c5ffd3ad47ecafe8474720477dcd2e,file_infector,21968,79,157,186,265,157
4536,9170ea35071184a7c28239a9babf88f1641183acf1c6063c5c617182e27c2a81,file_infector,29596,143,200,220,363,200
4537,917e2b7a0eb0bd25810544c36d2296e36c61d21d8a60fb534d31fefd528684b9,file_infector,29133,116,240,269,385,240
4538,91c825c42e0541202ba6be9a24d29ccbe14822fbec43301c580ac1e9e21713d4,file_infector,33934,119,264,256,375,264
4539,91ce92f33fa750432f473148c78de6b9acd4b5f62987e71ee7618ba921cfab74,file_infector,35053,138,259,253,391,259
4540,91f0da5ec3fd9e7d6f7e5a281ea3018d5992c25c82f8c8a228b60541c16f2e7a,file_infector,28819,104,229,237,341,229
4541,92040698b9787826a8c6120b0f6c0b2ebb172dad0e5ba4cdd57b710269ca5726,file_infector,31018,117,225,225,342,225
4542,920f8dce198c6e3f4bfd3cde8d89f7eebcbec818858e79311da01df4ff9fb897,file_infector,26470,102,201,231,333,201
4543,923ceb9b53793e29bd5476756fe79ee84e17c4dfae31d37a356697bdc5b0067d,file_infector,1571350,6317,12381,12369,18686,12381
4544,92964136648a554216b2cfaf816ee9ee2073eaf29148f86d109907085fac8021,file_infector,48889,198,375,374,572,375
4545,9297bda10ded4f81d64e064a283a024a12cc6372c3b7fd303a4750e4fe1ee289,file_infector,28807,134,230,249,383,230
4546,92aa606fba90a023ead7afefd2baef521b7097a55fa748395d48c463ddf07171,file_infector,83630,344,624,724,1068,624
4547,92aa8a70c39444e123467cb69cdf078fd312c9e86b10b1658cc1c046e7fbe855,file_infector,22059,77,181,183,260,181
4548,92af16d8cc9d8594316e049993dd63b36eeed854f2cf6829016bbf6d9cb622e5,file_infector,83530,326,667,675,1001,667
4549,932dc435ce01473ad3d71ceda85e2e15c059171355a838a120e0608c5a5887a1,file_infector,35399,154,272,318,472,272
4550,93417de3ecac8fa6588a65bcf021a8c501a70adb711c19031ef9d13e8add06a2,file_infector,48911,186,390,419,605,390
4551,93a09d35f2396659fcb7bbef5a0bcacd1388a0c550b460835e49cc5e41b05a0c,file_infector,229320,849,1839,1847,2696,1839
4552,93b6089632d939f69996f6009e46889c06947decb0e40cbd69d47aaf03e631c5,file_infector,23973,102,197,186,288,197
4553,93dbec69f4900c578204d443843f7efd86f29171bcef212398cd63b2e211e9f9,file_infector,57415,232,472,485,717,472
4554,93dfee8fe6cabb9d5c88a42e0190358976966cc13f2bcc04f72c364867e21e2b,file_infector,33610,199,272,270,469,272
4555,9417d5e38c536e13b98756cfbce69d70218e3bbbc723f23e9b6c04bbb2592b32,file_infector,1291068,5075,10500,10480,15555,10500
4556,9440ff19934218c34acf38bc95949da75a807cacf9c19719e5a887e8a9ebfd7a,file_infector,30813,139,255,238,377,255
4557,944cbd6f54c3d165fd944c18dbfe3a701a8bce766d5a8f767e25efbbbe965906,file_infector,439920,1741,3520,3582,5323,3520
4558,9478dbe580dbe4204c7c64a1206e8d29b2d71a9355e2b1faf25e81edaa8e021b,file_infector,1571273,6307,12324,12281,18588,12324
4559,947eb769b777845d3f36c6e423c9962267a3b0c38c040b7dddc4b8a8c8283940,file_infector,28737,105,240,233,338,240
4560,949d50ae0ad246ebf0d3933a271322f4a9df927c689aa0bda46043274aa49afb,file_infector,83496,333,650,723,1056,650
4561,94fb33a9f2749d32bceae96523d93cd3ca509bc01518a7ea65d4ba4b82b22b62,file_infector,19503,89,139,169,258,139
4562,94ff376f404f072534397af65a3dc42aaaaf89db44ab4a3e8f27668a6c6043bf,file_infector,24828,102,181,215,317,181
4563,9503fa526477f39ba0a6c6f809484d70e6accf42469b948c440655c2c6d315bf,file_infector,58749,217,486,473,690,486
4564,95121017a3dcdbb64b5bf77ca7b6c9ffff46ea8a8cb4c2123edb82021edf8de1,file_infector,24824,94,211,232,326,211
4565,9560ae07b41b11a41d4fc52d345feffc9c88d7bcf1144df3b1d305c206275bda,file_infector,28737,115,236,239,354,236
4566,9590d5f1704533f5ed20c4e53e72148617b03e5f6fc323b53ef22a9a8ab741a7,file_infector,28883,118,205,230,348,205
4567,959eaaec4a67f8e00c6fd17404d1732e23bddb2e8842dfe08e5b902e7ec3ef37,file_infector,1571330,6241,12267,12198,18439,12267
4568,95fc75771d5eb5eeb69f412ebac5b92908b6623503c836990f110bb35d49a90d,file_infector,37983,140,272,303,443,272
4569,96900f121bc0735a5c9c86ef6d035b4ec4d2474dfc9f7f08f0f54c2561d9f060,file_infector,37996,152,268,307,459,268
4570,96b35ba7bc5995afc03f9c04b40d1cfcdfb4e2f81789937adc5126a4c48261a3,file_infector,58705,220,451,462,682,451
4571,97e7fcbb4a9eb5078a8241ba8bb08d52cb8dd21ae59ae575a75fa6cd8e9bb2a2,file_infector,54127,226,434,423,649,434
4572,97f7d4e5733ab2e0449a0c8025e1efdf445a599ed66654cc0c4d925223f80e37,file_infector,28739,103,231,213,316,231
4573,9800a3b8fa31f752b05cfccb1e39301fa681bf57a120744ba32bb5419436bb41,file_infector,53611,227,427,445,672,427
4574,991dc35a830f1c64ac001877b74c8fef3267e73ea1ccc4efd458e43ae72c7255,file_infector,1571324,6334,12331,12267,18601,12331
4575,9931fd47c70cd0739f7d2ade445101346ede95660473c79b0a4ca355ec509865,file_infector,54859,229,416,464,693,416
4576,995119e55b0527790550f9262061937616a6e26525b3560a6952d273fd5c5650,file_infector,52924,230,451,449,679,451
4577,996ad514ed5dd2dee7e6d75b464d836434724eae320ac771816907ebaa717a8e,file_infector,72494,298,587,563,861,587
4578,9978f3188c25933a48687c61b4ebcae80c59d796a51082170fa01158a2100c13,file_infector,143337,569,1177,1097,1666,1177
4579,9abab60dd897737d3789adeae8186a1c9bec6f07769c302c9e48adff91618881,file_infector,83602,328,659,680,1008,659
4580,9b092002370df34c798203ef15f794373c0cde4c5402dd3f33acca29037ca8a3,file_infector,35290,144,280,276,420,280
4581,9b74c65fb81878b6f0d9e863b645ae7b5ac5387988631a44f6800048e3aa0e1c,file_infector,38045,131,284,306,437,284
4582,9b9e7fee2cf3e577b4ab16c06609a2a73f5de16b9d8412b0a6a47c352f6ede22,file_infector,24484,109,188,211,320,188
4583,9bb408bbe3570d7c60709cca63375009a171584f5d62149a255a3956404dc669,file_infector,24544,103,182,223,326,182
4584,9c1d44308e1c081547afd0341dbff88df120ec89955b413cebe2e69e71295ab0,file_infector,1571320,6345,12237,12186,18531,12237
4585,9c7234d94d16e5ad80fbba5e7fce6af8328f9c0166b7e79b4834a0d0a9b5f550,file_infector,28763,112,226,260,372,226
4586,9cea9bce2ce06bc7f50e6592b5345345546d22838ec67139e51373ce70474dce,file_infector,56628,225,456,464,689,456
4587,9d536cd4112c0f4519e025d6edbfa9371eabb2d4d6faca44d0f8943a3ce6381a,file_infector,83497,367,618,701,1068,618
4588,9d75cc0ca24264d550fa875b2f12d41c1209512ed2ed5f9efdc47c2c91aaf89c,file_infector,24910,102,178,187,289,178
4589,9d7c5d3ed52feb5bfaac0d3253ba1e7f6aac107128228124f3dca83eeb0935c3,file_infector,331061,1284,2742,2658,3942,2742
4590,9db7d66f035eab94e0380054835495c7674428b21f605c2020a1e63cbd3095d5,file_infector,1571228,6323,12247,12346,18669,12247
4591,9ddde66f0b4d25920451850ce55e49024a0f7f8ce9880fd9b1e151036e9908b3,file_infector,38026,144,267,314,458,267
4592,9e2d26c1a9710eed90ca5894ab22731bcbaa8bb8dbc81768403c7e3c21216dce,file_infector,83520,328,596,682,1010,596
4593,9e42402a264529cfe5ddceb76c94c8357b673752660a39a5966b25f04a1a1320,file_infector,29657,146,209,248,394,209
4594,9e507b42add20fe40d61b6e74e310c08561ee53ada93e2a42f8c30a74dfaeda9,file_infector,26295,112,212,223,335,212
4595,9f30d29267ebd141e0904b767f5812fd78a46534bea51cd84af07aa957e491ac,file_infector,52975,247,412,417,664,412
4596,9f7f52a2abc663ef913b7758f8ab23bb25e4d1c50478f93c1c32b4601a274833,file_infector,37956,132,291,283,415,291
4597,9f8ad8553be1be308603b3a121619926a54e34614036560d8e6b8b2a30a01738,file_infector,83604,318,634,713,1031,634
4598,9fb45eb9f089403099adfc8626304f1264ff8a551e8e83edc75efb678cfe6eaf,file_infector,99684,437,762,805,1242,762
4599,9fc10bd520c6644d673b40e53260bd6a98917f5c18c88ba0418f82e257a5f149,file_infector,251294,1035,1983,1986,3021,1983
4600,a0eae7c4b542da46d5208bc34c7e3bf33170f1206e5004677fc7cbfe2b7525de,file_infector,54715,211,458,440,651,458
4601,a16714537056aaf8733641604d1ee5bac61d0d24b42a05910c1876d1b47272d1,file_infector,1571355,6290,12169,12145,18435,12169
4602,a1a341e6c1d9ce52ba8d82e1aa058ae69341ddb845efdf95d49d2ab5a02217ab,file_infector,39896,156,312,328,484,312
4603,a1bff8c607781457282bb91192c158346fa5e4abda7a3b3da911261dfc152fce,file_infector,19013,68,176,163,231,176
4604,a225d24ec73b804217a2d7cb86c5be63558ab7efc1946cd03565a147504d69de,file_infector,39449,170,278,303,473,278
4605,a22aa37aea2d243ad3b11493efbd265371eda9e16005e5234550c026c9d2a779,file_infector,20960,77,158,168,245,158
4606,a2608add8ca85e4c335d33b787626bd16e1bd3354d9fa74325d26b6b60a23ddc,file_infector,57380,234,448,507,741,448
4607,a265f51b7ab17c135b55bec7ca9187f9fc2729c96aa40d636ee5c58d9f70f853,file_infector,39794,156,334,313,469,334
4608,a328efe2e06b40901baa201b53d0abcc3b9039f82baa4962603d69289ad4f2f7,file_infector,37973,171,296,296,467,296
4609,a340d0b757855ef6f281617f6a17029cc8a9a892e4e3b6cb213fd2254e16d97a,file_infector,22466,75,179,151,226,179
4610,a3b0e9588303586e6de34b72e5981373f9952998d330806cb4775a7d16bd95c8,file_infector,69319,317,515,525,842,515
4611,a3b9f3dfd5852f4768fa1228c5a5663445d19ffb2b1c33a34ea69e332b3c13fd,file_infector,20935,90,145,185,275,145
4612,a3da535faf2ddc01b8323db01c907c9278817f5bd9cff48bb10e5bb7729ac5bb,file_infector,1571428,6309,12335,12322,18631,12335
4613,a3ea714fad3b88d6a3dfdc19e90f0000c28668995baec28d51bc521375c64da5,file_infector,83597,323,618,712,1035,618
4614,a414e234c07cc961076e01c736fdf653c203621f2eceb7e67eb8ec85a24c2a65,file_infector,33953,124,268,265,389,268
4615,a4284a9945024d097fe524a584014a51d1ee7620d04912284731b552e1964160,file_infector,28794,121,251,220,341,251
4616,a48bca72693ee3a89fbfd3b8a0ff7afa76acecd05f56b8a786301c66bc26120e,file_infector,56779,224,431,453,677,431
4617,a4ce1188be2cf05aa65a564194cee828b85a11438b12c1505cf0f2b2e2a781f1,file_infector,83647,338,588,745,1083,588
4618,a4d943a10edf1190ca09840fe8381456b59dfe5d8fcd4fd944869691f176bc0f,file_infector,57003,229,423,478,707,423
4619,a581b9fb8a7d71f377d77989e0e48bcf21e88ca6f56810fd0689c37da8c11c3a,file_infector,251123,1050,2020,1916,2966,2020
4620,a5da61c726ad521525b51807a41105d91ce93aa977378175c5478dab84166dfb,file_infector,191707,762,1506,1582,2344,1506
4621,a5e0eb7fbbeb192a577cf27215c9d807c400f457b6be70b91ee8d9fa27f51da0,file_infector,29687,126,202,226,352,202
4622,a7021b6ec03c2fbe3e1018f9fe42a436c130f7298424ca676f55db82f7d7b2c3,file_infector,28753,108,207,224,332,207
4623,a72079921a46292c28c1c2283bfe4bc45e7f3f99f5d1b410bb9531181a60b92d,file_infector,53551,214,400,428,642,400
4624,a789305dab666030dabb7f49e25c1766c7b35c81d6a1a101274cd7cb04b6a3e8,file_infector,91926,334,763,712,1046,763
4625,a808b6545740679117328f13949e63b0e37c30b4c8cccb961f42585a266056b0,file_infector,37956,157,326,315,472,326
4626,a808d1c7021fabcfe27d9e9b9a308d8deaebb1b4166b93763afec72d740ba47f,file_infector,34689,145,274,274,419,274
4627,a83b744d4d49c489d3bfc40449619f2de027e7e19187d9bcc5be57b1129824fa,file_infector,53760,234,407,426,660,407
4628,a8960bd9666821b0485df1ad34d0e3c413f163fcceb5988f6682c81ae33af646,file_infector,48869,178,378,378,556,378
4629,a8a225659641508c5062e2b1c770f81459eab7f237622fbe4e8fce020d85184c,file_infector,251186,1002,2056,2002,3004,2056
4630,a8acf7f9d94074890e9c2e1307d7cf4b71bada130c3537bf3728208909a14f1d,file_infector,96462,405,777,840,1245,777
4631,a8b2430d54f2deb1c3dbbacdb5f8ae4f8df3f1f454ad31ca4897955ba3978f8f,file_infector,28789,116,228,265,381,228
4632,a912f7d35769d06e0b2290acdf823d55a08db01d14790a79085a78e7838b8a2e,file_infector,19141,107,178,148,255,178
4633,a9ea5e39a2239051c263fb7fbd587d128651e32c1eec988939b0eb2a4cb525be,file_infector,26515,103,205,210,313,205
4634,aa2ca475ee4370f3f4e91df231a944f0e62c6b86d7572448f4c64a200a13f811,file_infector,112341,461,874,856,1317,874
4635,aab7d5b84a5f2b454b4673710ff8a27cf84a229c4e4e423a355228a87d29b756,file_infector,28747,119,252,244,363,252
4636,ab0087915018edc6dd4c7d883a3bbb20d70e0062efaee5b798f0ef067fb00b80,file_infector,35072,133,287,278,411,287
4637,ab1ae9c50a89f30e198d3f3d1e9e103d66daeb20d03c0eabfac9b1dd6d8b311b,file_infector,440070,1723,3496,3463,5186,3496
4638,ab28372cb09a9870b715f883ac2ab8084d554428c594dfe22973051989b3ec33,file_infector,20858,73,148,174,247,148
4639,ab4ec0fccfb280f7381bff77aa078fcff54c6c731aa3b6be0d50fb24d2840387,file_infector,26011,108,204,211,319,204
4640,abc42ddfdbfdc7dc45007c39e0640de10b70b277b31505597512dbc442e44307,file_infector,35503,165,297,282,447,297
4641,abcd57282f263d32ac0af47d6a4b807c1f4605dd13ea44f3499a7ca9bd802762,file_infector,28903,117,228,247,364,228
4642,abcf66b439199eda0272e135b15b055c0017aa4f99c8466d04d39e1b95de8967,file_infector,26580,112,220,205,317,220
4643,abdcc148bb32de12c5d61434e898445203db1af21fc446ad3218cb007fea038c,file_infector,28960,118,250,224,342,250
4644,ac11545c24ad91ef2553d5ba12483b5b18b84df2ce54df0d67d78f6f2d6a0f0d,file_infector,53817,207,419,426,633,419
4645,ac24d7982ed730d0feb2d05c67dc72ffef60ee296614d91cfea5f444453bef8a,file_infector,38093,195,305,314,509,305
4646,aceec87b0a13d154c6ef0fe4a72000411126edbf5dcf7030d1a8ae0068f737c3,file_infector,32292,129,266,253,382,266
4647,ad174aa0af54143f724de2f3957fbf4dea20a73341dca884ef144a6a20d2e06a,file_infector,24390,97,163,189,286,163
4648,ad1c732993bb0b2cc42f0a75b80ff0780a7e6438666c458bdb524a6997183359,file_infector,439961,1749,3506,3532,5281,3506
4649,ad1cdd6ab34a2be34b65a5a01c4415cec38c49c6b899ede5ed36bfbffd1bcc74,file_infector,72456,274,591,585,859,591
4650,ad1d722ba4b26b0d98bccf6f0b9dcbee16c7461012eee9ceeceab5d78dc3c6db,file_infector,25888,114,180,219,333,180
4651,ad6dd0deff6ea837fca4d7678d291bbc20e3386a8006099364682acf7322884a,file_infector,35575,141,282,335,476,282
4652,ad90f5256d31d5f988ed6ddbb1d522445d62f8c81069b4fd954e2f5ca784af51,file_infector,54361,197,422,458,655,422
4653,adbc405591ae4cf812ffb8e0c0f6e1780624c1d703a70439cca9b5b60b512c7b,file_infector,37987,152,276,304,456,276
4654,add076e114985e4744bad27abed47c523c056305c3a7ebb6cf358577144d6997,file_infector,1570875,6358,12257,12252,18610,12257
4655,ae1ddcc2ca22fbc2525ab33e258b4b98727c708a5146b73d3bf8862f80e9f77c,file_infector,83533,305,668,725,1030,668
4656,ae266665a9e6f4701e3c73551ae73f7fe653c99338a423b077e4194ceb042bf2,file_infector,331091,1312,2676,2613,3925,2676
4657,aeac8902ce2d88944add23554374e99a42c2f38eed9a65b5913ebb6f0addfc0e,file_infector,52898,210,411,429,639,411
4658,aec600fc9c555189609f74614c1fb8040149437006e6c9fed36d94d00071ea25,file_infector,20928,64,147,157,221,147
4659,afe4c501e0a5f4928152a4ae428763908740dc6d8cde9e1a3f110c2dc4d1f581,file_infector,29678,125,219,267,392,219
4660,affac96c8bcefd99de384465c5c834b8c27c61f7895df67e7d463bbe4bde2297,file_infector,37666,138,310,301,439,310
4661,b01ba2d588e55b56f5b50580f1943a24fa9bb1610a1e180cec606447ebc5dbd4,file_infector,83562,356,679,724,1080,679
4662,b04c75b50c050ebe5b0682d3659c51e9b5021b634a1c1fa0769f90a2109b0d2e,file_infector,53306,200,394,390,590,394
4663,b05d590e9f4f6a6a61900a3a5b4ea82439108269808137511d9285401fc1ee9c,file_infector,26157,98,200,209,307,200
4664,b0762d8c7886389033e88eefabcbd05b49964de98ab2dd869ada257a12888497,file_infector,48936,178,402,357,535,402
4665,b08857aec8703c4f0a16358558d2da152d53cb0c6f509a3048db1cea5a5349c9,file_infector,38050,160,295,312,472,295
4666,b0c915b6252d20846a26c3f32d8548ca224c3f3f4d99239574eace40f85e7a40,file_infector,37655,148,297,287,435,297
4667,b0dfd5aa98c6b0de78312c0b32d8ea63b50b8f843c2f1bfb5bc8032f8050b1a3,file_infector,53920,221,411,488,709,411
4668,b1107f1e0ce43016f427e27be948586a2467fb4c5f6454573c37288f656e92bb,file_infector,26076,102,175,189,291,175
4669,b22bc65bef75d0f08b15d0526195da7038762131fce647d6cca3f9f3c0891e7d,file_infector,440147,1718,3454,3479,5197,3454
4670,b2875cc6d0951333a5ad0935477038f167a014da662fc08753dbaa5de435402e,file_infector,29601,109,243,252,361,243
4671,b367777617ba9858582bbdb3b65c47827f15228f96ccd1c3e23a3c84fec2a83a,file_infector,28754,123,206,255,378,206
4672,b3a54ee9b2663fcc37d8fef2ac1634e2199047f521f9405888a60d7f053bfc21,file_infector,1571302,6323,12312,12190,18513,12312
4673,b3b68b90300b4db2e9fbc8a7f427de1de293ae1538f8b684a56b9fac64fe215d,file_infector,48155,205,360,365,570,360
4674,b462718689da909fa6daf6b52e098c7015bc0f97e7f273678403ae1c84997f48,file_infector,24815,103,156,206,309,156
4675,b4a1b3a3a6f918dd20edfb6863d736534125d6e16bd54cc92b0f3d2900b634c9,file_infector,50560,212,421,445,657,421
4676,b4a98ad9f1863f5683f17c965b4df373e1807e7c53edea662a3565f3ac0e159b,file_infector,26240,129,203,202,331,203
4677,b4d2d9298fc926f991d632de8dc9fb4923e0b266cde66f62b3ef1b94d69d5082,file_infector,349589,1473,2821,2652,4125,2821
4678,b50013dd37bc8c6bd9a1d265329ea744cb46f9d85460c0aa0f4e263335141afd,file_infector,331564,1285,2730,2733,4018,2730
4679,b531dcb277c2f9c9280ea70de7be3814b43fea47640d04932617863646031594,file_infector,83502,342,678,682,1024,678
4680,b5905669d716b400336cfe13b98561f013b9134cfd6f46380f6ce8e791fddd30,file_infector,33866,132,276,257,389,276
4681,b5b546ea6fdd0322b86f12887dda4c77419383830724ad772adadcf0777bd4a4,file_infector,28723,101,253,213,314,253
4682,b60161e8ab454f747598fb2b8c85e25f15e3db7d9c999d25fabaa35ba3253c28,file_infector,104164,434,782,857,1291,782
4683,b60f0a1271b276bd42ccc4fdd87ec5090ca8ef20d2b328967ab7b8bd89ac9033,file_infector,53136,236,444,415,651,444
4684,b6906c1d5610646f6c7f30970deacd771f7b8061aa8cc1f5147ba3891c549803,file_infector,83556,302,644,732,1034,644
4685,b6a7be827fd33df3bfb93ecb8e568a203d5ced8e8885cd30a2a3589122dd006c,file_infector,24523,84,182,207,291,182
4686,b6b75dfd5424d1717dfe19bf2f57aa2be760456d9625b8c63081efc2a10bc009,file_infector,24140,117,184,231,348,184
4687,b6ca95f2c92093f7df0d34ce0f67c08560a940a2e6cb2cfb888c898f40cd6a4b,file_infector,54183,215,448,448,663,448
4688,b6f61d58c480a8951427909ec32d95a0c76469415dfac59cf2bf17d6d546d155,file_infector,48935,202,420,376,578,420
4689,b6f8ac31ba57c9a07c928f12af47fece88903b1b4acb5f855c9d5c95ffe7d13b,file_infector,21372,79,147,189,268,147
4690,b6fc62efb1ef3129fd1b4853f2fb7bf46a73fd0e7eba894a142788a479cf6250,file_infector,53848,245,434,425,670,434
4691,b706c703794885e1106e0d5393f90db6cb8ac6f20f572549e0d0eaa8de83ac98,file_infector,33865,134,252,277,411,252
4692,b76455279cac1861e4f7ee3643312485acaffff6b5c869bac68640488243372a,file_infector,1571301,6291,12314,12331,18622,12314
4693,b764a26a7fa0871fb5236390a024ec65727307d9ab094e7893aa49a63b529100,file_infector,57016,232,447,497,729,447
4694,b782d465cadbf51adb14538bad7f7c1a7112ed74bdbd4d7f56c3cd25a52131f5,file_infector,58711,195,474,481,676,474
4695,b82dad5e479f9b5bd3e052927b260491b6c731e5073e1361fb5badc764e673c8,file_infector,19068,77,167,141,218,167
4696,b85e285f24d8cc908ab933ec5f8d693371bad434d92564b156994dada77c9f2c,file_infector,33893,133,248,255,388,248
4697,b891068f6e99293d79e10f528119f56deb4641fe53b558b01ff7f221eeb86a3c,file_infector,24922,104,180,223,327,180
4698,b896d70653bef032fd6f639ea66d6d7cabb5a41cbbf4a6e7e925fad797642708,file_infector,287415,1239,2324,2250,3489,2324
4699,b8c044dd926f8031066686b7997c5d538aac9dd4385f38d1b865762e1d547fc8,file_infector,38037,156,299,342,498,299
4700,b8c32be3bd083b680cec1c67df7fce92efd147f5b299d8c7bdde295a85a408d6,file_infector,24738,99,205,195,294,205
4701,b969cf7487f6133a16659ee0489bdcae515ffeb3429d9cebd0026d726137fe7c,file_infector,439888,1677,3416,3487,5164,3416
4702,b9a76f9e8dc9fd0d8c7fabae3da4d988dcc39217ab858c165f7b91c7238cb357,file_infector,58727,213,481,451,664,481
4703,b9b904312b6e84070f84c309a3f982856bc8b0125b9bde35073763fc12416d7a,file_infector,158781,572,1250,1213,1785,1250
4704,baf7ffebf2528ae1554e60c30879973b3b81ec0c0a2723c65b65ae0e1d1966d4,file_infector,48926,177,412,351,528,412
4705,bb0691ef900efc7c7449c7a61d5b8de6b02f4ebac22e60518fa40283bd5e41a9,file_infector,135208,529,1050,998,1527,1050
4706,bb371f32131188e397a0b1227bac320533e1eb9e25ffe798c98c40cbad985095,file_infector,56474,228,483,489,717,483
4707,bbf095a7a7ee875b676676bf8b8e65e9cc7db084806c90889d32543393e5a33e,file_infector,29057,106,237,235,341,237
4708,bbf9bd31afc0af2d78cac57c4cebc0a348b40c426953c6f3ae36f80f8ed3cd70,file_infector,35083,163,290,288,451,290
4709,bbfcd14e483018752a800b67b2de923c76ef56cc6b17ab3dd58b5c8bd6f8131a,file_infector,24203,86,194,218,304,194
4710,bc2960387d8043730deb5aed79a25babd802af5ada2c33a847333eca1fa4bb19,file_infector,48567,216,390,370,586,390
4711,bc8268306aa800993e9abe6b6f106db989877fd369e826d6aefa18e0a14e0287,file_infector,21632,89,162,164,253,162
4712,bd1ba3fa1980a6324034584f4f987168038b03a6b44b662535139e9a4d97ed2e,file_infector,19056,76,135,149,225,135
4713,bd258cd926000588828eb1ce0f586fd5e08fa2f6a0f31afd7b98b4f52c23ac9b,file_infector,41684,165,317,322,487,317
4714,be22051493e761416de40c549f09243a70153cd86e74bc014d3cf200b3dee3d8,file_infector,20321,85,149,148,233,149
4715,be3194a4e4d9dc3142e31a51a75ac028af9932ba56dc0e192966dc0ef54947fa,file_infector,35228,146,276,282,428,276
4716,be3e83db472d6db2a88334e535fdc9c815045b68496be2abf580afd6371c9079,file_infector,57054,226,452,488,714,452
4717,be5865c75ed10511bf3b37b28ebd937bb9cbc2f17efcd5a08f5fe7b677395122,file_infector,38037,128,305,331,459,305
4718,be65615a58688d9157cacc6ce39e7a4c9069acef7c83ecd525ab4d3f47949961,file_infector,28765,111,246,256,367,246
4719,be8f25c0bfe9be214bf170791e4615928f72a6958f0ade48cbe677604947127b,file_infector,251213,1048,2112,1998,3046,2112
4720,beb05131f63fef2c5982cd739e5e0e83e606f8f31d879e8bb302230771f5bf63,file_infector,118100,497,912,966,1463,912
4721,beccca60e4920ee9d6ceebe479dc9b035611e5d0de5d2d69287599c6ca83aadb,file_infector,105233,438,924,859,1297,924
4722,bef57b1b10232bd5c782341b47b3e0d1d52478a76015f26dfeb8da9eb9924de6,file_infector,274819,1094,2196,2144,3238,2196
4723,bf5f6f2ec0f1c50d5b2cb2958a51f5f00f0d7dbaab34b432a5ff388725de6f7d,file_infector,83549,334,630,701,1035,630
4724,bf8d723c7034b9bf7b80ba48e753d55ad0f74c1c0300298ee877b0e20a259f25,file_infector,37918,167,287,315,482,287
4725,bf9964944df4d32003411457a8451606fcbfe26322ed470be025e7261ace6adc,file_infector,21906,105,173,188,293,173
4726,bfb40fe7be22dd12a2b6dfd76303eeacd00f5662ee68ecbc2e972a5334cc0f1b,file_infector,1571196,6341,12110,12112,18453,12110
4727,bfce952ff6435ca5102293437c619a0b7cea99ec04f584a36e73fc18fec710fe,file_infector,51318,220,406,432,652,406
4728,bffae145a8179afaa98bda58add2b7dcd2a0780022fcbda59d41fd09a8ae3800,file_infector,33790,134,274,275,409,274
4729,c00f9e6f05eb87275beba092cb8330fcdeaad7155c7518419e4442c09efc8052,file_infector,48976,181,354,385,566,354
4730,c0281b1cdf8f134e76b69478af3ff7c93ecc90b92aa12d26fe5e22011cf5098e,file_infector,39755,174,302,337,511,302
4731,c0691aeeedcf0df0cc9b388c7be870b1424d911469e5a4ba6abf4c41aecb3995,file_infector,53207,198,417,409,607,417
4732,c06f1e185fa2edfc4e18d381cc1f3d02c8135a5ebe7b0bef783a5ecd82799781,file_infector,439941,1733,3490,3442,5175,3490
4733,c0e21070b50847cb24fa512a2337a98e99104ad951331d2425ffe7fc17c4fe69,file_infector,136079,558,1138,1146,1704,1138
4734,c0f489898f62b544bb180e8a1ffc0b527cff1a39b32ee38c219135199b165372,file_infector,83555,329,632,681,1010,632
4735,c117a8e50c7d921a67f0c96cf2d1dc97d1df7013d5c8e870ea3249ce4bc900ea,file_infector,54561,208,436,443,651,436
4736,c1666bafec3ab5e0d263c1321dd0e5f5428e3806db970d92ffbc6e591c3d573c,file_infector,28774,105,231,265,370,231
4737,c1a415d742be10af60ba2fa790a894f317c210f724c3dd3436cfb0a378bf2050,file_infector,29076,120,215,219,339,215
4738,c248f44e8d6c0671bd6f3c0aa820986a72b4f127ff6e8029a0d5dcfea3b3bea5,file_infector,20620,94,149,148,242,149
4739,c284c03c0a33f13031ad342cfc43730c60815e8a83d948023e5395b3f48e8976,file_infector,53662,231,411,431,662,411
4740,c292dbbf5a50e5605f2050fad8afa8ff0c492ad83d59e64b13d6eb7b7246359a,file_infector,26014,93,206,198,291,206
4741,c29d2054a82011668807ba7a11a7b88aa5df5dd1524549109ff489fe438fb653,file_infector,20949,90,150,167,257,150
4742,c29da144104826c5667f412c19bc0497c4d23a6b5afb5708f4fda00b19294f43,file_infector,28805,127,225,210,337,225
4743,c31b743d1e64e3c1e8898fe8846e197ce7ce19eff73b57c1b1c84dc1780f699d,file_infector,26504,102,223,221,323,223
4744,c39673ee23791cb9810c73fbcb60542637c9b567e9be02ee3f0a9bdfba006f6d,file_infector,37898,152,294,289,441,294
4745,c39a65b74c9d4400cb7e8f90be1ef3cbc414db532b1c52fddb64fb61afdba89c,file_infector,274578,1140,2132,2134,3274,2132
4746,c3cdb8f01c5690603c412cc5fa3bfc23b3b280a9889d78b535eb9640130f93ef,file_infector,130202,510,1020,1064,1574,1020
4747,c40c16a273a09171e5f1d5061d76281c7069a3e3336856341d7abd0ccd399f64,file_infector,58695,217,464,460,677,464
4748,c40e8b21febc4518a346cd294832ce5a71200993dad5c0f1b56ef6d3faf979f2,file_infector,58695,195,456,481,676,456
4749,c48724e0e928aad2428b9cfe56032d400c89dc27ca3bafadb4e4cc3fa234d3ae,file_infector,21759,92,167,190,282,167
4750,c50b8cc86a52997f6b0c12ddc4da154b29ce9d4f0c64f8ea6337e366a6f3979e,file_infector,57295,229,439,470,699,439
4751,c5a3b5161694a2e0398a8ca95f6ee389119cc64c6a255a7b4400c2728f999550,file_infector,35536,148,275,297,445,275
4752,c60fd0280dc4aae7cf3a454a08c1b17111b817895831d05c91392bfba74d19dd,file_infector,28836,108,217,243,351,217
4753,c62b225259a1c87ef8fa13ab4b68adfb0622d01ff7841df1689a2a53dbd99143,file_infector,439795,1758,3554,3503,5261,3554
4754,c6da8619f5c65092975e49ac5bfd9bb18ed374b922a871d6887b4601ce868a13,file_infector,1571284,6200,12290,12193,18393,12290
4755,c6e4997858fc735b15ade2c553a5ee7167114b51c3107a89e03b4b81dcc44848,file_infector,35371,155,284,282,437,284
4756,c70a2452090e65c06b419e023802b357329e7d0c28354ee1df461f3f55b92346,file_infector,41048,165,323,316,481,323
4757,c746bf472c32480ab40ec779619f55bbdbdc20d0279d841b4d0f024a841c492e,file_infector,48919,181,403,364,545,403
4758,c81f8e8d45b7db39b60e86ea8d4af0b6d44b96885003c241d7bab2134193aaab,file_infector,38017,158,288,296,454,288
4759,c8250ad0890d9207e978a79c2fed92aba0e00d3b572d9b6c85a32667e12ff67f,file_infector,22322,97,157,161,258,157
4760,c897d317b6f2133631815f75dd82566c3acd67fb794f522013d037878194f470,file_infector,33931,138,255,290,428,255
4761,c89cb3ded643833c9df4c3b8c078ed798e85d011ad09266386e0eea0a6afc9e0,file_infector,57530,228,483,488,716,483
4762,c89cf2bd310f9789149d5484f277bad3fb5e9046096e7855b7647332099835bc,file_infector,52566,222,398,445,667,398
4763,c8ae23ea353a465f46fa8907524a251cd40d3aff1f6f26e75095e75db1a2c56e,file_infector,28882,112,248,230,342,248
4764,c8b8ff8743a877c8e425038e2baa43976ab5c69a405c0fb6088d425ad005f0af,file_infector,29096,133,223,222,355,223
4765,c8fd53753e88f2b275526ac96d2f22fe5cd74bfecb1f2bf92e867984433437cb,file_infector,275747,1124,2139,2161,3285,2139
4766,c90f80958cf9ea8f9b473c70f051789f0cfef359e6b4941d5cb5f9dcdc59d5fb,file_infector,439900,1714,3487,3455,5169,3487
4767,c95bb035918845e21836c63344fd53521ea90bfd16a3652f3e14549be8a44186,file_infector,440011,1746,3513,3578,5324,3513
4768,c9705808619c2388321ba2c9dff363a48ee62c49768455778834b84cb7a423c2,file_infector,24562,98,205,232,330,205
4769,c987c3218310725a9141fcc2e5428629eca99d1e4c6073126299c2e4cc39f63f,file_infector,24190,108,187,192,300,187
4770,c9e1d0b03a372e83070c2ae316d4bab92a7b339809f7a38fd1cca1102a5d06f0,file_infector,35353,150,283,311,461,283
4771,ca62be4bf7a31ca7bf90c86977b4ffea62ee32ecb922e275720cbbe5c493b0ca,file_infector,83566,366,650,695,1061,650
4772,ca938d0a19486db415e9b9ea354cc56e574c8cba02e4cfc358356f7f17bceba1,file_infector,35176,123,256,269,392,256
4773,cbfac1debb04c3e48d376261fa0deb75b7d9f8158d98ecf857a87bc3e2b0da0d,file_infector,48431,223,320,427,650,320
4774,cc04c2dea24c103de60273dad7aee40f5af243e77116b9a30a7e79aafe623636,file_infector,528714,2136,4103,4493,6629,4103
4775,cc2d57ae6324e822b777c7cfbf417e0c21280841c72bdda54dd51b3c2101d5b5,file_infector,53532,212,440,401,613,440
4776,cc3faf09e09f2e8eab28619136620a993d78b27775aa386c41f2251f10545308,file_infector,1571394,6403,12221,12222,18625,12221
4777,cc7d2882fd1830ceb9bb10fa1ba2bdad929e180984f358f7e82704abe7bb05a2,file_infector,332069,1269,2736,2776,4045,2736
4778,ccc65d4099109ea4b9f5603418276c4dc98a4a989d5c23a57c992bdbf6bf5158,file_infector,439966,1719,3510,3473,5192,3510
4779,cdbf115851e732667b64cf5b1a53c8007781c88b0f138bd330d1e9c55a0134b4,file_infector,28947,127,223,204,331,223
4780,cdd07a8062430faf577e29706412759e17119a796e3ecec752985a3802ee2bad,file_infector,57554,231,464,493,724,464
4781,cde0f4264f3e87e98dcc3f3618cca8d63aa51f2661530df9d38235d82cd5ba0c,file_infector,26400,103,238,223,326,238
4782,ce057548715f4630b236ab79c2568a6cf77a39f52810d61de589a791f0719c25,file_infector,106735,452,831,836,1288,831
4783,ce3d991f5a575d548811f1dbb4ebffd8175e7cdb6aebe611db981f398f6e0787,file_infector,251138,1026,2038,1926,2952,2038
4784,ce460708c1e03b102091180796c21dc017184a595910fdac29ed165420d64a7b,file_infector,439912,1712,3420,3519,5231,3420
4785,ce7c3282b21090e1b0a8225512fb8d710d07863c98e2fc1040fa0ce5d17c6045,file_infector,42330,158,309,352,510,309
4786,ce7e3df43aea0b1cdcace1b9d74de253d5d1d8dba0464c11228b54887a6793ff,file_infector,368099,1452,3002,3012,4464,3002
4787,ceb95c6f9707d93fc3c68d14ada1b6a8a5b532e0414666be2c930a0db2afa3fc,file_infector,34751,130,263,269,399,263
4788,cef11498f16bfdc189c4e671ae2d11f86a56a5ce69b9afd43c168e7b63d37943,file_infector,38105,142,278,307,449,278
4789,cf28b9b08fa88934b7b445a9a0d510c8bf7b541e4f708bb257d6e066d81e23e0,file_infector,350411,1373,2746,2771,4144,2746
4790,cf3de0b0d1b126cb20c362ceb7b66106557eac7bc8c3499aa5e7954883bc917a,file_infector,113284,482,884,887,1369,884
4791,cf543faf05ee8fef60f0b342064d6bb7a17afc6ecef6adbbf3ef1529c7107d32,file_infector,83562,324,587,683,1007,587
4792,cf63814c0d81a8c54f4781b6c033c791c04a55b37e546cab95265b781dbba426,file_infector,25613,102,185,201,303,185
4793,cfda85aa7c862e55ab91e252c7807228980d7584c3ab3c814f62329069203aa1,file_infector,140267,571,1107,1098,1669,1107
4794,d03307aa8395f2950903d09edc2a93a587fcb34330365e3ee677efea7d0e1486,file_infector,28754,124,266,232,356,266
4795,d03ff0b39739bdb135f7feb2849277587d87aacaf5c413c0aeb1edbcc2b1e3f7,file_infector,28747,110,230,237,347,230
4796,d05b31422abe1990bf7365739e4fbe0779ad84121cd515c11470691939f4ab84,file_infector,54672,207,449,448,655,449
4797,d0a4ab08663d22426827979bc9888d08570d03ad061764a24b07a79d42ff9f1d,file_infector,83649,345,633,693,1038,633
4798,d0a9156ab5819ec1d63378e1265d0633ac1ea83eac90ab22300e33c9c0a537cb,file_infector,35298,149,283,294,443,283
4799,d0e6919aac22fb8d6f465c28fb0ba94f15e5e37f49c3317aa2a877bd170f0e5d,file_infector,195013,742,1542,1466,2208,1542
4800,d11a8ae9db1fd7c51c492855caa58a67fa3b270519054ddc754d831943a81d60,file_infector,58734,207,467,479,686,467
4801,d236d55fd9c0f842a2e0e33c4aae22d69be8e943e9f34148142b8e24b84de55f,file_infector,60914,238,453,474,712,453
4802,d25420d3eb10673851e4df0dbb2ad6ef60a80cafce547e65657a00a12c16bcb3,file_infector,26177,107,208,237,344,208
4803,d2d7d0daf807c811b054a64f9c57ad274c45d708c797cf5748297dc496399c8a,file_infector,144472,600,1146,1142,1742,1146
4804,d2e031f4340d535474ab09e2a903777211d31834aaf09eab8030d55529a36556,file_infector,65135,278,538,528,806,538
4805,d2e0ff457c26e969f468fb83fa54fd49d4839d95c7b3100874af4431de13740e,file_infector,331220,1357,2666,2644,4001,2666
4806,d2f319f3cdd29f66d44a4a4206529c531102a98690a5b696b55950f506b492d8,file_infector,33885,133,272,274,407,272
4807,d390da559f2c2cfc0426bd9783cfea833e6473318c29e082031ee3e1881dce5b,file_infector,38069,165,313,295,460,313
4808,d3fb9ffa3bdca99e6925acb56ba99e395220b0b5a558cfe235a6ccd187b48f58,file_infector,64471,254,537,558,812,537
4809,d42e33b20621f799f34cd65568c7e7dae072d19bbd8b7051b3d99cdf432688f5,file_infector,1571430,6225,12229,12203,18428,12229
4810,d48d113a60d3194888bfeefa45636176b0ffc61a274a3e1082020b93171f4408,file_infector,136368,546,1052,1041,1587,1052
4811,d5b8baf3166a6432a03f874cdedbc0d17557b29e6a462ed3423131f9a00687fc,file_infector,105137,445,938,854,1299,938
4812,d5f4d06694ef01c3f12488040baa13af52549222945147089bbd33564ecb569b,file_infector,29720,141,231,248,389,231
4813,d62b36df62b0954c0c6de8e178aef848f6a6ae7387be258da7fe1977808532b2,file_infector,28725,109,222,230,339,222
4814,d63a8e380dbca303bbfbc54f6f18fbdfac4783bd290860bd1576ea36708127ab,file_infector,34794,143,270,266,409,270
4815,d666c9d46da73321d4f901d6f04a6c1dd3a51573da818f4ee27879dc16d4923b,file_infector,33852,129,250,293,422,250
4816,d67303f569c3d32139af5798680a6de30487f895169a89286966394e5e5bfdf9,file_infector,28924,109,222,209,318,222
4817,d673f121cc232e0a484c88c7e8f7f1f3b59a83afc10a6a85cc70a9e55cc59051,file_infector,21720,80,185,155,235,185
4818,d6a0f7d717ff64e43993f498bb80893d9f35c27c524eb9395a0386695c72e7c4,file_infector,83597,355,651,706,1061,651
4819,d6e3c36702cadc4d358187d41d34bed9754f35c641fc111a5f698c63f51648a0,file_infector,28765,115,249,237,352,249
4820,d6e861479dc505aeaf2ad0e9ef3c6ae9d6e20a1204e1f3b20825edad516f1e5c,file_infector,58637,236,465,457,693,465
4821,d6f90d41f0ac8fdb8bf5db780b24c96334f0fad4056a5a256546411917e746b8,file_infector,25969,95,225,212,307,225
4822,d70d303a9652912b2c14db18f8ecf9b280d314f35b658da6a03f5133428fe6ae,file_infector,38080,162,305,315,477,305
4823,d73bf97c7a909dc1fecd6d76541a5b2c3613b9192186861ad74cdb558f07f444,file_infector,56820,218,432,486,704,432
4824,d7876098151f23b119c9be6d4a675af3e2367f2d0b34bcb08e9d3537b6a1d624,file_infector,169156,722,1356,1378,2100,1356
4825,d7c0967f0fd6cc1079c50b557263ad1e61ba3b1553b4b3f01c51e95cc6b205de,file_infector,39761,159,300,314,473,300
4826,d7ebca975166bdbd47f92b2ba7bc76e42d127af36eb9010447e361c1e30c0f84,file_infector,449822,1803,3618,3759,5562,3618
4827,d8203a0322704043fb33e61b5a5bb8e22d236b52e1505bfd4295d3b1efb30264,file_infector,53007,196,407,456,652,407
4828,d84829da86109c8a0da75e56eb7c873904d502b4d85ebdfded41379105724165,file_infector,21665,83,166,180,263,166
4829,d85f9f94a72bc51263dfa254f4c4ed04275c47a963c7ccb5b2c1d4d8e98a3378,file_infector,57307,237,465,505,742,465
4830,d85fb7758b4e50c2752ab300a206073875bfc61e145b57f15d72f60a62d32f2b,file_infector,22680,80,173,192,272,173
4831,d897afe79689dd513f53d4856e5bd835fa61dd644aa8978985200d186d456241,file_infector,23210,93,159,182,275,159
4832,d90e91cd373f1f269b3e124a081a7505c61f06c1cb57db1850efa73e74d73660,file_infector,251233,1065,2054,1919,2984,2054
4833,d93bb1d7db24bc7b84a6f723a4e6d8e776ce842e3e400390e5097e8cca415657,file_infector,38108,157,307,322,479,307
4834,d968a7096b346c75e6ddb4d9baa200ed64fb49ec16409b910a94af218a58f1fa,file_infector,39604,149,311,306,455,311
4835,d9c5f7a8ed28802dd64f6d5b16b169e6cf832544d1899972d426bfd51fbbb382,file_infector,155091,584,1334,1231,1815,1334
4836,d9d015b24e625b2c154c8cc2bdcec9d8d8a73eccbe2d8e105ecb565815cac2d2,file_infector,54025,199,458,435,634,458
4837,da29a909833762f1ce2d635f69d9eecb7ac3e197ca333232711ff7ba0827f979,file_infector,58718,214,483,450,664,483
4838,da7eccdd5896ad47ab036edf82baee97789fff51f5d533ca4e6a4a3717010139,file_infector,33906,156,268,287,443,268
4839,daa2f3c5088b9714fa6e8d080c685dece0b77241261762c8c97f1b924253563c,file_infector,24814,96,179,188,284,179
4840,dadd937ebc8fbb8edb6fc5904255e740c908a532e719711c1de34a808448e1a2,file_infector,51461,203,359,418,621,359
4841,dadf73833778241a5f2bc24956edc602698bc17e511adfdd70b908c66da51e91,file_infector,156290,589,1240,1174,1763,1240
4842,db2cc6d62a8fdd4e6ebd70734f5396defe45577d343167d21943aec0d271f65d,file_infector,105211,440,914,852,1292,914
4843,db2ed9f847eed9f9f18f747c1aa5f4f5c3eb7c459b7d7e0c0d2d34d62ceefb73,file_infector,356720,1405,2708,2834,4239,2708
4844,db7560ff9918518ce7e649205db18e7c3b2c0bc65ca2aa422ada527485439a29,file_infector,1571352,6291,12269,12323,18614,12269
4845,db7987640247dc375a0b69d8a186d8175bd651965d882b7165f3f24f2723cbae,file_infector,83641,348,629,681,1029,629
4846,dbfd1366df4e23ef2f3d0e35952cdd5dda308f690c4a3aea4a120488d50614f3,file_infector,274974,1109,2182,2220,3329,2182
4847,dc14f80cccc854d64cd5e01bd09ed63a5f44dabe95b35c8fbc3a1c31a0e904d8,file_infector,52812,210,422,448,658,422
4848,dc15a6b09c80202fb6cdb245fdc42a580f88e86660df9b0a6130c78866f8a768,file_infector,331014,1368,2692,2698,4066,2692
4849,dc38182a87d60a84312af9e7708ab8adba7a5e5163b0c5ab6980455a04f4f992,file_infector,39751,144,294,316,460,294
4850,dc727f6abe28259d6d2e15fe6cfb649da569b115218c169b1123d75939095dd0,file_infector,21415,69,172,156,225,172
4851,dc8ca1e8edb3a2987e976af2e86651f21f2e583ececffa6d44a923b7ab63d824,file_infector,36923,146,327,284,430,327
4852,dcb65c24caec9e0e8c63a86043aa74526139220400654ae077ec9700e4dcd199,file_infector,58609,218,493,467,685,493
4853,dcbf9d971feba509b0bf226e78ac98fadd89c310a5ecc8f11fb4b253d041da74,file_infector,53097,220,409,414,634,409
4854,dd60492df5c89525d699ecf044ebd3a92354ce5d62e437263f3cff2fd7da4f05,file_infector,349294,1405,2744,2858,4263,2744
4855,dd64fb7b9b866389f503a5e8773facbc30c74ad49b8b2f475da2c20713737cff,file_infector,24407,111,194,204,315,194
4856,de264aa53987f2ff96594bef75757745b97165ae2b271ea471efaf51a6140473,file_infector,18777,72,133,127,199,133
4857,de2e91dc1211e8c3e50e5b257cf99543b364125b3a754a7b25a3176760217874,file_infector,33882,122,293,262,384,293
4858,de56a38db8431cab95dc2a0679b8a445e4b937754a22fe2f06f37baa17ec8474,file_infector,21535,92,189,152,244,189
4859,deb70a545e3c2e89280476a25f35d8cbf7469922be4fda7932adb86f56ab373e,file_infector,136915,555,1152,1101,1656,1152
4860,dee8800197b4c89d6b565a4c0f7c6129b3e11d16729aa3621460d2678316c268,file_infector,20170,91,152,158,249,152
4861,df40df5e95e0471f5aed2456647d96048031360132ee6aad76a264d4a7cd884f,file_infector,274224,1107,2116,2191,3298,2116
4862,df4e0bc3e95b1cb0e50a62197cf882525cdea6442227702ffa0c5cba7df1611a,file_infector,49305,229,359,387,616,359
4863,df5815605ccf8833d4025ea3af6613143172946d51b445534433d5b4969ad5b8,file_infector,83548,328,615,688,1016,615
4864,dfa090686b7aebfda9cf62e2a4e0797db4365228e3654789094fbe4f86f99618,file_infector,105592,422,762,850,1272,762
4865,e037a4c57aaa5179c6b3adadb86fc4e192f75ed0b5ebd35a94f17497348e6a69,file_infector,48897,181,403,415,596,403
4866,e0986caf1deea616405372192500b91016fee08bbe9cb2b8f41db4fc1ef697ca,file_infector,105195,450,917,834,1284,917
4867,e0b12ffc3bfc735e9c9323118bf187d078545ae056bc6fd87f0314bb8ae6c8e7,file_infector,20395,76,167,159,235,167
4868,e0bf448da6298ed9ff2cdea73b0b8aa583a65914c96272e869c923f03490cbd6,file_infector,19990,86,182,145,231,182
4869,e190197b0f1b7de8e5285242bdcb38903df8d18ce48365414fccf7bbc80d69e3,file_infector,20091,82,169,188,270,169
4870,e1bb6afdde40e434b00635761209e02c362a1ca9623769c4b3b80cc91413f14d,file_infector,38092,134,301,317,451,301
4871,e1c3380bb2a122692ff7dd56afec6aec0e6cf37c64881120151382d33213caf4,file_infector,63731,223,506,513,736,506
4872,e24d111265a92f79ede195c40654657d4d747a8e3a3c71771393403175fd231e,file_infector,33925,133,280,262,395,280
4873,e28074ab8969f49695a06e1507362aef61d80aa47ec6d99366abf36117b04ec4,file_infector,39841,196,347,320,516,347
4874,e303b2ca8d747c0f5113edbc4db5b1dfc05ac04b9a567cba496b87c7f045a60d,file_infector,182361,697,1447,1503,2200,1447
4875,e317fd090113032ba94d0a2446b90921c658ecbac1a27b8988bfd3b17d4d81ed,file_infector,28780,136,223,256,392,223
4876,e352eb2f04f914cf402d8ca869670cc8256982f98ba6cb88e0c4a8f809f0f945,file_infector,24524,101,183,193,294,183
4877,e3a1f742ef61a93e6adc5b9667b88b7983c82f9c237d2c08c44d68ec18906eb2,file_infector,135348,564,1069,1088,1652,1069
4878,e40f4230c47822e558e6205e948370fd3dc8d9e02fc52d70c8ed06922b17da82,file_infector,26350,117,222,214,331,222
4879,e4237f0195d8f6adcc50b49f806d43eba2c5187f2d742c2bd2bfb741a2eb29da,file_infector,20993,75,174,155,230,174
4880,e4b688f6b965624b1939faf125e6ba4270a639806fd4455e4d541c1b3835e22b,file_infector,26316,92,233,212,304,233
4881,e4ed1ee35e6cbb6161a59b0899958823cb7eb8c4adfc0d9d41360bf7a9ddc510,file_infector,83514,325,642,697,1022,642
4882,e54d9f4fd8e3b136f8adf359b51259c7505f0ec73dd64733359983f57955662a,file_infector,37968,185,321,309,494,321
4883,e56c6168ec5a61dbd8519736172592902614428beab9da50b50523ce5f830a60,file_infector,57146,235,446,477,712,446
4884,e56db8d0080d8495a1572a2ee3a685e8592ec6876d5d945e7bdb268d25fc3f93,file_infector,23248,87,196,196,283,196
4885,e5817eb3ff707a15ba8df87667b34b0a94a045746ee893ae74dc2111593cdc84,file_infector,28673,125,225,222,347,225
4886,e5bba4124a59b60baf45da2d1f06f1b6c84d5b7a20b9741e353f962d6e4aa167,file_infector,331369,1287,2672,2721,4008,2672
4887,e5c505f818208455a213ef3c2dc892adc128d9193a195ea97b5a3df0ae34539e,file_infector,91379,380,715,720,1100,715
4888,e5e39f21fe163346edceba3b2926bdb34de26248c2870c3861e999cbfd69bf6e,file_infector,23186,91,163,221,312,163
4889,e6394ddedfc4aca2a9e5f3b8bc3b5a195fd1f841e6c3842d4e51477080fbc43d,file_infector,56744,230,483,486,716,483
4890,e63ab2c249106affaf21417fd7e48513351c4ec12c46961302a77db13cdcefbd,file_infector,45254,203,378,379,582,378
4891,e69a6f822b52fedf179acdd35eda95db8caa7dd89d275c729598826d3ee89e99,file_infector,53678,219,420,483,702,420
4892,e6ac54f35c49b1d76dbe8fad06745622437102092dce7a9db356ea54e403aea1,file_infector,37998,139,286,297,436,286
4893,e76ac29967c9e12ba52ed921e9ca2d76354edb396825759a58f3527182d5cb33,file_infector,28790,107,247,233,340,247
4894,e7b07f9fa068aa84fbb144f3a4f231cdec55eca3ed6875b77629fa42368b8737,file_infector,194741,872,1543,1635,2507,1543
4895,e827442e19b4e848113a55922a53916e61059e92e58070fd84668620791886bb,file_infector,83584,347,659,703,1050,659
4896,e8fa4be9b1a34f52a2e3c212618c28bec6b28bd8c7f4a73a53662977e47b5e30,file_infector,24877,114,187,211,325,187
4897,e915dbcb508fd42cafeefe1ad724b421bf5960cb10978cbdbce171e6be2e832e,file_infector,38051,152,280,304,456,280
4898,e93511ecebe9c0c7d9737e25248efd1d34786bfbab2a93d6ddf8b7b0865c9a4a,file_infector,58722,223,461,485,708,461
4899,e94c0cefb04d5cdd1078df33ee3aaa8acdb9a34a3e5475e0aaa52dbb71b77e67,file_infector,27770,134,215,235,369,215
4900,e96045d28c1ddbb3d4c452e2dafd71074f0df45f12b9a8c1b37d525de59a2a0d,file_infector,1571379,6314,12151,12244,18558,12151
4901,e962634b182e8ed2268ea3de9edcf6c33661d751915e54e1fe9ebbae9a8b744c,file_infector,26499,98,197,237,335,197
4902,e97bb325ce2d2459d65f9f55fd9eb7684beb00ec566439f66d4aaa379d661c2f,file_infector,26635,95,218,228,323,218
4903,ea0f64c0206bfe8e4a0ab52dab7135252da7f9a87d712dbd49295ef80ec798bd,file_infector,29656,128,217,225,353,217
4904,ea22604100e979aa4e10f58dc4e57e49f67e29834a5051ba4dd2312d4e400996,file_infector,251178,1005,1993,1924,2929,1993
4905,ea72049051c79e09ea96f2d11fb2c80d7861c187fc359329edadebae6e20d88c,file_infector,38001,123,292,298,421,292
4906,eacbcd5514f73ccbaa104a0252d5290d9280fe491c71fe969c572ff48efeddf3,file_infector,251166,1010,2090,2013,3023,2090
4907,eaddba6502cc020f13653d9b6f42f7a700cb8801b4f474ea1e9f27d882e3fc91,file_infector,24443,99,189,178,277,189
4908,eaf9a9e9f838fa9f6d0d4aaaa9103b41733a31f1d0a87a5782a047cdbfa08892,file_infector,20028,92,153,152,244,153
4909,eb374b4e52aae825b5bdb823a65c8aa8f1cb25309b3346fcbe5494bd2d6746e8,file_infector,29019,118,245,228,346,245
4910,eb660805e97d51230f672ffb9bcd1331836d18406c7af06ad546c7473a4107f5,file_infector,60571,254,485,484,738,485
4911,eb7e0d0fc2e349ff7e2a5754129c41994089835a1a64c6f5c2c0307574a144d4,file_infector,32764,128,254,272,400,254
4912,eb94f1cb0808b281e738906cba66526b5fb2654d20121096af912b9effdfa38d,file_infector,56082,204,464,477,681,464
4913,eb99b78304565ae290280f6d01c2dc9edae638707d63ee7be1c02e15daf6a8a7,file_infector,35339,145,287,294,439,287
4914,eb9bcda36831cc38acafccba6438bdf7f7b2b785d5a4a3a43fb4f445a477fdce,file_infector,28706,117,209,209,326,209
4915,eba92e87554f9252f2f596da29b8ec243b86147bfcdc8c7bd80c9d251ba78f36,file_infector,39758,134,325,339,473,325
4916,ec3aa3e6a2e349bbdbf1110109222e8c4c51d0f7dacd7a8ee505370b2bbace6f,file_infector,20410,73,146,179,252,146
4917,ec64c51b1b3c5599d76e278f8f65c94a6e29577841cbddfdd95901f62a307cef,file_infector,20837,76,158,162,238,158
4918,ec8981d8b96aedf64083296fa01dd4fc9c41e033e6ab8a0f28a2cc1051a121f5,file_infector,20227,96,133,151,247,133
4919,ece32ca50a4773f0e82a4e23c93e9bc17433263564a6272e1efa37718cf14278,file_infector,21454,82,173,185,267,173
4920,ecea44346a1fa1a37be28a7b51b04c3eabb7de29eec7c82a535d05f19e150d6b,file_infector,51208,234,424,432,666,424
4921,ed412623b9b23e1ab1552ed19723ec5d4a9cf20d59c164302b6d8c7717fe32c3,file_infector,331188,1299,2758,2740,4039,2758
4922,ed542e549fcfeb2a8743daf5c0fe1159bff7db9c19468cf4fcfcb6d7ca51d43a,file_infector,19040,67,150,145,212,150
4923,ed5eb3f5410def558c4b249410b5046574aeb0e3a532e89667b90d6ad871493f,file_infector,38040,144,279,300,444,279
4924,ed740d2529d537985a2dede862400b9bd7a6e311037647aa1b9e24e641465a0e,file_infector,28949,119,233,206,325,233
4925,edc51608826115a3c94dcb5a2a3af46bdbdbf020e665a0cb36fac9743e460d7f,file_infector,74929,289,602,577,866,602
4926,edcb8c990ff00ae05bf2874183b1f08c6d6f62ce6466085cf92d08817ade56d4,file_infector,28810,108,231,259,367,231
4927,edcf20d8ad9ae2b96aa0f750e6da7566331133d6199c5c890106d4877ca07ed2,file_infector,56330,205,426,508,713,426
4928,ee1246456598d1f61328edbde991bc498d7ace8c2a6394b757ff99c7684fe587,file_infector,20860,73,159,144,217,159
4929,ee602878699b4758c7e7987a30ae3297f4229988f70efb4bac7dcd9fa326fd35,file_infector,24508,88,209,207,295,209
4930,efcec429f45e184aa9542c6c6f04b7f8e85226cb8b190f565b277a9989735865,file_infector,28935,142,247,234,376,247
4931,efcefa3fc81289e2719f9970365caf55b2455112962e7ca719008ffe0b58135e,file_infector,251118,1034,2033,1998,3032,2033
4932,f00e1c760d79d9caa433c477bdbf1d413feb6e605c2a54977ead75221c1de895,file_infector,24602,106,218,198,304,218
4933,f03300841c52f57fd4152c4c910deade7f6159d8d70505d93a45beb9979302e8,file_infector,20514,90,161,153,243,161
4934,f065b4033474f97eb69281caafca6075279ce269083e5ea31a03a880df8424c4,file_infector,35744,176,273,264,440,273
4935,f0cb2e4e6c5db53427c9dc4db0a81380996fbcdf204594c10ada483566abcf86,file_infector,1571312,6385,12370,12222,18607,12370
4936,f0cb55fbc33a6367c113239e2538f306e8deafd774d1798aa78030a4c4bfd505,file_infector,1571292,6364,12269,12359,18723,12269
4937,f1917ee2b86e9f020f27bf5141562427e8a03b8d324b439ea2a6dab41a0e7473,file_infector,94001,405,699,784,1189,699
4938,f1f1243343b6223f1d8b88d064a923d4fe97f05975155cce6681c6e4e4fba4cc,file_infector,57185,247,418,495,742,418
4939,f20bbc4c311404f0be52d179337f2e0ba0cd3613ebc698a70a5f23a2eeefd482,file_infector,28723,101,211,247,348,211
4940,f210fe8c6d380e14fa3b235c9bd6c5fa65988839229363eed43a15a68b11b59b,file_infector,27217,100,245,190,290,245
4941,f231a5f2efc28aa6ff593a690f10e3f7779ea7857b20c38c250863f31de6aea2,file_infector,24696,93,186,181,274,186
4942,f25d5bb77521645444beb54a7c8873173c18810c06761f03e1d1ecef7a3cbdcf,file_infector,28799,121,247,258,379,247
4943,f26cd3add2a741cba4d928b392e6de1133a862f2535e9d60ff9e77dc1cfe31dc,file_infector,24414,84,185,198,282,185
4944,f2c48c78e2d43e0e55979d0bed9f898dcd262b2c3c900e29f20b400374c01817,file_infector,38065,133,307,275,408,307
4945,f38d56a99bfb5ee10cbaf85a41ce3fb8c9c9a78d9721ce5a29a979cf8c80d151,file_infector,34871,144,325,279,423,325
4946,f3ba650f1298e0b55aca1dae6329d79c760d224b9ad5776745c0022d082677fc,file_infector,25886,94,227,201,295,227
4947,f3ccd616c22f6f9b8cedd168289dde0d1bb35a50fb657588fac3160536955b22,file_infector,21994,120,173,198,318,173
4948,f418f98980a7b5084f70046ae20d29d1323c6d880e5ecae1d6ca414aba105059,file_infector,251147,1003,2111,2029,3032,2111
4949,f4b4f71043fc479166b41792de99fec88f8677ee0b3872071b853a5565a25652,file_infector,56532,231,437,477,708,437
4950,f4c1861614f32114c954420f015afccfbd150b56035f134ac0ab90a93791b089,file_infector,28737,106,233,242,348,233
4951,f5233e35beee7184ce8b4fa0fb8962da8d645631a87f1f78a2f9e0f05d39ba7f,file_infector,93101,328,748,652,980,748
4952,f5259ca71c5ee997c68807716bfca34928342cb637874feb2981211e1f100b50,file_infector,30869,122,242,244,366,242
4953,f5610f5fbaab3b2c8522b7ba295afa13a054dffc1b91e4959589b1dda4a5d975,file_infector,53084,221,423,445,666,423
4954,f6491c76ae0f56b7c676424e6619fde262c5a00fd0706f790308f62a3a61c3f2,file_infector,129915,500,1032,1065,1565,1032
4955,f64a82a96c3824c80d4163d22dfa0ca4de2825757f4841234c6bf29b5e11e85d,file_infector,440027,1732,3497,3511,5243,3497
4956,f64a9407a9169aee719af7c3752c86f2046d257d9245d0100a5b09cc46f9ae0f,file_infector,83593,315,643,668,983,643
4957,f65ded604291fb57dcd12b09ffb9523c9581b2efb56651d6eeed52137b1b6390,file_infector,86922,327,750,749,1076,750
4958,f6600e8cb58c1f832674fb8b9af8ace06e445761f1d42704966af42eb0928c5e,file_infector,56488,221,457,444,665,457
4959,f6ac7a479022e1e53be149cef5891a93b0f7598dc10b8da62db7086434fb76e3,file_infector,53522,209,414,409,618,414
4960,f6d09d90c54b954664ab3b6c77a1e1081e4bc71667ca28e6abf20b3797e592b1,file_infector,34800,138,279,274,412,279
4961,f770e661112529de6aec88e3a59617fdcd42bd7f19e7e4ab6bc34d1d9ab2cb2c,file_infector,251170,1002,2097,1976,2978,2097
4962,f7e161113ddb7bdb4f4d4ceec0ef36799af50cbca6d112618f494f5b9c971d11,file_infector,57028,255,448,494,749,448
4963,f80efebf9a9e87a188752cfddd3145e99bb9464c04b6d56b27ac693215a75e33,file_infector,427370,1735,3271,3417,5152,3271
4964,f841ad91575697b6db524efd5cc96db5633e06de5740cc43334553afb8ad60fd,file_infector,251171,1107,1998,1949,3056,1998
4965,f92bd329885d150b6a0c25d010eac0ff7b7a2a9f5c9733a80a2dc43f7073849a,file_infector,440104,1713,3558,3489,5202,3558
4966,fa50451551174cd22d25d7fccb2c35265c94f8b342c10af0b2d3b6014b5c89a4,file_infector,29604,117,196,222,339,196
4967,fa8363b574e53eaacd7f4f0fa52e57fa722ca9f9374de86b40fd816811646f6c,file_infector,50577,211,391,424,635,391
4968,fad461ac5e4f14288ad1d101b72a27960c944fa6b878bc7019a3619cbff9a46b,file_infector,83539,353,622,707,1060,622
4969,fadf3b336b9a2a6218c89656a2a57e162f41fe65e95417e453125a5e5085ec4a,file_infector,24572,94,187,196,290,187
4970,faeab291ec1d067b8f5cc44fe93768f2eb9a2be78939be7c8951cb10c4a78e47,file_infector,21853,85,160,195,280,160
4971,fafa2e5e825dd9cb71d79676095642f76eb197d7db000717612ee76f6abf31f9,file_infector,38036,133,271,304,437,271
4972,fb02cfc11b941863021b640a5181e96b4540ad06acd645d5a9f4cf9ad69ddfb9,file_infector,50194,208,407,456,664,407
4973,fbc9b08efbffd854afc28ac3550a7f7dd16aeb1acdc28f0024f68eb07e9daf26,file_infector,518506,2020,4087,4230,6250,4087
4974,fbf028fbebe8abd7db95584e837e57a33bcecefba45d9ba885d2b2e8d603b990,file_infector,28768,105,224,254,359,224
4975,fbf50a0afe74fdae5832a89a0367d96afb8d64d2f2e84f46c0641b5d35109d21,file_infector,57470,216,502,506,722,502
4976,fc1d04734290949603b9e776b72a8737b45e33160945d0c7d90d8b91c100a92a,file_infector,24454,111,189,189,300,189
4977,fd05734a8104e8980f1fbd1b3cddb0418922c879e1e3adf6d529d5aeb5bdd564,file_infector,22286,88,172,166,254,172
4978,fd234b8131d7b490fa7aeefe729f5c513ed64953abfe1a201d1596ce4179fd95,file_infector,83581,356,626,723,1079,626
4979,fd5989e5362061b7e54af777bae5559823e95e281ecc10c646ecff797b1480b6,file_infector,54420,208,423,465,673,423
4980,fd75f0c2ea047472c357a8388d21269bd790f8de145af054707df8b2aa63a5f2,file_infector,49790,213,412,396,609,412
4981,fe3899b89b3405edd9740cba899bfb1ed058362c4247ed4ca8729d9611e5b006,file_infector,35122,153,251,293,446,251
4982,fe4cd2dd9a1a2e6d4b298909f7aeb5738cd6c0ca25c56d40b1bd8d2752cedaa9,file_infector,35198,159,287,286,445,287
4983,fe561947d604bd676c029566399e638a2694bc1be0acbaf07cded2707abb60f2,file_infector,21338,75,155,200,275,155
4984,fe678c366b1a23f0020c18dc2648f49748ee8af50f00e0b9cac66a979b2e107b,file_infector,23859,97,188,217,314,188
4985,fe7bd2f88b95173242a3c435f9f1c4d4a7b4384cd83a9b5bd105187612872c70,file_infector,28650,103,207,226,329,207
4986,feda4070302c6dc0370cfd24a5126af720bea09aa776f51c79d490474ab3f72e,file_infector,38021,186,276,286,472,276
4987,ff338a93bb01c6617acddc6236b6b7514ef55b91927e14eb71d8e35b908d367b,file_infector,251145,1002,2071,1996,2998,2071
4988,0000de5005ed1b3dcd1ccfa0796cb316a19eed1cd448a5d0c7e0c786a4bb83f4,flooder,128839,484,1011,1064,1548,1011
4989,005a1ebcc1046fa15151b57f19cf6156f77149a5b9777a2fdbb3f39c4709f6a7,flooder,121627,454,950,914,1368,950
4990,007a8a14967d676eae4ab3d5fec76bf04325f395efaca05d8471547138f58788,flooder,126037,507,1012,1001,1508,1012
4991,00b3e8e504d0bea5448581e1a63030160ca57da24fa1217288c4459644406d27,flooder,130984,489,1049,1002,1491,1049
4992,00f5f9c2e374c81eb45e2fea360228230fb31a33281a683bc0e5dd8ff9e4565c,flooder,130957,512,1043,997,1509,1043
4993,01518a90c533789cc5d76f494856b15cff101b0ee230ddd866632e638a91a4f1,flooder,126483,478,987,1040,1518,987
4994,017820ee2e39ef8b3aa56e3ff30fcf17341a0b52c6c2ea733322f40bacfb8713,flooder,126668,472,999,1046,1518,999
4995,01bae9ffa6eac25f132b115ac73e06b68594288c7fcd39e9509e0575412766c5,flooder,131083,488,1049,1003,1491,1049
4996,025860c6f8c99bd81095063a1a4230cfe75358460ac7cd265b7390675d77c6a9,flooder,126196,511,960,1000,1511,960
4997,025c81754525bc9d8e041573489eef47fe7db6a7632028bb8560ee3927ae0d5f,flooder,127505,512,944,1040,1552,944
4998,02c47dbc7b5c85050db4cef943c8ccc76ed414b2f80da8869c9e1593672f6647,flooder,122853,494,976,1031,1525,976
4999,02fead705d3b9a7892ed117320d81a712a248f34302d862c0d06f40dfe48f21b,flooder,127537,517,943,1029,1546,943
5000,0302b8fc0665c65a0043572f1865d6aec3a5be5c36efeebdc7626ba8acd5bbfd,flooder,126111,487,994,996,1483,994
5001,0309fe2d9aae73fd66c9e5d33a6f79d36d25f55dda87232761f289f45b6b2d98,flooder,126598,468,996,1047,1515,996
5002,034058441b1c7362b507d108f80ec2bb659bc1c4e8e3972510772ae1b1a32a57,flooder,126161,513,962,1001,1514,962
5003,034edc31b2fbf9e01113ef09503bc3ae7851e4a8c199d7e16ead6a381366ca1a,flooder,133863,502,1046,1101,1603,1046
5004,035870b7d2a3478599b8e3fc92bbc9750079d7aa2c8f6f2e3e8ccdea48b042c0,flooder,126228,491,1008,993,1484,1008
5005,037c606305802e257236ea2a5e24a251e8dd56c3f072cd3af112f373c717ba78,flooder,126280,468,983,1045,1513,983
5006,038501fe1f7ff6f853f07a3fb4391e84b342a63dd1cc85dae6ac5c6a41946b46,flooder,130303,498,1052,1035,1533,1052
5007,03aca205381ffb4b19ede8344f4c208396ff3564e77398f61781ea782804c17c,flooder,131111,488,1051,1004,1492,1051
5008,03eb99a905c832692b962bc1f30ebf5a5ac383f67a9319f9a7bf24d2334dec5f,flooder,127504,516,947,1034,1550,947
5009,041e09e15c023128fc8695dc1deafd81f48189037ad0c5a5df2378a390eded1a,flooder,117456,471,902,969,1440,902
5010,0475f1c05f624a2796987f1efff5840d686eb374f6957228db5923b1315dcac9,flooder,126078,479,968,1024,1503,968
5011,047cbaba9a45fc2a288d2efd592d0d8a1f6c54c5e30c7813dfeb03285a3b5ffd,flooder,126629,465,989,1033,1498,989
5012,04a4eb77c8e597d6762b4f88068de7c90dde2eb89f6810c1ee6039dbfdf8169d,flooder,126650,467,987,1035,1502,987
5013,04bbd021704acff9a7113b6bb4b4075a0122cf0bbac9ec0b80ead777d7dc2d6d,flooder,130965,511,1043,998,1509,1043
5014,04c5db70e41094c4b0a21297af9c9ed31832c77391303f6dabff2ea8969d54e3,flooder,126120,504,1015,1010,1514,1015
5015,04c9f2a3b0a4645bc7c1ffd44af69bfa8c0d21fa4e85b5c0ac2cc536c1cc278c,flooder,64823,265,513,531,796,513
5016,0518c52fe8076d154db9b6748049c5d6183aee5b4db35dfcb22815c4c7f7c001,flooder,130980,488,1049,1003,1491,1049
5017,0559504b09b2638b6af1c315fd1718f4a0f1c22783b612379a6e07562d9f4ec5,flooder,131015,488,1049,1002,1490,1049
5018,056b226752313ea0fbe614712395422782bc638b2c239c8bd429e44b751357a1,flooder,126011,485,1000,1009,1494,1000
5019,056d76df8b707b9d5e488b9aae6b8b59f8594d3eeb081fe600c49057a55f1e0f,flooder,126001,501,1023,1003,1504,1023
5020,0572f3132042a277a97b1127faeba0ca5d8e80c77096c3b1588dec43ce8c2ad7,flooder,126200,477,1003,1028,1505,1003
5021,057374e01f394221a8c919d995311f326213f35e7febf312b57b0a56cab9dce0,flooder,125999,493,997,999,1492,997
5022,0662115a7833c2d9ea2742311dbe16a9d66c062822f92700a937b60f2215177e,flooder,126147,509,1034,1005,1514,1034
5023,0666d4bce3f303d100fdfed8e2a4b015598aa23d69c5b91854c25a27b5ae0425,flooder,126163,523,1013,1024,1547,1013
5024,066bebff9f180ae873a71148089f40e5db2ecc48058137526d901c2ab5efc793,flooder,126105,482,976,1023,1505,976
5025,069401bf02cc9e89f9e35627496177cb5024c9a8693dcbdee79fee0a3d9a67dc,flooder,117496,461,904,951,1412,904
5026,06948979932de825d6cf4463fbce2e395652f7512b091e60993b5d40f684039a,flooder,121596,460,949,912,1372,949
5027,06d3ecbb2ee9de8ba37f8c45f7ba3ada9b506a678ef73803773c119e33dc2e0a,flooder,126080,489,1004,1011,1500,1004
5028,06f5bf5453933f82389f39f101e7a9f3016d0e610f9fc2a2e6d200e6c77ed5e3,flooder,130988,488,1049,1003,1491,1049
5029,0707d6dfb0c15f98981ae7400771895ca6682673e7a7dae42cc2eb9503299065,flooder,126118,505,1003,982,1487,1003
5030,071789b077803a2e7900c067f81e92ecb63e2cbdf06b1ed78ae3bc0d768cf172,flooder,126149,474,976,1017,1491,976
5031,07262e3ec3e4da4f502b6565d36954cf8392f697f8b1b781728d5634ed9d0ce9,flooder,126237,491,1004,1012,1503,1004
5032,07c70d9e5ba8f4341b1f0c4593bb857cd235997dc8a56145a6b93c5a24a57968,flooder,130965,511,1043,998,1509,1043
5033,08017c51602fc3dd0e6bf752aa994abe7548fc7e3953dd53e7cf06b6c3e3dc92,flooder,126648,473,989,1057,1530,989
5034,091cf55b58b674d5b281f91bf27887ec77ef768ee8a010704003c44ba7083062,flooder,64888,258,494,535,793,494
5035,091f570d8a9eb8895180ac526168788d4edfd317b7d4d78d401d82191d65ed6e,flooder,130945,511,1044,998,1509,1044
5036,0924d57e423b21c6790d285d97d410f0a08350bec6660e299ff69a546135605d,flooder,127461,516,946,1034,1550,946
5037,095d5b7ff69107df4f6964f2b339bbf29d40b0e91412cdd810317d75cbc2c421,flooder,125980,486,995,989,1475,995
5038,09e045dca6c0058cccd334f78a627cf686024bb471e49506ee5094412e95ba33,flooder,64848,258,527,523,781,527
5039,09f57691596af982554d364bff1edbfc1f2b16bc0ada30d5c2c4255c35fc7c5f,flooder,126160,500,1021,1006,1506,1021
5040,0a10129e8915aa443cf381ebed9039e60e13ac3171eb52a4af795bdfeba151dc,flooder,64850,267,505,529,796,505
5041,0a68eb9f2a76ee3c5aabecc48862d76ebfd3cf0e9bd41c0182bcedda9b8bcb45,flooder,64851,257,514,530,787,514
5042,0a7b4311caf2ca082d54e3d41af38b563f4a74c0ab8e05935aac5adebe290080,flooder,126280,467,983,1046,1513,983
5043,0aa6ab57726dbc61bbae8305556de7eb75e732ad505446c757ad11cd7e0f6647,flooder,126169,509,1027,1015,1524,1027
5044,0c0eb9ccb1eb0e94c18b86d8aa2d6934c732574eb9ac7c408646954696d254e3,flooder,126059,531,940,1002,1533,940
5045,0c1d966b23983c50161f64b465262c7e0c89412c1278adaf329fda29969b7e4c,flooder,126058,481,1002,994,1475,1002
5046,0c2e5eca19ec4f82c220f61a31309b35e923c6858e2cea2e66257eed11ccfee8,flooder,126275,465,996,1046,1511,996
5047,0cd158635e42035fdde25de592c1091d1eaf4904efc6e6c6d1013f85e9ec0195,flooder,126128,506,998,1016,1522,998
5048,0ce294aa71ee98ba2a5033a9cb54f4756183c8d84f79e200f489ddbc3b129821,flooder,126101,488,963,1002,1490,963
5049,0ce89d8aad565d6a7ec76417b0503b822e54495bfc8511ed81c4e2e503a41f83,flooder,126229,508,979,1004,1512,979
5050,0cf5c7768b6e4c486d001f8a609741ff07b84f2fdd180477adbf884f6dd68390,flooder,126054,527,924,1004,1531,924
5051,0d9d0d48df8848e70cadd76ff7ceffddfafc3ebdf213559f3c65d0ada42a0930,flooder,126273,490,1012,1009,1499,1012
5052,0e000e1fb3b75915e0d35d6bea174143e9f4040d77e7948ba66e00c2dcbf9b21,flooder,64933,254,520,523,777,520
5053,0e394683309a8f49e0cc4ea72e3751a8e8967222198056781bbc47c4db764ac9,flooder,126035,499,1025,1009,1508,1025
5054,0e99028ce9c98f93d07ba6c9aa07bd59158b23b2fae5053a34b6b14cfd2743cb,flooder,131047,488,1049,1002,1490,1049
5055,0f6cdcf84b538a640457b6298b8ce6d17e9f9e93118df3979105abe6fdcff705,flooder,130980,488,1049,1003,1491,1049
5056,0f94efe8015059ec528550ceb7d94e5a3fd9ee284f8c2bd355e9dea0c8cffa6b,flooder,126213,502,958,1004,1506,958
5057,1000ae2768d68c0b1ac7d6ed07e75f932cf249d9308555779d87e56fe41e2756,flooder,126209,507,974,1007,1514,974
5058,10a4398737b1200365c6b6e359fc07636efa05af9486a59e9b82f8c070424744,flooder,126190,513,959,997,1510,959
5059,10c15a9580dd5acbb8a3d2cb0018a1e126712b9bb3396b43f1c88a1f89115ca2,flooder,126256,490,1009,994,1484,1009
5060,10d98d6b32617ebe068aed2a4834281366fb594274bfb6e5b118182195ce92b5,flooder,130984,488,1049,1002,1490,1049
5061,1103b2f0fdbd6ddddb73bb1a21f5fe702003ade983d803b52db7a899c4bd4614,flooder,127452,530,976,1006,1536,976
5062,11ae508b176047d3a3730c2bbe6ad8625aadb19e2cd8983e404de8df03aa1241,flooder,130972,488,1049,1002,1490,1049
5063,11e89423146757977d3a3688a84d5c66d6d3f8730066ee297074d307fa749b7d,flooder,126207,499,1012,1012,1511,1012
5064,1219e56ac62fc91d6acdd80bbc004ef6eae94d21b59f9e90c4599bc2e04d4818,flooder,126172,512,1013,1023,1535,1013
5065,122835db7c4a26d2215478e19bc4b0b81b6f0baffa38795592ebfb06bc2d0d06,flooder,126181,519,948,996,1515,948
5066,1255c067f11bceb343ddc6f42702bf89d3d64151ca75d2ecaca96a53d18585a8,flooder,126035,500,1025,1009,1509,1025
5067,12df45cd56aca611f8c88759626beb742159ddfa8d04b42ad6a133058358dd31,flooder,64852,258,520,530,788,520
5068,12eab142afcff8e399394f37a43b932dfd7d7499b52c5dc201d4987d5dafc7c2,flooder,126207,471,998,1050,1521,998
5069,135fcc8b1f9797c46e67d27c089989add2ec63e88d8265872bd028d52022ebc5,flooder,126211,489,1010,989,1478,1010
5070,136ea1cf60297dee12936762b3b3aa99a8d56a3bd71ee46f150f8315f6c64e92,flooder,130972,488,1049,1002,1490,1049
5071,136f0cf40c725ee8b3a053f695cac8b3e51f1153c0890a22aa7e7fbdb3352151,flooder,126247,485,1019,995,1480,1019
5072,13aec3af33959143caf03f553b5bfa40d8f4d50affaa140333f965b35722da26,flooder,126194,507,959,1012,1519,959
5073,13bc8ff209cceb1452cc4a19819d08d04eb823f4bea5d0774456a86a79c56e11,flooder,130961,511,1043,998,1509,1043
5074,14010f05226a3175ae31fadef38a6ceed7e88475c69f1311cf6bab6a17953e3d,flooder,130949,511,1043,998,1509,1043
5075,14503c71668f0c5c9fad1c7ea63b09f0cafc55c0c0e034bdb98c34465db22e3e,flooder,126235,485,1019,995,1480,1019
5076,14519d3666422e2dc955db353d9bd8b0bc3a3f8d6103b733a9d8a3e584cd0df0,flooder,126279,467,983,1045,1512,983
5077,14cd4c8d733a2e13e3f0fcc3c1d78ab0f69358570138ad5b520ea29c23799aeb,flooder,133822,502,1046,1100,1602,1046
5078,14e76e48b943af476534df3dcf0126fb173fa9efac1d5d33f0c86fd3a90db364,flooder,127450,529,960,1017,1546,960
5079,14faca2bbe4a0067c9252ec298bb996b3bd350787b14cc61fda723b2c988f9d6,flooder,130972,489,1049,1002,1491,1049
5080,153a1d2ae99c65210390b95da30c6ba43444798eaf3a0c8a8e69ea3f2c24bb89,flooder,131071,488,1049,1003,1491,1049
5081,1541de8114c631f2dae53b0d27947bf635931c4d320f511d36170bd89b7d523c,flooder,126022,508,1004,1005,1513,1004
5082,1557fd658207b3a5fc645a19d29d95d19e133bf70c6e88ec65fc855a0b3b0e43,flooder,126083,491,1017,1022,1513,1017
5083,15ab39864603f5ec754a14788e640bddd939b187ecba5718ce1b29e35ffe94aa,flooder,64915,253,491,546,799,491
5084,15e35c0ab761e4ff7dfc669aa49da20a89c84444dc1f76adbcab1e8c48ae8394,flooder,64867,251,499,534,785,499
5085,15e916fe0833ba05b0d3ea155e1a1acdc4e7d3cd35986c31028e0086b44c0eb2,flooder,126683,472,1007,1038,1510,1007
5086,16074847912b8381c66dd5b931a1a004cd2465b16e3595d7bbffd6ceb9b79ce3,flooder,130953,510,1043,997,1507,1043
5087,165be3d7208ab679d6dd709ee2f109343be549e4d1df4466ef9c11472f81b655,flooder,126128,506,999,1016,1522,999
5088,16e3bee3ff4818c4a65c904af5be97627fadf0a2c8dfff9668f8dd097cb65d77,flooder,121616,444,940,909,1353,940
5089,16f446cdac15c579d59f00dfdc8a05c1dfeab53e8ebab0acfd52172738fe710c,flooder,126638,467,1001,1036,1503,1001
5090,173b3137bf774edf6568840c90a14e4335ba1e42c754cce080edc7b7687b766c,flooder,138003,524,1050,1132,1656,1050
5091,1748c5744612eac947ca8bddb669dfe93aa335d0d3bcb6c2d527c2b2b3efd0b0,flooder,130965,512,1043,998,1510,1043
5092,17db8e309e3ccc5257d3d0fab01e13a3cd26d8e3d704e0ecbd90035dafab2278,flooder,126053,527,923,1003,1530,923
5093,184a99454325bfa0449de376ec4fb1c9812a62170e78a57fa98c19f8b8635cbb,flooder,126269,490,1003,1005,1495,1003
5094,186797603123665431c21e96cbad9682fb7f757f0a39d5e6eba9e3566cd860a8,flooder,126287,498,1023,1010,1508,1023
5095,18fd80907d39a9f9656dd66f15f70de9620ed6dde9f06dca051433f4124d5a2d,flooder,126138,493,994,1001,1494,994
5096,196617f93f4e7bce36f33f9a4ee55ce06479514f586aef3621c9a42d4269777a,flooder,126638,471,975,1038,1509,975
5097,196a1f865242eeec19ba57c6a696f60211f4eceea65739c0b5dcd720ff66b355,flooder,126653,480,997,1050,1530,997
5098,1a09015e8f409ce7330aeaacf6ec7cd63f9ee39081ec028860edfd720e3b30a1,flooder,126030,494,999,999,1493,999
5099,1b1630a966aaf829b1308a4bdb22f23721eda9738b1dd164cb55e753c4445007,flooder,126049,497,1012,986,1483,1012
5100,1b25075ff09c134dd60e62d09614334d3df04f9641c91b803eaabbfa38d78885,flooder,126043,482,979,990,1472,979
5101,1b257ea56ba84d1a4bb76f433680f6da25616bdaa9fe51746375efcc33874eae,flooder,130965,511,1043,998,1509,1043
5102,1b25de0fe64db6b54ee25ebfe4618321a372a030d0d5adf3a4551ef2f84101f4,flooder,126012,487,999,995,1482,999
5103,1b49ac19d483ee1e6fc76db5859544d8a5204998abd5b32496c675f19b46ccff,flooder,7161,21,72,56,77,72
5104,1b4faccbc8528d337c012715db1369abdeebb5b2963fc4f69c115159e5c63e09,flooder,126638,475,981,1046,1521,981
5105,1b5b2cbe0e52ec00a16140c3d717a3acb2c146ed5cbf93433c81dc531c1a3d1c,flooder,130949,510,1043,997,1507,1043
5106,1b9028366d1f7c98606f28db87148aedb727aa2cad44194bba8406ad8631dcd8,flooder,126141,485,1001,991,1476,1001
5107,1b9bbb0630753089aa6a331fbd5cc49e3c5e419be7880cfb638331ae91b6e93c,flooder,64896,253,518,524,777,518
5108,1ba15e542985c158f42425a8b6712cd0b60c145aa8583603e38cc42204a821b5,flooder,126034,508,1021,1003,1511,1021
5109,1c74f5b4689f4cc0d299b8f2a828b3c69830b4390bc16ba95df63db2f984433f,flooder,64853,258,504,539,797,504
5110,1c7890a4746473d763ca86a1932a38d9e398f164f3f9c64a2de2b2aba1740dec,flooder,126174,509,955,992,1501,955
5111,1ca05adbc4fef38ab11602b22d0bddc72b7a6f0713ad63a22d89361f871c207e,flooder,126094,484,962,1010,1494,962
5112,1d058dd1056e3a968c4a40ed99bde60921b9ecad0a136834bab151cacf3c3511,flooder,127512,514,953,1052,1566,953
5113,1d1121f0f95be2fa32cba708b113977c8855edca88b50aeff6773414b29575df,flooder,126055,531,940,1003,1534,940
5114,1d1f8cf1a6c39c90f2858fc882ea746bf9a88dc2df69e8ffc698e150007a8af3,flooder,126094,481,964,1023,1504,964
5115,1d9264a24f160a295126c03c1e9d3af03a1554eb462d4ea9f2e0761174d18633,flooder,125977,497,1007,967,1464,1007
5116,1df221b3d0141591ee926015ef22036e18b51887707c92c7046c864c5827920a,flooder,73330,303,580,559,862,580
5117,1e83b69d04a5feb4693fbb3ad3ce7b8b500b5d18f97031227eef964f58b61e0c,flooder,126113,504,946,1009,1513,946
5118,1f08903a3aa930e631a5896622ce1ffcf293f96e93a1b09350b2565765ced0bc,flooder,117496,461,904,951,1412,904
5119,1f36609ce9c9a074e2e368c5a13d54a93407845b557a0840ea06245d51d7e319,flooder,130157,502,1070,1016,1518,1070
5120,1f590bc3a3bc057e98a9d079d35ad0a931b32c6e4bc90a5992c5e5660322e638,flooder,131067,488,1049,1003,1491,1049
5121,1f874e6cfedfdae4a5afa3cedf922a80ad36b07a36b2436bc4e33930785948d5,flooder,126299,469,983,1045,1514,983
5122,1f912b67b299c202945d7107a755a4ee168cce126aae0a59a744f0ef808dc8b4,flooder,126652,465,1007,1030,1495,1007
5123,1fe3bf07f15a4c1ea1062edb440c6d0e7e65bbd0962bdee33fd9eb4478eab7a9,flooder,126063,484,1009,1010,1494,1009
5124,2015cb6a3df965f32ea0da237dbbdcc20e610b39ffb8fc82eff5bb433e602628,flooder,126239,480,972,1059,1539,972
5125,203e6677fc6b0fe06f8d859368e17ab2db82678e502f4e775df41e372fa35c96,flooder,126141,504,1004,996,1500,1004
5126,2054217a75ac6ff99b14f7a7f31e6a2dd8abad6e9d69780b70a5fe55b4d59cf8,flooder,126245,494,1016,985,1479,1016
5127,20c9149e9de512224d97a5f1f830bf2efa1efac4624ea0b4a296509f93178ff5,flooder,126009,515,1000,1019,1534,1000
5128,20e3919631e7c5843a8833b90e5b99a09e966d3efff3df1d06f71d0185252c23,flooder,126637,480,997,1050,1530,997
5129,2299bb7136662483ca634ea8886862145f982c080fe3d0a4ee888125703bd744,flooder,126097,480,981,1008,1488,981
5130,22c182fd063ee349b99296fb278bf423bedc87a53eb3841408d048aed27be940,flooder,64878,254,525,515,769,525
5131,22fc15bf1ce308ded5cbe921974cd4deb8929e2fb0b42d5fe8a0f96b303b468b,flooder,117508,462,886,961,1423,886
5132,233648a8a6b52eebf1fd454365fd5c67b0fe870b2791eb0fe2cfd8d9ad504021,flooder,126081,497,1013,1018,1515,1013
5133,233e3904f2e1a48b1eb28fe0271b5dfaf566a3ec88a5ba94943dfcf610a5839c,flooder,126663,472,996,1047,1519,996
5134,239b1ae4fa716552df87b2e7886c91d0a781fb12fec6a46fa8ac8b6b0a132e91,flooder,127500,517,947,1035,1552,947
5135,23b0110dc12edfd23b9ecfaa59582834d65b031a5b50a5e8facafd5744a6d305,flooder,126031,498,1018,1019,1517,1018
5136,23c616daa4574366042eceadec01e2de544325b630ae39cce278e1d36d52d29c,flooder,126053,497,1028,998,1495,1028
5137,23c6b63a979188b09220060c670e941ade115cf2a583718c2bd3cf131d1a089e,flooder,126047,508,1011,1006,1514,1011
5138,24253f5d98507ef3bd7de96ac277e9a06035dc37b38f17edb521bb7830441ebd,flooder,117490,462,884,962,1424,884
5139,242643507a24a78a13464ca681f8789f9021902b8e50bb6b20be7026761c0f03,flooder,126172,518,1013,1041,1559,1013
5140,242f1410bd72c5db86dfa8aedee26cdbcbd24e7a5000fb3e369aef10fbcc1069,flooder,130984,488,1049,1003,1491,1049
5141,24342971cd28c8bda715df17cc6c66c2e8922460f9525601deddf93a14dd6494,flooder,126024,497,989,1008,1505,989
5142,24ae5821078a756de73546bde04664152b1d37b52a0bb476ad97175c9d9dc65a,flooder,64893,238,515,539,777,515
5143,25244dda0e2b916afd6a16884d3d6064811fb383110181319e310348cc420e85,flooder,126087,479,969,1025,1504,969
5144,25387f1a34d03922927f8c8c6f6ba125bc6daa76f18d8d3a4f6aae9d400d1d97,flooder,126285,499,1017,991,1490,1017
5145,2548c37c8faffb2e0cd513b2b9e4a3f93ea35ee6fbae8a3a1a34f51553b41c0e,flooder,64875,258,527,523,781,527
5146,255c1c2bc519a9bf5b16165d578db00999259e99619669cc3bd3fd3642cb1366,flooder,73293,299,584,556,855,584
5147,25bba88c5a0836ddb39de399f04bb81d74618f85249a1cbacd014e7170f875b7,flooder,126638,471,975,1038,1509,975
5148,265107987e48616cf1823724edb8b6f0825746be6c929e2990dcb4e2b5000564,flooder,126217,498,960,1002,1500,960
5149,265382e4e8464fefff4848c20822492a8643e980c67ec1de5cf099f61f3d6e25,flooder,126692,475,994,1064,1539,994
5150,26612604d4d2fabfd93a6ad4568937ccd875d352a2aa956898d6c974de88300f,flooder,130941,510,1043,997,1507,1043
5151,2689483e39a97746fbfc1331fa24d64f8b5d6d21518c46a3019dbcd452c9d76b,flooder,126247,481,1005,999,1480,1005
5152,26ce6e019bae27f0c02d601c73c239608c07a6e2d2d1ff20f5b59cbedd12cd72,flooder,126047,518,1034,1013,1531,1034
5153,26e4a93ee17c7d28c27934a1b783d8ccbe4126c4eb3a16fbfb55ba3fb12dad4e,flooder,126040,501,1009,1014,1515,1009
5154,275333c0df87cfb377bcd74d0193a45e25aec9e1ee42ffbf1598c7a1028127b6,flooder,126269,539,940,1009,1548,940
5155,2799f6db7f7a91f6aea75c08ffdeeaefd7841734891407c4c975441b552b0ff1,flooder,126063,500,1017,1014,1514,1017
5156,286586ea3f7f920d4bfb6c0d3c7828dae2a71c8298318452bf93a205d780f67c,flooder,126230,511,1007,1029,1540,1007
5157,289b9734a6a9ed24faa84551d70ebf4697253d132fdfa3c8cba996f82e0d3901,flooder,126035,479,980,1014,1493,980
5158,28ef3da02e68b872f7f05f5d7f7c77db4fe8432a70279c424e8ceaa108df936b,flooder,126028,509,1026,1015,1524,1026
5159,291478363ac7639b687c60e00793b01a509fff36262b9d8709c4d311368c866d,flooder,130968,488,1049,1002,1490,1049
5160,292131bae3e1a663c149783e2ebb7024dc29e7408a77ba02c52e7de6a0ecd44b,flooder,133835,502,1046,1100,1602,1046
5161,2968c0b790a5aa064824779deec1c9d3458cba0eb7634e26da42fb19d6424b17,flooder,73377,269,585,586,855,585
5162,29b94b946cfa930ac30b1aa63016486cb1835cfa465bcfee09c615f225c0c98b,flooder,64907,253,491,546,799,491
5163,29c2cac02541eaa589166e72194d93f3b9512124bb34425298f9ef50d5ea487f,flooder,126038,508,1021,1002,1510,1021
5164,29cab0196f6ef747c2f65748dad00093b3e10db3999b241c0c960c1f68747600,flooder,126233,493,1027,1009,1502,1027
5165,29d003212e17e650439742094bdb4d9a4f8e5b85d1f8d47c58cf7520c009f3af,flooder,64954,254,511,525,779,511
5166,2abb90fc329cf16908e9cde996dff9fb1df927b53f9aa0a9cbf4b2afe16aafab,flooder,64879,262,530,525,787,530
5167,2ac4ae5995423bf5497dab9bed23117a0687e3610d55d5d55a73bf5723f3f9e2,flooder,126105,502,1027,993,1495,1027
5168,2affa7b6e8dd2d80bd62f9b90f8d067ec91a24d5896d3d589f45c9021da8f5ff,flooder,127504,515,947,1035,1550,947
5169,2b25f41b5695d7a7a89b768782e827a3de4f5f7e76f37f3bbbcaa28bab404e45,flooder,126233,497,1007,1011,1508,1007
5170,2b39eaf4ee5f847b86fe3c2b1789008b2d59ffadea736765415e74bc09a3e264,flooder,126148,508,1011,1014,1522,1011
5171,2c771602fec3f598bb95f00256aab09929e518455a6b4eec6926982f78cc111b,flooder,130211,496,1067,1011,1507,1067
5172,2c83f4ed55e83ae74123a6d65afb91a96ecf82bb4d3196d6c429783a7298273e,flooder,126101,504,1025,1001,1505,1025
5173,2cb578beeaa96f80ddab24ce124b51fd5393bb82abe3d68d48de373a774806ea,flooder,126158,487,1021,1010,1497,1021
5174,2d302b15564d4a47384caedc7289906e9ca5f4e6a0d10f5edf862c4b65db1f35,flooder,130957,511,1043,997,1508,1043
5175,2d446148537ae2eaae80e3c854639ac62cdc922dcf1d59be20a5b27e8801052a,flooder,126159,519,1015,1024,1543,1015
5176,2dd0d4322a2a21b31501547d19f6d12a9cfa09025bbf1c54cc1e8f2b286cba8f,flooder,126175,526,1013,1047,1573,1013
5177,2de977e62be627fee8b3ebd4e7d76520b8a5eac4e969056679b1875bf625e26c,flooder,133831,502,1046,1100,1602,1046
5178,2e38f1b694e518c5279eb7155ce7b9f9f1c7a36ff3f851af215cbc7a7a266dd7,flooder,131116,482,1051,1011,1493,1051
5179,2e47aed0f446d577d4e15d88fd16aa7705b651c6198c82e2379b2c8e37956ec9,flooder,126222,515,974,1004,1519,974
5180,2e9994c520ed72b88b141e22e1525c9b2a64df56f05eb3e1af51cd6005f54bf1,flooder,126277,539,940,1009,1548,940
5181,2eca0b5b2234ff25a33597202020c51c2496dc6cc4479aee66a4b8dece871245,flooder,131567,528,1040,1079,1607,1040
5182,2edbd5cd3f89a2cf56ac53d7de45a589288d31116feedc04c21dd945994122c8,flooder,126674,463,994,1056,1519,994
5183,2f00e185d2226dcbb1ea14336c585ac500e8e5fdcc61b4a40e3dba47de456b6b,flooder,126184,518,1013,1041,1559,1013
5184,2f2d1d49855c92315f745b885f16a9c3daf2876508c053e03e3fbf58c1565323,flooder,130980,488,1049,1002,1490,1049
5185,2f8258307503b69b45e159dcfea714e9771caf23a8cfb480b045e7f44017c9f3,flooder,76047,298,624,651,949,624
5186,2f8822b8337d8a643ce7635c6f38b043cb25d5bdfb231a743050909a23fb81e8,flooder,130953,512,1043,998,1510,1043
5187,2ff6896fa3d6c3d31cb5360722be0dd5605bab55aa1beecbd1e8af6962448dbe,flooder,131035,489,1049,1002,1491,1049
5188,30c66c0ba670721aaab5b359d9e8cb322061dcb355dd3b7a0b2425ecc3850716,flooder,126243,485,1019,995,1480,1019
5189,30f79202f0795239b5659df270454be2c728c236567d2bc77802d5136c6d7176,flooder,126320,482,1000,1005,1487,1000
5190,311f6c60b0a8dc459f03bd001d93d0336186843395b2dec26cf9ece689527256,flooder,132997,502,1048,1108,1610,1048
5191,31b751f20f339b262d796f7d794c0c8895ba644660fe330d83d157482e7f43d7,flooder,132011,554,1084,1072,1626,1084
5192,31cd8882f7bcebf2e6db593b6e230c2af8033a7acf63702fa87ef82bd62a20f6,flooder,64851,258,504,538,796,504
5193,3205d6924f4957e6e5fb57861af4f846334f0c304853c78ad826d1d0e439e516,flooder,126004,484,1003,1002,1486,1003
5194,32b53bb37e08ccabf769f3a77c366f7d87f7e9ddded246d97228786cb14ee18b,flooder,11522,45,82,96,141,82
5195,331e98a41f5c31dcaa394d830ac62e91452e1effda01b62174b19e7b03d90c64,flooder,127500,517,947,1035,1552,947
5196,335cf2c74d4747135c125d03ca1d7fe8e0261d0375ebf0544d9fa8ffb11e9745,flooder,64887,243,490,523,766,490
5197,335d442e7816c268803b6806f6bc038582f508458f2ebdcb389fe5aa242c67b6,flooder,131051,489,1049,1002,1491,1049
5198,33c3841286bd105b11ae99831ca6c5bbcc2c4085caaa1ba5eada4036664d1042,flooder,126095,509,1021,1016,1525,1021
5199,340737298c4d8bd6dd27409a47b880d8ed0508184ac204e11df375548a887576,flooder,64886,261,495,537,798,495
5200,340d6ef0c2d26855b51dd1c479730b29430d3b1bfc8e134aabf8a944c5842690,flooder,126171,527,999,1051,1578,999
5201,342492a2c86563bc02ca00993f09e9fbe348d6b2ef72926f2f25636548f2ab78,flooder,126214,519,956,993,1512,956
5202,3566c233560cc456e1f5b6012d05b7a0959f0fd185ff964ee3f45ef0f63086b2,flooder,130211,513,1057,1012,1525,1057
5203,360e9d7f9874c4297affa9773d828c16c1340866cfcb6a09513d39589dbfcc1f,flooder,121582,471,953,927,1398,953
5204,361eafad2dbdf0169f54814a4c660be4007cbf6ab179c009367a9134deaf3fea,flooder,64838,247,488,511,758,488
5205,363fc3b4d33e1ea1582088a6d3ec5f4e445e5317de73ad4e0bbbeecc409efaee,flooder,126048,542,936,1003,1545,936
5206,3695402ba5cbc0c5d76863261c5a81267db7cc60bdabc1615ef6986c0a9c05fc,flooder,64879,251,500,534,785,500
5207,36b852e98b7f4b2e27de45a3e127a75da8acaac21866a4d305ea356c0b54a40f,flooder,131103,488,1050,1003,1491,1050
5208,36b9d003f854fbba603af15cf907416ba3e19651efeaeee9142fae2d402bfa1d,flooder,64891,265,519,541,806,519
5209,3709315d8ff322ef5db462dc44a5467fd48f821e1e41d5376c7c0d31e93c297c,flooder,126101,504,946,1008,1512,946
5210,377eb09fb14b51f1ff1cc097526b83e365cd90816f183eb2d7647a6ce06881a7,flooder,126141,529,1020,1037,1566,1020
5211,37bded4a5dafc7034d040e95447818da1058e73938f282e4bbd1134edd29f602,flooder,126639,466,1006,1030,1496,1006
5212,3860dea9759d1ab68801d83a9f16bbaafdda71a0455fe9261fe555f4acb07caf,flooder,126039,518,1034,1013,1531,1034
5213,38f87f6f79b38799d2f0aab852b9b929c6e4dfcddb51523d3e46730c88c46d38,flooder,126648,465,1007,1031,1496,1007
5214,3905777a11190ddc312fef951cefa3413e458b757589d610dcb4a22587a0f13b,flooder,126035,506,1000,1012,1518,1000
5215,39a8c1a25fa27d121735c914120d37f87c8f5ec10c3e2cc954b8b353bc8c4bc2,flooder,126102,488,967,1011,1499,967
5216,39c29925054f713735802bd72002590bc46ef6abe1d7ac5b247091c1ea13142c,flooder,126059,504,1015,990,1494,1015
5217,3a3fe17e9e251294b2416393ad391ab6dde03991b6949c369f296174dad13040,flooder,130980,488,1049,1003,1491,1049
5218,3a64d2585973d176827699b672931036a1e11714babef8408dc8ca6ef15147f8,flooder,126015,494,998,1000,1494,998
5219,3ab2d32f824b1b3129bcc3213c93b32e5138ab5170b29b0d20354c8406dd7636,flooder,126221,494,994,996,1490,994
5220,3ac78e2d6fef262aa4c70b2f62c7a472aeecea6f321f1c6364b0151109bbcf88,flooder,126223,482,1000,1006,1488,1000
5221,3b2624a59232aa49f5866f9019dadbe17620045f6faf177f30a9544650a771c2,flooder,126163,514,1004,1046,1560,1004
5222,3b9cec70ef54a8b86d97867a9565bd99812595519e5d09d8ddf89ceee77ca9c0,flooder,130984,489,1049,1002,1491,1049
5223,3bd9f815bcf2ef30fc88f766371ee659fe60abc9dfa72a935cc7e82039380fd4,flooder,126086,484,1004,996,1480,1004
5224,3c417e665f5b576f3a88ee88cbc54283eb528318a4d0194f75a80bf2f5e3b8d4,flooder,131039,488,1050,1002,1490,1050
5225,3c586b332ff9c1b69135c9ea09f1117d6d2e78782936f68d73aa316331fbe6d7,flooder,118276,499,966,958,1457,966
5226,3d2e6948710f513074f1f3151df2b4dffc80fc1463353db723cca7f353d29d69,flooder,130965,512,1043,999,1511,1043
5227,3d5ca76b040eea875c6fb80a5fbfb820bf7d646add78db7778a5085e70dcf725,flooder,117494,462,884,962,1424,884
5228,3d85451ce935d9caef9d7914555ff420e9099eca0679afd91eb0a6e21bff0036,flooder,131067,489,1049,1002,1491,1049
5229,3dbd8b9f9f7b35f375f6b59bdc35db76b151122a00a7c74b95580e4b50f8662b,flooder,126297,489,1009,1015,1504,1009
5230,3df1834b9a1bf35a58f156aa5c12d192eb79d70959fc4e875ecc403c929fc8b7,flooder,126078,531,934,1008,1539,934
5231,3edb70c8332f3c14636e1d973271d44bb425c6f6cb0e5f6f9618267801b24beb,flooder,14972,58,117,103,161,117
5232,3f07ce2d620ffd618120e1b7fb581714fb992ce342a5012e2ff0449df5a7a9df,flooder,126043,512,1019,995,1507,1019
5233,3f1e3bf90a4897c3a39673c25a2fa60047c9410b2ca82d0e21d55c96c902e5ca,flooder,131138,488,1051,1003,1491,1051
5234,3f461069d4b98da7783f878a4c3cc22695c0985d22a34a61e0b27a403fbc5a8e,flooder,126046,472,978,1030,1502,978
5235,3f9a4d35c26ec32619320fffbeb9d6b73cfbb0109467ac513558d66a6343cb8d,flooder,117488,472,880,957,1429,880
5236,3fae8a3305c27c5377ac32bbb61cdc2621756b76c8dea6db3ac4cbc66c815f13,flooder,126257,484,1009,1000,1484,1009
5237,3fc2399ec3323ac866d6958fed657d9ae6112aab3cba0147893b2077417fed64,flooder,126641,480,997,1049,1529,997
5238,3ffaf3a21fdcf18702f8b3bd503e11f6656b059aa8ff88113e11a6d4d20f9b54,flooder,126084,508,1022,1002,1510,1022
5239,40216c5b6f2d0a1ef4a1d589fff2bc0b707898d69ce19c642c04e02eddd99330,flooder,117496,474,876,892,1366,876
5240,40a181e70cb60921d58cd6ed93d07f105ab18640b08ec2e36cff50f8de7cc2b9,flooder,126300,488,1024,1006,1494,1024
5241,40edf1213718845ded597d8b0432ab2ad3667963164a06723a304eb02a4c412a,flooder,65221,263,531,518,781,531
5242,41130fa8488a790c1b7b66e074444da5de91e5ea36383ae9c36341016831e07c,flooder,126053,492,993,1002,1494,993
5243,413ad00b788fbff80a7682e1771dfaa07f7947bb7ec888a77763b425dc17669c,flooder,126285,499,1017,991,1490,1017
5244,41df0d619976724e73ac9d4aeea62044f0214139f7827fe32d68640cbedf36d7,flooder,64867,251,500,534,785,500
5245,41fe494e7d0060c3a4d45fc5117b6adb06f1b976be78ad7944a107b55718f1ef,flooder,126281,479,1018,998,1477,1018
5246,42877b94bb813bbd823c918a16953784a982dddf7c3cb949d9aef9cd73afed56,flooder,126277,490,1012,1005,1495,1012
5247,42a9dc9f33a30a22cce9f41fee56441aa899cd5df04c2ce0406192998f657beb,flooder,121589,464,943,910,1374,943
5248,42b1394ad79289788294c595f4e60c99fa3fd549a615689bd1b4e99fc5159366,flooder,138488,526,1053,1140,1666,1053
5249,42b9326e57d9b3ab5c1d6f4598c71bbc58e500fe6d296248cf82ad8a73f1f164,flooder,126123,504,1015,1010,1514,1015
5250,42edb26f1513af58ff884af29fd07f7ae881a8dc6d1bacf1edd005f950935af1,flooder,126207,493,1010,992,1485,1010
5251,43459e7e656d7c6325e6b48f4fc13a32aa66ae2b0ad93ead19df6c25599150f1,flooder,126644,465,992,1045,1510,992
5252,43b9b9d021aecdcb2724be72dab98c07ed9a7a467dc9237ec0303852654a66c2,flooder,126031,497,1004,999,1496,1004
5253,43d0ad8cd7ce8fc12cf799f7ad3315451d23dff5a5bcb619751e946732731f72,flooder,126052,480,1002,994,1474,1002
5254,43e2ee367e3bae8adfeeb1b85fa580c1a0b7f8182deca5a9ab41cd761f653caa,flooder,130988,488,1049,1003,1491,1049
5255,43ff451a9dac4ea3034d5127a39c3adefaad4d89b812dbfbe86c223900aaf1e3,flooder,126209,502,958,1004,1506,958
5256,44758faf188c09db93f6ae0a54f88538be8e200f0afa39c9269492fe6ae5d8d9,flooder,133817,498,1034,1085,1583,1034
5257,44a59ee6759bc0fc17a0e9718a0004bf3d37853282681e3496dd48bf2d1fce12,flooder,131083,488,1049,1003,1491,1049
5258,44d21a8a5489dd9a79a3d373ff708c70c1d5a9cf889878cdfae209699f11533d,flooder,130249,500,1053,1022,1522,1053
5259,452bb7863932b2f429d40e93ccf676806600956be479ab4e21a9732263b2f459,flooder,126176,518,1013,1041,1559,1013
5260,45d241430dab8459a3a17f9349f17d08919e4ed6c1bb56946166028dd06ce220,flooder,130952,511,1043,998,1509,1043
5261,45ee71a00b167d66120244670a0aa6e40c50a59478161e0e8d7da7d8f14da0a9,flooder,126206,502,967,1006,1508,967
5262,460582e1c26c3ce5696e1bce41a5b6491e2709c1fd9949f44b2fd42780ca8bb5,flooder,126211,489,1013,992,1481,1013
5263,4613e8e1979bac5dd1e38c4d3524800c07a7138582dfe2f87d7be22a8529d816,flooder,130980,488,1049,1003,1491,1049
5264,4682089c8c95fedd8d34c470867550146fabb5b95c53957aa43ea430713fd07f,flooder,126149,519,969,1001,1520,969
5265,46b4a1b7860a9e0f04fce28c70f17502dbbcf5323c1b2b12ed94d9ec5a0be4c0,flooder,64837,253,496,528,781,496
5266,46e24ad84e4e901a6020be4aa39605a55d8af4b90dd737e9b6e4db9c8e492544,flooder,64897,263,511,521,784,511
5267,470fd57f8315dab9703f677b6fdc02d9b67bb1dbb45ef3422262c3989245b367,flooder,130969,511,1043,999,1510,1043
5268,4710609fd49f3547596b858fca9ffa7dcf2b2533cf92e89274532ad4c71efd23,flooder,125987,496,1013,1001,1497,1013
5269,47653fe2fd30e5a0f3a86fa0a600e398e4a070b0229b05e3991d09abba67500c,flooder,131118,488,1051,1003,1491,1051
5270,47bdb7bb286429f74136aac60bdb4d2b0050a51db4daa0cd00f0a2c8a767a69e,flooder,75451,269,633,635,904,633
5271,47ca8d6e8d6b73121b9a69ac60783031457f8de67f92ac71f8677ca61f2ce7be,flooder,126060,537,934,1007,1544,934
5272,47d89305ab9a4e299efabe0fd5ec1ae6945474bb2e00126d03430683aef86c6a,flooder,126251,482,997,1002,1484,997
5273,47e2a2044992976a907d8ff2fd620f71404d4ba7358566fd5143287f1e31740d,flooder,126284,549,930,1016,1565,930
5274,483cca54d6366e38a8ea01f013e9ad1512acb42967fc10726b3695d3aa9c082b,flooder,130937,510,1043,998,1508,1043
5275,495b15427e90c1fa4a767dcf64f5720775c5f5fde4c056e3ac88a682075e1c24,flooder,130968,488,1049,1002,1490,1049
5276,496adeb3a85505c54c739cb4db31a29d0b1c2c057db2b8e4f4fff59e45f6aa29,flooder,126619,475,989,1049,1524,989
5277,4a85e5795e1ef3b3f044f60c752a16f0c17cc495391bb24d4cca15d214c83237,flooder,126646,462,970,1046,1508,970
5278,4a88c53ac87f68eb06444ff7919af161dcdc3e6f243ec30641332690e7a99b6f,flooder,131031,488,1049,1002,1490,1049
5279,4a99cfd80b985c5c36794523db8b94221bb1ebb31e49fe26c921b9a09466ba8c,flooder,126220,493,1010,993,1486,1010
5280,4aa1cd69916de2c45e3e693398f9ba152b863353eabbc5109db025f9cb448115,flooder,126160,512,1017,1002,1514,1017
5281,4aca22a7d2b117984db50eda02bcdeec802708592ecf71c218a91fc2f88219ed,flooder,131039,489,1049,1002,1491,1049
5282,4b2ecc6f3091a0b85bd2ad68326ef447c5c72015bfdad6f20c0fbe430bf72030,flooder,126049,492,993,1002,1494,993
5283,4b48f5b0b494c6bbe17c2edf1cc6072c13b209679d06a45f203fb51cc0634df0,flooder,127492,517,947,1035,1552,947
5284,4b6fb90be0f8802cff530d3904014e3fca5187cf6511fac4a4c46c332b8e47a7,flooder,126141,529,1018,1052,1581,1018
5285,4b71a64c40ff3ec3186a02897dc20aa7f12effb688652a0a0248adf45a9c3418,flooder,126273,479,1018,1001,1480,1018
5286,4be41e0f2d125372a995bd8401257dda0fa185a660f7ba35b6c3969d552429a0,flooder,130206,492,1059,1030,1522,1059
5287,4c79fcbf895ea03bad45d4f12f0292bfb1d4c870776921000b8d92d0197c95a7,flooder,126040,529,939,1007,1536,939
5288,4d0d3650e2c3b5c282790c99031cf0002e58e355bf971164af053f0bb088e5c0,flooder,126232,484,1010,995,1479,1010
5289,4d26969441c261981e744378da9f934292983110cda4918fd1a92447f4456b00,flooder,126078,502,1045,1001,1503,1045
5290,4d89037fe671c3f0cc5caa95b42507f3d10ec5cee4192bc8f76739200b1caa26,flooder,126383,476,1001,1042,1518,1001
5291,4db6270960a509dbf62fcb11bd6a3ec467766ca64eab526e3630a6d40b4ef791,flooder,133234,495,1035,1089,1584,1035
5292,4df07e7c0857b82552625bd1284688472d8e62d76dacd45be01b03434dce5b83,flooder,126142,493,994,1001,1494,994
5293,4dfb1be72b1bd4c01a406569b8ceefaefdfeb46ba56cc00166977d5201b1b6b7,flooder,126044,504,1002,1008,1512,1002
5294,4eaea7d81ec0980c3a30a8d0433b48844c6e415f9defb3827c46f79fb0872183,flooder,128889,494,994,1056,1550,994
5295,4eb32f8ec36da5d3fb7f8dca81039e337902fc12961f958e88e678d3cd3540ee,flooder,126078,481,964,1023,1504,964
5296,4ee6b8d019f047363276d700a5859548b31d6569168a9b87a50b48eb8a642498,flooder,126108,493,1006,1000,1493,1006
5297,4f0e643434aa996024ee8ed5e7bc5648523d23a970cf4bbb4bfd9cfcbade49c1,flooder,126183,514,1025,1020,1534,1025
5298,4f24ee87a1d3322c06ec68814acb2a9369bcd44423a6c34fcf1fdc4335f67a04,flooder,126262,539,940,1009,1548,940
5299,4f292801e2c37195d8629d0285227baa3daa3e5693e414cecff0c0d4efd77557,flooder,127506,507,939,1029,1536,939
5300,4f342f100d4be11451ad10179f7c1fd9c522f859671176f3376e721ee22e4e00,flooder,64884,258,528,523,781,528
5301,4f445a33099fd9d11cbaa690f3ddf6585064d45d41c48d92071263f8eab5c331,flooder,126208,472,987,1048,1520,987
5302,4f591c2bd2356e53cf310d2b72dea1edf5f22d85c6642bba34c5ce3ab94f6fa1,flooder,11358,59,100,85,144,100
5303,4f786048098f3cb168efe9cacddb02b1af53007a5366619c0f3997986b1778e2,flooder,121612,443,940,909,1352,940
5304,4f92dcc1209f42cd3f6c984b4359d32808578b2d882999ee9376edc09ab8d2b7,flooder,126123,506,1029,1005,1511,1029
5305,4fc0ee0c443670aaafb47c4bfcb4430d756ce1c4e52eb3bb7759e35ccb942267,flooder,126242,487,1006,997,1484,1006
5306,4ff752a3887f053aeed6f0fcf666dfd9d9d2907b2072e40bd75d78cb74aa2f78,flooder,133822,502,1046,1100,1602,1046
5307,5038c4fe8004207ac2b519cabe12679f415aa234ca63727016bb7fcce9f764fe,flooder,64857,238,498,525,763,498
5308,504322ab31bd2e1183a2afc7f55ec21b46762cb16d3d2387392f9b669428af29,flooder,126642,474,982,1032,1506,982
5309,50a39f3e2ac300c7605c52cd30bf57f505859b0e24861fced29d5fe0abc3c960,flooder,126147,466,1001,1035,1501,1001
5310,50f206ad4c3d535cf2ba651dc6759aea1a63f86074b98f483e44634428d28800,flooder,130976,488,1049,1002,1490,1049
5311,5100db3c0ce305270dd2418f0b125df048b2086c9da49b6bf76bcfe9b7616491,flooder,125963,500,1003,1018,1518,1003
5312,519a47c9018bc4d0dcee5d24b4c3eb01f83b5b6541e93465fd113e5d9e7dc6be,flooder,64916,249,520,528,777,520
5313,51a83e0f8158b8c193b6205e51c17fc6a0b1b1ccde95a97cd55481352e65c6f1,flooder,126026,484,1003,1003,1487,1003
5314,521cc64b6fa2bb659c08bae5b251f96f92909fd3bb263d12f436742121e6da73,flooder,126073,511,1012,1004,1515,1012
5315,524170abe41ba9779b27a36bc9ed9e248623aec50620b66b689d31bcad61e875,flooder,126223,489,1010,1018,1507,1010
5316,527e0f4661d021d3a4bfc79122a3aa00b150509e62e590c5e5377d634085a12a,flooder,126896,469,994,1051,1520,994
5317,5287592a7d1182a05acddfb7369f9621ea88290b759a7bc3759b832c13fc0b08,flooder,126218,512,945,1010,1522,945
5318,52d84dc2bfe2843a5c352c9c15e48b6abd1b85beea4ebe5be0ea96b1bee3293d,flooder,64931,253,525,522,775,525
5319,530622a38b8121c4512ac807fc344fa5dd118638a6c38843c0cea348d169cc29,flooder,64856,239,498,525,764,498
5320,5322feac108bcebbc73f9de1b76e16e17a325227d9c1d22e8b5811c17cab78c4,flooder,64935,253,524,522,775,524
5321,5324d41927a268738574b2c041823ea1d3a124503632a27b5a06abf341a86816,flooder,126226,494,1025,996,1490,1025
5322,538154bfb80910455832ff176615903bc49bb669a2ebf7cf6ce9f95d1dfe3927,flooder,122811,495,975,1012,1507,975
5323,53e66b4d369352b70877432127beec7c5404767aaf58f08332794d0c4aa64ab3,flooder,126050,483,977,1006,1489,977
5324,53e6cecbec779539b8e2b54c9b96fb290bd3452e91b62d11864396ef3696e847,flooder,126232,492,1007,1018,1510,1007
5325,541f8a78c5eae64f7a7b70a9d223972c1807ccaf08ccafbdb754b6a4493467d2,flooder,64955,254,511,525,779,511
5326,542887f52ddc8b030aa89b013836d16669f5c8e75670d0a9c2fa8400a74128f0,flooder,126217,495,963,1006,1501,963
5327,543c1f2e7a3b1522e6c95e9afed25167247f68c6df9b4f97624a2b0273828b3a,flooder,126051,500,1045,1001,1501,1045
5328,549afefdb52f215ef0337644764b62f0040098f41ae526eadbac55d2587f0d14,flooder,126259,498,1005,1006,1504,1005
5329,54b208a4b90f31ac97bb536070c21a4c5935548b2f79d9673a55780fdab3bcc6,flooder,126638,465,1006,1030,1495,1006
5330,551ed6f82c6bdff02a443518d5c892a547488a1723d58a6ff26b13dfed4e4a38,flooder,133855,502,1046,1101,1603,1046
5331,552bebbd8e93955e478b24e18a3a8555d43878a0c5be517171faa5387475bab5,flooder,126035,518,1034,1013,1531,1034
5332,55cf88ec9f741eea436c6d88d7da9de21c49a50691c8b44d13f582f6d46436d6,flooder,133830,502,1046,1100,1602,1046
5333,55e298ada85320ca2331ff6b51d16a55b1a13b8a6082820e81ab88bd1f808095,flooder,126180,514,1007,1013,1527,1007
5334,55f99654a3d14ee1d42ba236f92d0ad4cb787412b6f014981c69f218ed3df517,flooder,130941,510,1043,997,1507,1043
5335,5609f6f72aaffcb59c4c6257272c97c741622a103dea91e62782cb046fc5acb2,flooder,130980,488,1049,1003,1491,1049
5336,56205a552636c8af2371bb78ecbf6353ac8da965ee84d54436882e918f917c98,flooder,126089,489,997,1006,1495,997
5337,56ae51f45a5e1bac1c02218487354ebbea88321e008ad3975980006f31ba7756,flooder,125972,488,1010,991,1479,1010
5338,5773873e8ba9c0b221f8f598ec5b750931144a63ff3be0f9da9c984abf8531ca,flooder,126273,536,939,977,1513,939
5339,577f98f921a012cb3e1fc7058cfb3101bf6ac9d9883e3464c46345b1df6ec9fc,flooder,64840,252,493,534,786,493
5340,57a54479abb2daa9e516dec4e8a6d59d13e946c6f7c71643fbfd1d1900950baa,flooder,126201,515,961,1011,1526,961
5341,57d65adfdc2b9dc3e78e46d8ba59c0d0ed995cfdcee918dc6209214f0df75d02,flooder,126277,474,1001,1038,1512,1001
5342,57d9c2e54c1dbe9d85cd13059ad96447ef12813e1689053ac04bfa02a36c3273,flooder,64891,258,510,518,776,510
5343,58e3e216e03c3c67dd4b54ae8559ad12ca2bb256254a24181a43aed725f8795a,flooder,126158,504,963,997,1501,963
5344,58e40e46828a6f8a961a78ecfbb54469f82e45fceae95167fc31babec1baaf3b,flooder,126163,529,1018,1052,1581,1018
5345,594fde295d75515b430b84660503a57f0607e3228fb5a2d485b9700c82cbb8b0,flooder,126123,512,1011,1015,1527,1011
5346,5a014182f51b960e3e28a6ce89f94892fc71f7e2742031a6e32aab4f8de5cbda,flooder,126644,466,996,1068,1534,996
5347,5a0262fd597dfee2bac207830d07f37846ae100e0489799cfdd064da475ac676,flooder,75443,269,633,635,904,633
5348,5a2662d1d622e326b7c9aa2bebfaa0cdda5abf2697fda319dc5e141c07a437a5,flooder,126044,505,1036,1012,1517,1036
5349,5a3e7796cbdd73bedcf2b851004462d3331833a7f09689b67b2f82ab0eb368b9,flooder,126160,519,960,1015,1534,960
5350,5a451804440bbe0498b778cd6372f3ee347dbdff734ebfeeb603a264c7c76a3b,flooder,126187,532,1012,1049,1581,1012
5351,5a5bc60db8110adc0b1af64be221875eddcc771ead328face5b7f7d9ade4966f,flooder,126058,490,1013,1001,1491,1013
5352,5a62a0ae907d3615ab3558cdfc6fe0dd91a04a1e83365f66c28ce2c7566dd110,flooder,126074,532,934,1008,1540,934
5353,5ad4a05fe9daf3a34e16ed5cb20f09733d535ccd8ceb614d44b24bd91ce45799,flooder,126043,500,1025,1010,1510,1025
5354,5b7af9e47b4859ebecfa8da87598bc0dc1371c88c250d364f0658c125193a538,flooder,133818,502,1046,1100,1602,1046
5355,5bacef7cbd4e7e0c8510806fd4e2e13a1a955afe30fd2d16e82667ee21524840,flooder,126082,481,964,1023,1504,964
5356,5bce6132a9173e8da7a0718bfffa30ee4d6574a0298155189e2a6d928b0e7bac,flooder,130287,503,1051,1032,1535,1051
5357,5bdf1236dfb13767ab0ac3356a3db057758b42f3dcb9590a930f9df078a75bf8,flooder,126048,515,958,988,1503,958
5358,5c0226be75fb95473b5a409efde667a755bd4d45123abe2b1761be14dc03096d,flooder,126172,529,1018,1052,1581,1018
5359,5c2bf9bdf9ce382e51a15811a8765dfba5e6c9df693c917483f13ebe3d306b13,flooder,126056,492,991,995,1487,991
5360,5cc62a59cb74e323860055847292cbc147233906ac79fb0897e07cc58b9f4ec8,flooder,126637,481,1002,1036,1517,1002
5361,5cc91b6d255ef46adfeacc45101ac666fb14d30d8c6bdb0a37b55b8291be83de,flooder,64886,261,509,533,794,509
5362,5d1bf4f721cada47aeab67a3879777cd876673d1bca7aaf3d61c20191415947d,flooder,126182,505,960,1020,1525,960
5363,5d40c3b844c0c90d3766652100a8716f080eb22ef4574dc7901d6ddf80a0c2c0,flooder,130992,488,1049,1002,1490,1049
5364,5d7e989fe1e55222cedff88d95da80b7cce8f37c448bdce268e78b41c379e1c4,flooder,64903,253,491,546,799,491
5365,5dc0d18ea9dc2ec912cda06bb6dab3794205eda07276476f9e816a8eadc44445,flooder,121588,450,950,900,1350,950
5366,5e38ef523729372668521ee3cf3709f971ed7c12b5e8ac162751039e507fce4c,flooder,131043,489,1049,1002,1491,1049
5367,5e7338a118cb9745737660836590f8721caa95020d04c06c1e214c9676cd60cc,flooder,64941,252,500,527,779,500
5368,5f293e9df20eb60dcbe9edcd0e247b7b6481f8870719284b0c3cda96ccdf8c18,flooder,126071,531,940,1002,1533,940
5369,5f4de76e4e4c3182f70bc99cd0a5c02dab1e0e20462e584d4fb17fc0902f2ddf,flooder,121628,443,939,909,1352,939
5370,5f9b145c47f7a02028fe284e987353c448f7b9c0d670154a8355ea9574708ef5,flooder,126251,491,1014,1017,1508,1014
5371,5fb43f4a2e8b3bfb38c563fb5d015454464ebcceb5d50a8b8c949c1d6cbbd514,flooder,126164,525,1018,1045,1570,1018
5372,5fef475e3be8b8791be26185123c97c8ae066b6fb7312211fd19a53ff916a292,flooder,126142,504,963,997,1501,963
5373,60a6417d1b447a11f4693138add6c0a8680a64fbb41ebe794919da0a56e573ee,flooder,126634,465,991,1045,1510,991
5374,60d03796ed0030b8457e719a8f9e65ac061d2e782a5766091a295c871c62a027,flooder,131023,488,1049,1003,1491,1049
5375,610a8780ac8f3eda628872f801c8bffb61302f634acb0ab2e90b7a2208a7975e,flooder,64867,254,514,520,774,514
5376,616bad2b86e34f125569d12f285f8275809382d6f1f91b8bab10ac1a08f260ce,flooder,126641,465,1007,1030,1495,1007
5377,617b32707bc88dfa61f01783799762435d8895a9f1f54b738ec714d13fe54e80,flooder,130965,511,1043,998,1509,1043
5378,61fdf615131a4737efc5430d747d46b7f0b185e36d50fc78fe9db4c82bbe512b,flooder,126033,503,1019,1006,1509,1019
5379,620b61e0b1e055243aebcab7058edefd5ecfca2208e2b929d20b9d2c863d9d31,flooder,130207,495,1067,1036,1531,1067
5380,6218130db79ee7c001d066c754d40522b0e3a90afd0d409a0ae37bab9d3621fe,flooder,126107,505,1003,982,1487,1003
5381,6267cc43ae2cff95503fa05d22f62798882a1c47d2ff7731bc2b705bdd5f14c3,flooder,64887,257,510,518,775,510
5382,628eb1543fec4a968159ecd7c1a6210f5c6c3dea7ab6afc504d6f8e180c0ad76,flooder,126241,511,1007,1029,1540,1007
5383,62fb7d7b0494599a61328f5c42e5ecdd193fab47adb7244c819c7b9cb2b5ec32,flooder,126483,475,978,1041,1516,978
5384,639b752b057fbb109c86750675323b83927a71d3fd584bdce2645d732c1f8db1,flooder,65081,248,490,512,760,490
5385,63a70f2f12ead66b73f328cb8bd930c1e845d69b7e6d9d3a5421e8409889c90d,flooder,126660,475,1010,1055,1530,1010
5386,63ab015cffa2693182f919c72d7dad6f8c2e2846a64a5018cd497fd71ff38d47,flooder,133854,502,1046,1101,1603,1046
5387,63e54676386f19279049213b82871f67963ad18bd76187f31ef3e7dbc9833e98,flooder,129548,494,1020,1064,1558,1020
5388,63f6d47ee743e7414a5b40e5c2190b00661b782e483f69fc8bcfbf23a9cb20cb,flooder,126168,523,972,992,1515,972
5389,6435ff1bca05e35fa55286d0e45e896b83d8ceac2264e8424c9b304554393f31,flooder,127504,520,941,1055,1575,941
5390,645595a772ac27d80e4e1315d93150a62a550946a55c9288c708c687afc5fced,flooder,130976,488,1049,1002,1490,1049
5391,646312238372524669628baeef7d5f34d1f92fbe3ea6bd24bbee4516dcd1459d,flooder,126050,527,923,1003,1530,923
5392,64edf288c247c6419ba9983e13592cbdcb17459c89d57d973a3d197da7f7091d,flooder,130283,498,1052,1036,1534,1052
5393,64fd159d47a95dfbd153e46f61cd7cf4d38503ddaaa2eb8608d9a7a9f6e33001,flooder,117480,475,908,954,1429,908
5394,64fd9727f914c0efcfb937f6056d1289279eaaf12328a1360e0a43de474b31e7,flooder,64855,266,513,531,797,513
5395,65769a72f644190f242be4a12ac6a00e3d37d505383810f12234e12a85fbf85b,flooder,126263,486,1008,994,1480,1008
5396,6620012b5ea1bbd87a5c3a8f50adadfb02139617ad74a2efe92e484cffba7f9a,flooder,126102,504,946,1008,1512,946
5397,664b047f19de1e8df954e485ea7ff895dd5d5158c6416565e8f01f4072eaeda9,flooder,117499,472,873,989,1461,873
5398,66618352dc76a17fa9cc8e203fa5700216fe8c7bcb9efaa50c9cf4352f5987d2,flooder,130957,512,1043,998,1510,1043
5399,6664d22ba94497a27f3c4e31b920e6f0a269491bd38a6b1722a8ea48908b12d2,flooder,127500,498,952,1044,1542,952
5400,66861223397d0977c5220add097556d4a8b11f315334799d17face35861c05cc,flooder,126138,493,996,1001,1494,996
5401,66de6e42bb6b9d341731755559875084467d743646d5940f6199f75e475bf6ab,flooder,117492,461,904,951,1412,904
5402,66f85f81a5ea6ca6c5dab68cdd028fe47d07f47f6cc6131f5fb4b2d209408b16,flooder,64870,258,521,530,788,521
5403,670c2e94381d22f3568f07a54c2dce5a418990efebd8cc1a1482805cac546797,flooder,126462,464,971,1042,1506,971
5404,675706633c009c2f6515b44a05694b6b6dc8f67096cb6076b452c929553a7b6f,flooder,126317,480,1018,998,1478,1018
5405,680f164f98df1b6e10ab45eaefb56a5553c546961428fa5e5902bbe8c1023af2,flooder,126050,527,923,1003,1530,923
5406,681669260fc1c8ad15400129feff84d1ad79092204491edb48d4fd8202ac62de,flooder,131055,489,1049,1002,1491,1049
5407,682655d55a550b1b12a983d420d2cb0150b24dc31686e9d0f08415a93dbe1c36,flooder,126210,489,1013,992,1481,1013
5408,68a6c4003d7278c49e460c16baf850c058ddf69b98b82540ea6f2b2db52db114,flooder,126062,502,1024,1009,1511,1024
5409,68a7256adc9afd802f5ff3985389be62dafdb0e0e3ada35929dddebb132d4ad9,flooder,126052,482,1006,995,1477,1006
5410,68f0c8f77008e57d1df1807e1feea6dd7f16d301e88511a9eff0c7b192bf5ede,flooder,64886,266,519,541,807,519
5411,69702055303a45e5bf77564807aeb44e8c7a45c85eb69d937d241e0654bbae28,flooder,64864,251,499,534,785,499
5412,69bf73a62658a22d943b51bf3855485cfcb850fb4de3205d3a6a6d74a34b5460,flooder,126031,499,1016,1006,1505,1016
5413,69c73ec2b154837c7e6ac77cc90ef95caa0c83420217b0d64358f213e6a52676,flooder,126187,514,1026,1020,1534,1026
5414,6a291305b8890c71317e4c6c116718f085b07d329332ef76a5ffb29271c97db0,flooder,64876,257,532,522,779,532
5415,6a8f063b3e847cce4f2f8fc60b00c3ee2e7cab67d6185ed8ff6f728dfcbc6a9e,flooder,126078,503,1026,1028,1531,1026
5416,6aca7ef5d6e13bab462d39226fb5024c96e0f002c0338797a6028d87377b3112,flooder,130273,498,1066,1031,1529,1066
5417,6ad216473108808013f06457a1a644cd34dd86830284477d97ee5bd8050c5328,flooder,126475,467,988,1049,1516,988
5418,6affdad9ddfe5e3bf603b9fb4de97169b637878e8a11fe937275f45899660fff,flooder,126008,494,998,999,1493,998
5419,6b1ca6a6b183d82118286f32d55a2fbc7a22b8fe7233c82eb796edf808a88ba5,flooder,64965,258,517,525,783,517
5420,6b4777d48167eda7193868644fb9c78f220ef04ed8a7a8340cc495a8da240e6e,flooder,126464,473,970,1037,1510,970
5421,6b485f6398fd324f198508ead7ac7327005efe02ba11541c4af4c30fc20604bf,flooder,126147,521,1020,1046,1567,1020
5422,6bab6a852769841a3c1850e4e36df41eb9aedc14e90f47f7d18b32d76f8ed8ef,flooder,133825,504,1048,1099,1603,1048
5423,6bc4179cf33c378bc50603b6b163cc0a56f9fbaa6ff7675522692a3f98235535,flooder,130965,511,1043,999,1510,1043
5424,6c05616c833b9f6fba1cf5f46899b5c93086e1787f35d688af7d69a7105a9255,flooder,126251,493,1008,998,1491,1008
5425,6c083c27a8891b0fb43c2c5878ac0ef1d627c9360b424d5df5a64fb7593d3854,flooder,126668,465,1007,1030,1495,1007
5426,6c4f7cbc09624e81115a91ab14b8a056626401e83525f6e5880580b0e1b6ee28,flooder,126200,514,963,1001,1515,963
5427,6c68bdc053d1c849a1ed5769e3b179f37326d7140240460e77d45a80f72486d1,flooder,125963,500,1003,1018,1518,1003
5428,6c77c8fa1a2e153806c9895555884d63c5b975d19e07413c6750cb89807d9dee,flooder,64922,267,500,527,794,500
5429,6c896f332d5013845a0a8496724475b2d61a772facd339e07de125e501f30700,flooder,64884,258,493,535,793,493
5430,6d205fb841553bf6834e606d4d2cefe388c7adc28e5b485871bcb6c7d18d2de2,flooder,126236,506,1022,1004,1510,1022
5431,6db9dbb049876b61345074ff40b0f629e256fe319e6a8080d5e49bccc18d16be,flooder,126119,495,997,1006,1501,997
5432,6dd8676e1f53c138cead83613d3388fbc76d93ee9502c6193b4395a6bc420301,flooder,126277,536,921,1019,1555,921
5433,6e326392bd975e23f0794d025ebbaf2d9443572c5ca259ee554e7ea914e6ae6e,flooder,126051,507,1028,1021,1528,1028
5434,6e42c0c5928f1792af4863ac0baca38df1b816db05ef0bc9e3376860ea10d18f,flooder,125979,487,999,1002,1489,999
5435,6e8e367ebc1907a6d4f95a6537ac9bdc190009d24d9d4a45db959c00ac5548e1,flooder,126058,494,1000,981,1475,1000
5436,6e916012d1dfd82dddd74dc022da05590b21e2acfd87c43ab93f9f5b698b5024,flooder,130949,509,1043,997,1506,1043
5437,6ef576a31eb5884540cfca1e3a679f326d61e222c09d2aed0f2b4fc02dc65f09,flooder,126048,490,1005,986,1476,1005
5438,6f0b52ec7e8f31f0a53544cac08edd426be75dd81bf97c23628a62d79799cf6c,flooder,126969,478,980,1043,1521,980
5439,6f39e9d013991570801791c9f9ede2ae15b926fbaa10901bd01ce6eda306923c,flooder,75455,261,617,614,875,617
5440,6f7c91dd04988efdc0685bf0608cbb7f523c00101a4609b1aad3eb963b55fd75,flooder,117468,471,902,969,1440,902
5441,6f94dfa6bc4370d351e5f75cd6dde633f7214d35bb5798d105c7ccb3c6d13aa5,flooder,64888,243,490,524,767,490
5442,6fb3ec7fa7c73fee452df74d1c840016ae2b0f751744930514321a8e3151cedf,flooder,125991,496,990,995,1491,990
5443,700d31007dc3aee12973e7f77dbea0a66d7ebf3f11ddeab24505efdb650ff55c,flooder,126646,465,991,1045,1510,991
5444,700d4136431d45139c07052e16c9f8cbb3d942fd00804d37e33ef33e337f4692,flooder,64885,250,515,554,804,515
5445,709899249541f3f6834655985e749f329b2857465c31cc042e3d87e2bab7ebed,flooder,126048,482,1006,995,1477,1006
5446,713ad2523d4758100f6773c6c0765b9ca862250421d658b265058ad3c2cc779b,flooder,126273,499,973,1008,1507,973
5447,71b28c7e77a6fc36af8e00278dfa73e9c83e86668ae0920488b938b1c08f1946,flooder,127512,520,942,1041,1561,942
5448,71c0866e6a259c9dba6592e6ba478e2a1ad19feb37e024ec705ddbd30d62a3cf,flooder,64889,252,503,528,780,503
5449,71f609a78ef8e9106ab7859b6b5a9ea8fe6f0d423f57bdef8105bc4da7f7d6a2,flooder,126018,508,1004,1005,1513,1004
5450,72a1dec442557fdab131c0823c3f9bd6c3715e73abe8b3a28b781b6350b81742,flooder,126644,463,970,1047,1510,970
5451,731b4b34cf29438ef732ef008ac17b2a98e045062e3a19aa0b78a8527fdba380,flooder,126119,495,997,1006,1501,997
5452,736fcf6e14cd903768ca85f9d11301fb138eb17e1388bd058c992b9d632ca3ae,flooder,126012,487,999,995,1482,999
5453,74475ba7b68dce661640140eabc7c759273b94d4bf14ceae6e507d29020d434d,flooder,126672,472,1000,1045,1517,1000
5454,7474281073b166cdc10714d26d3668f75fb4bbb821d7c4dc5d3ad2e0943ffb7c,flooder,126116,492,988,995,1487,988
5455,74b787bb392b63bcead3d6e6e575a5bad416f17cd02315869b390c82963cf714,flooder,126039,529,939,1007,1536,939
5456,75143c718de235f5f2e64e601c79429439526fad6e711dfcad8d3bd092032584,flooder,64869,257,514,530,787,514
5457,756fec152afe54a5ee0c0bf677583a28637ce4f5348d0c4cdd9efcfa87fcaaf0,flooder,126128,491,998,1014,1505,998
5458,757a4c25185d3f8bd75e06870b36924fe4de779729c88dface706fff968fec9e,flooder,126112,515,1000,993,1508,1000
5459,761bd096557c68ab00368edc769a383e62224afc1e1b435e549ceb00e378d33e,flooder,130976,488,1049,1003,1491,1049
5460,76441c23c60c18aa9d01caf00cc8f053dea5f22bd5d09c6ac6a4eb16ce3f5dd4,flooder,126394,472,990,1041,1513,990
5461,76467317b7fd5cd8f123cccc258cd4cc603188d2333af67c1dc659dd8889f0d9,flooder,128870,489,991,1066,1555,991
5462,7683a95a7681b0e8e24f724a1227f862505e70542bbe60ecb4f809db8a1077fb,flooder,64883,265,514,532,797,514
5463,76851fba6f9cb0c6aebe668bfc6aa81b9f219a12557d5d73e8d9e373f83e2e95,flooder,126213,491,1008,993,1484,1008
5464,768f22a4b72d655bab2bb38e8fb3b5feb64c7c7c12366561a939827a5c188153,flooder,126127,512,1011,1015,1527,1011
5465,76de4eb90e4dbcb56a28409ea4882c3b9e40798e1711d2cd977567d2aed52df4,flooder,126041,493,1008,983,1476,1008
5466,7727d276498adf6a621c5dd87317f84bd62abddf61da6c3f41cd9ed436386e12,flooder,127512,517,947,1036,1553,947
5467,776c9f3c3769c65182d9e34e489ec61735d190bf9ae55a1077ecaa8d5a7af03e,flooder,126663,471,994,1066,1537,994
5468,776cf55a4bfe198b772dc2048207a414393254157e80c5c15c957c004f27f66e,flooder,126091,481,975,1016,1497,975
5469,77b860289c03ea74b6858d548d247637ec0b25425b14dcde964e5dd237b964d8,flooder,126074,476,968,999,1475,968
5470,783e90f24b9b99abf2f9ca5cc646fa7770b902e273b39a5809277790b409c307,flooder,126171,486,996,1007,1493,996
5471,791c21045832e0890c10efc6c2721030b627876e72cc06eabf4557af42e3c133,flooder,126182,516,959,992,1508,959
5472,7946770e4d3d4f1cf2928e85876986acc9a2aa1b3646def05c7ad237be6b3e35,flooder,126109,501,1023,1012,1513,1023
5473,7952763de4df5f1affe8d3d17a09a4a1028ef9d853f9783367581adaa768abf8,flooder,130965,511,1043,1000,1511,1043
5474,79e3eef888f9c129b439c806d4a2425394258f55bb8bf0ee2cba5c98c9f90c28,flooder,130965,511,1043,999,1510,1043
5475,7ac5b27773251e90a3ba5f7b9d288b45d7ed22e1b2cd8dc1d02af8852493a09a,flooder,130968,488,1049,1002,1490,1049
5476,7aebbfac51cb0c1c4487df6128d77e768260459eab7f3035779405e4d9ceecf7,flooder,64873,259,528,525,784,528
5477,7c0fd01242314b36ccb6dd699af35f57d3dc3b030a7aae42089ede15d204b530,flooder,126483,475,978,1041,1516,978
5478,7cbc52ac3baa41df6d7393a430208e7191b4a6b6bd8f6139f58d7525deae4cd4,flooder,126637,465,1006,1030,1495,1006
5479,7ceba8cde8a2fb5560401fec8101fa911f40c2cf7f328f87417f3bad3a5987a9,flooder,126120,508,1022,1004,1512,1022
5480,7d2c2147a2a163688e5847de9609119166752a580d98a998c4e9e051819e3ef0,flooder,126109,509,971,1016,1525,971
5481,7da92fab1093e210ff39d203165becaed7d2f7460f30aee32f5b55db01d1dbb8,flooder,131114,488,1051,1003,1491,1051
5482,7dac49881e0c2606e7f92211de3a54b3a4fd4ca8c400490eb312ec617bcc0f3f,flooder,126173,504,1027,1000,1504,1027
5483,7ddfb00d61a1e0e4af79674ca36368f307aa1e8150d1415aaf6a15e0d168784b,flooder,131043,488,1049,1002,1490,1049
5484,7e2f1af3a14a9f19a40676620574c6486d929ec10b0bd2ce6d8bfa3e610fc4f8,flooder,126673,462,1000,1038,1500,1000
5485,7e7875ee5338271ecb0c75fce3ca6f4478b05d3c4a9a1e3f88c5cff3cdc377a8,flooder,130957,510,1043,998,1508,1043
5486,7e798bc3c6774d75e8e932fe8af8657cc1f7786d0f693313ca9c977bc9ed4dba,flooder,127449,516,945,1038,1554,945
5487,7ecbc616d9d86866f76e0b85428182f1e04daca50c2b9576f3cd886aedfa6146,flooder,126215,505,957,985,1490,957
5488,7ed04c060298779ac52492f575d1432155ce8eb6090df9fac58328231e13404d,flooder,126275,465,996,1046,1511,996
5489,7f2a528ba6c7b6f881624d2393a9c9c1554688541d45fac9f39e1e188df96d27,flooder,126267,489,1012,1009,1498,1012
5490,7f552193744569391078cdf6e5ab53837c01782a8d1edff75e4a024fa8fdc57f,flooder,126642,471,975,1038,1509,975
5491,7f5aea7c1b22b97d1aa62f07cead53e906074f31eb1142dd0975690019673b4d,flooder,73276,300,584,554,854,584
5492,800547e403bb7a3921c44ee6029bef54cf319a2db8a1499018aa869f21a68121,flooder,130964,488,1049,1002,1490,1049
5493,80966188c80d8f45466d1c9b1367bf89f1e30486b497b958ccd187226a11c88b,flooder,126060,493,1006,995,1488,1006
5494,80a2b993f9ab35b8c3b8915ab89edafb3bd417f29d5236b08e42787b860876b8,flooder,126213,491,1008,993,1484,1008
5495,80b0795301f557677bc3db7516493f0d3faf9eff49f9d973be20b155077a21c9,flooder,126186,514,1025,1020,1534,1025
5496,812ba7f83b1223d858ce69a6d3e80041814611d5b13a03f4db7487df35eb071d,flooder,126658,461,1008,1045,1506,1008
5497,8130cb0839210367069372853c28647e420f2b60bdf369633c4e527e37f1cc44,flooder,126664,465,1007,1030,1495,1007
5498,81493e0ef0ea605c4e40d1cf9b492c84f287c8cfd960366272778c7243419077,flooder,126250,492,1001,988,1480,1001
5499,81d0149253bc47fc0e491985c9ee3b9501f51e2e16b62ee069ea23a3ea2ce0c2,flooder,73335,300,592,550,850,592
5500,81ea2165cf18721c84864129139f5364c1934ac60084c63c1ce3fb47bc7a051c,flooder,126204,503,1013,997,1500,1013
5501,82551653931baa30c5fc01c3f1d44e46034b6bf9b177a8cd741e9196ff17d311,flooder,64863,266,514,531,797,514
5502,8261b3623563e098419e470eaba1cb40a5482143b6a4cb812c5cb9ce8070068f,flooder,126043,540,930,1006,1546,930
5503,82d5c0c0dfdec7d3a45f68c11c10644c07663943daac290e73952ca65773f7fa,flooder,126060,477,1004,991,1468,1004
5504,8318b63ee2f1527d94316edcc5dca86b41f11d5d1d2163321ce14c76f3d093cd,flooder,126082,497,1013,1018,1515,1013
5505,8321b9a5f583355b64ab22df5a88bd154899b6dd9a4c2260fec241dcfcdcd745,flooder,130980,488,1049,1003,1491,1049
5506,8375168a46a9fe9da9431013f70bffe002e8d18923c59eeec6d4868ebf9c7359,flooder,126220,486,1020,1000,1486,1020
5507,8382bab4c802a02f06282ed817ab671147429b59a25135b4c5f399086b17d670,flooder,130957,511,1043,998,1509,1043
5508,83ce3159410634bea35629fc68a47c35b7222768450f5c50e2a88438f78e5c7d,flooder,64890,265,520,542,807,520
5509,841a1dcdddd88616f0001b2ddd7bd8454027ce2348c655a137fbfc96738af025,flooder,126145,490,981,987,1477,981
5510,845139fb8f8eb25652db7e4f9b8c56c46c9ca03292c36fa2d9fc60fc32e5fe2e,flooder,64887,265,519,543,808,519
5511,847e4b4c45c8d664838e9b2a08188a22f961910b5ece3a296becaf8eb93ac07f,flooder,126181,514,1008,1013,1527,1008
5512,8499423ba1e954bff63321a7d434e152d86a149050ad3ca4c590df9b252ea008,flooder,126062,508,1022,1002,1510,1022
5513,84c62cd17ec46d5f0cbc32ced3e89b0841beacd02ffaf7f59c5b251ecbdcba0e,flooder,126262,490,1003,1005,1495,1003
5514,84febac8c766590524fcbd8491f6cf199e1930c95873f750f87cbd1df7f5047e,flooder,126184,518,1013,1041,1559,1013
5515,851dfede0fcf6b4025e56ebc2f5e7fc5fd069125c348d53d750905016a8bc0b8,flooder,126217,501,955,994,1495,955
5516,856b43f6e9cb4db9d5fcfd0763bb816e70dd6c0768d3a24e944f52b222300040,flooder,126225,486,1011,1002,1488,1011
5517,85b660eb7e88aab4fcca6d660158b655de9862feefd4f3d8306ca3b78fa00033,flooder,126113,504,946,1009,1513,946
5518,85bf05eb0632be232e81f823193720ea74495f4bd7f8650cf99cbcc5610ee690,flooder,126228,484,1008,1000,1484,1008
5519,86442810f3a9a02ce7443df4cb77921efd23307d31cf495a9059a70b5ea996f3,flooder,126251,493,1001,988,1481,1001
5520,877839f25a75cb5b9d60a504f6acd93c19eee1cbf2182c67c1e1db53e6779c1f,flooder,121615,460,942,917,1377,942
5521,87e4778a899513621767254d157f0b4831226ade139df34988aa59e996f34533,flooder,64828,247,514,522,769,514
5522,87ee2b1e66497c2c75e43393373a9532fa6677cdf36811dffc2543cad003b6a6,flooder,64898,265,519,541,806,519
5523,8837abb0e6edc9d26beced257345068922fb655475668d2d672a2c2ce5413edb,flooder,126259,488,1009,989,1477,1009
5524,8859fdef27003e706f7b6a704bbf8040edf6d33933bfa4315edc46aab6c4cf81,flooder,126107,490,1000,1023,1513,1000
5525,88f445c6307f7b8f6d6b10b8effbe7e0391ef87d15b42efb900631ef3bbd42f5,flooder,126191,522,956,1002,1524,956
5526,88fef44ee1a9efc266d8106b242daca85315c620d721ae3287b1520d315bbc85,flooder,126036,510,1018,1008,1518,1018
5527,890d059087e5dcb8ca40d88010ad4671d92ffe4ec0cd9dcd954c69dbae493f3f,flooder,126023,529,939,1007,1536,939
5528,890f5fd5352688f383f193a8aae4c6b4736db898638cdee8986183cc5f33d554,flooder,126185,535,1006,1022,1557,1006
5529,89235a93c23a2438d54bb1ae13129d94f90ae3dff0021fc5b76ae35932b3d43f,flooder,126075,518,1018,1015,1533,1018
5530,89415018c6d384c38165f11585a4558f9995a71604a633543e9c7dc4d69fc679,flooder,126657,474,1002,1033,1507,1002
5531,8967b7a78ef6f608383e7bb3535e109860126c17e73a52a90ac0c46455f90359,flooder,127504,517,947,1036,1553,947
5532,89694876edacd82022bb460ceeca1e05ebeac16899303a9679d193f66e62bd2c,flooder,126301,490,1001,1005,1495,1001
5533,89881b8e03248422a4299113cf012d5bb9b361b05da8ef298d1633c2883084c5,flooder,127411,482,992,1037,1519,992
5534,8999c48077e9b19666ede993be9c0779b575e61b141a443424f96427e8acdd25,flooder,64871,270,509,523,793,509
5535,8a8a4fbf1bffc7eaf92a9a15dcc8d9f026b94e6c80d2e7f27122ba39e920bb96,flooder,64902,257,511,519,776,511
5536,8aa33ca4ad7aeb540d3efbaa6ef308970bcb6a0f73de1af1201f0e410ed240e1,flooder,133818,502,1047,1100,1602,1047
5537,8b1ada00bb631c85db72487e0bbea9db20a8e29a2668807e7419d38fd0039e77,flooder,130945,511,1043,998,1509,1043
5538,8b6c1778257d49ec2641c18eccf9ff712cfb4cfb6100a093f8e4eb79c3aaa65a,flooder,126266,527,923,1009,1536,923
5539,8bc350468283db153aeda0bba7a197719b597bdfc4a46e399a1a7e6940deb6f5,flooder,126644,465,991,1044,1509,991
5540,8bc9a0453d72a05192985b81b8c3c0379b890098999a9724eb5d7e763a19781a,flooder,126112,514,957,1005,1519,957
5541,8c4c068ce9cf9dbff22d9be6402baee568dcf14bba3438fbfa0f072cbba1484d,flooder,64827,265,513,532,797,513
5542,8c87e060536dc3eeb8fe538d78deaa4b0abc364ea5f6f5db6848f7eba1c96dd0,flooder,126074,480,968,1024,1504,968
5543,8c9376f36870c0718114ac7823ff1ecfa15c27a38fc76cb9d101121d2b7b1ca1,flooder,126138,493,995,1001,1494,995
5544,8ca7c6e1ddea86219c943f49a4b920613c6a45382fd74f06722cefedfbd9796b,flooder,127446,531,961,1013,1544,961
5545,8d28728881d87de06cfe3119fcafefe80654a90db2b66593092f7902c3f58e7f,flooder,125977,488,1008,993,1481,1008
5546,8d4e0ea9e0744b8a0bd3e68cdf43c906302967a2df511a76c51407578a2559f8,flooder,133838,502,1046,1101,1603,1046
5547,8d69f9bb067b269014857f87b686f381e5115f01187978b293e320c7e7666f80,flooder,126205,507,969,994,1501,969
5548,8e115e21ebf2203fa67a389b2236588f5154a15b919fedaf74c5cf7089c39277,flooder,126648,465,1007,1030,1495,1007
5549,8ee326cfca4ab8b13c14849b3f4538d080c11b4c8a674490f09b195affaf0b9e,flooder,126072,537,934,994,1531,934
5550,8f2749ba02fd8aa1f28ff80b668c20da319b18a2c1797bc06bff65266fdb26ff,flooder,73304,300,586,549,849,586
5551,8f29e0b2e0438e0a4fb866f908114a8aaf5cf20694407a8d0b4038264253bacd,flooder,126277,492,992,1008,1500,992
5552,8fc0e2f1c7c3cae22cfab45aa8b0ce811f1de6a14cd466f0db5df97275a70558,flooder,126013,486,1014,992,1478,1014
5553,9028883e29e549d75cffaf6452717aa04157c6ada86c8bfdb6ffdc46410e82ca,flooder,122877,493,976,1020,1513,976
5554,90fbdfd82f436c19a2560b4634242be30c89623350ebbbc03460ebe3ec0eb82b,flooder,126262,490,1003,1005,1495,1003
5555,9127ac8660814d791a42293107533d38788f0a975ba66bd98f40d78a78959d00,flooder,125978,496,1013,1001,1497,1013
5556,913565173d707c1503a3cd7932f83910d7ec5c2c905b3cb18b370d8a07208f4d,flooder,126043,525,922,1001,1526,922
5557,9163ee58f54dda8da0847e980b1687cfeb8a3088e27dfdf7fe7159b997cbca30,flooder,117484,459,886,948,1407,886
5558,917532e124682721ee075498e0c7068b7cc6a31cf43d44e6157e1783f5c8025f,flooder,126308,479,1018,998,1477,1018
5559,9175a68c7cd458e047404473b55884200f05dbbd666e8d3371c973cdd86583ba,flooder,133851,508,1026,1112,1620,1026
5560,917b280a6eab9caca60e9512b56424d542c981b756378e6fc57189d007882acd,flooder,64887,253,497,527,780,497
5561,919d2f2f8c5ac5efd8fe37868e2d303691ce5f3a8d64dd87c9b37b9993bd698b,flooder,64920,252,524,522,774,524
5562,91c58e69b9cf3cdda11342098f10924c3afdc16267c81bd846954b95b9c8aa81,flooder,130968,488,1049,1002,1490,1049
5563,91dd57aa74321aaf7e979e9fe0e2141a83791609b35224f38fe4a52922bed614,flooder,127512,515,947,1034,1549,947
5564,91e776ce5fc1abb2cfe0b4ae986a9081ac2784a9ddf2021d0f593d67440af709,flooder,126231,481,997,995,1476,997
5565,91e7e37cf7a59e87d1ce8d02f61aeba09a3b841a56fda01b11e8844bb9b0e2de,flooder,127512,517,947,1036,1553,947
5566,92299a9d9821f9dc81fee4d8edc112e81bad1866364a6dd8b395520351cdb68f,flooder,131004,488,1049,1002,1490,1049
5567,9301a8bb65046c12e714f78da9f7fdd7b93c2fb7ef60e430ad27e245a24e6d42,flooder,131043,488,1049,1002,1490,1049
5568,9302938ab6e9aab6639521deb077937f15ee41f6a07afa7814fa69b59cc009af,flooder,126601,469,997,1032,1501,997
5569,9328964fae4f8bd124d20f22906421412aa3af60fd3a367396d1dbfc8e6bf8df,flooder,130165,497,1066,1033,1530,1066
5570,9341bad6e5d535db1ba740453cb586e4d58e9b1b6d5e4ab48327fcef86450416,flooder,126113,504,946,1009,1513,946
5571,934ad66bcaa3bbb1b3c5eefe8f4e73c709ad6bf0a73ef15f8a249eaa140e5c32,flooder,126406,470,986,1044,1514,986
5572,935156823d7495166062743e5d462423eecdde49b29bbfc8b023245992219043,flooder,126043,482,979,990,1472,979
5573,936ccf0df7273adbde40c787f4374d93e5150c5e40d15f49d4dacc88f1cc7b48,flooder,126163,520,998,1038,1558,998
5574,9399e9ec451acacf092124081e879328f1328203ade3580e51fe069033c026c6,flooder,73288,300,584,556,856,584
5575,93eb1b3794245e9218bd217ef2d439adc3acb3378c00360fb0037cd41cc03822,flooder,126477,457,991,1041,1498,991
5576,9403b52c40d441774c8c76d5ebd6bf77ffeb5a633c13531e7a5a6fa21f78ca38,flooder,130957,510,1043,998,1508,1043
5577,9427d12734ea98f5db926cd09fe94906670dcca644e806324131632275a07495,flooder,64875,257,510,518,775,510
5578,942dbb8d80f873ce5e097b6cf563861234e9c475b37b2fe67ee7bed142b2d90b,flooder,133850,508,1027,1118,1626,1027
5579,946c3d9459aacbc128220cf7ec8a6b38c5e3164ed4611372f0ecec74ead280c2,flooder,126293,496,1003,1008,1504,1003
5580,94e8ebd68a7fd3b94872ab574b08244a32037a7867ae557dc72bd877551167dd,flooder,126040,511,1014,1003,1514,1014
5581,95522b6ef0111131d9582428edb471969ecb2795ffcb563fa0ce5d497dcc9e19,flooder,131059,488,1049,1002,1490,1049
5582,95629d3a978894f7a6b5d8ddbd7e1dd7f4f382c2e5b6e5f8458f5447a2b73035,flooder,126213,509,956,1010,1519,956
5583,957d6dae00c1c36c1a1598fee69e5734fb50e4b379513c079fcb67f1f795f955,flooder,73286,306,579,547,853,579
5584,958173b42ade6774bcc76e61092223e93197db53cdf8a5acbad766af4fd0b951,flooder,131138,489,1051,1003,1492,1051
5585,968affc3958106ba907d38b4b51fff7a307dcb6b76834383fea35fb65a2a49c0,flooder,75448,273,623,633,906,623
5586,96c2d3818125439b747245ca6874d5fcf78b2a36e7f296ec92abe48429f4745c,flooder,126065,503,964,988,1491,964
5587,96d62087fb4594114a25bf70c6a48aac4ffcdd301403468305c675c978f02aca,flooder,64858,248,526,520,768,526
5588,96e27d56b07dc80103981edc943fa77e7e624878eb5ad3fdade0966d8351f2fa,flooder,126238,498,1016,990,1488,1016
5589,97047b12d48f2efb9c0ad9df51eaf13ce8f2be82a693bdddfcd92c015dc321ea,flooder,130957,511,1043,999,1510,1043
5590,97081b8ddb0e4e091bc6665b526af74b3f6164f88cde527a5fd153c26113bfae,flooder,126191,522,956,1002,1524,956
5591,970abaa797c38c1cc1204924f36c6d917543b04069d087b810a8f00a410eda1c,flooder,126043,489,1011,1001,1490,1011
5592,9719fe3280390d800a7bc95d0e482ca916a557524824f756112138839e368109,flooder,126208,471,998,1050,1521,998
5593,9722051777a7130541366fea8938a5db4a39b58ee59562db7468bbed67d5704d,flooder,126033,503,1018,1006,1509,1018
5594,976049924fe884ccf93d00ac3e05122a0cf3dff61450da76d77bdeb1b02565bd,flooder,126054,498,1011,1014,1512,1011
5595,9797e4cf51181abd17c5bd67d758f504f9f16883af556fc078d856b91d9bb37a,flooder,126289,504,1000,992,1496,1000
5596,98215f12b6d42995d5f9737c4f4938cefb7876e7800956100540b39bba00269d,flooder,121603,454,955,900,1354,955
5597,987a3718da02e00411825db1a400502334a8838bb60ff4513cdf2ee57e84a7c7,flooder,126187,521,953,1010,1531,953
5598,98e4015a1ed9d362ac35e05dd4c346c7b67c68352bec04e154990ef3aa3fab2e,flooder,126053,480,1002,994,1474,1002
5599,98fc77433855770a1f45a7143a0064ee0316101b8f98ee8a6f0e7bf1f513a350,flooder,130961,511,1043,998,1509,1043
5600,992dc666b65b99977c8ea12f3fb41af041652fc7168e16b12a2654589d520fad,flooder,127534,518,943,1029,1547,943
5601,99a215c4343531e1594c89b4415a1f1f7b1639bad313803ceb490fa58af40f35,flooder,130969,511,1043,999,1510,1043
5602,99b8aab13911e02c45d15092075dc68da23ece8730f8480b05dd8d3f59c301ec,flooder,121614,458,940,926,1384,940
5603,99bb3329465c3d21e3764e13bf12d3787beaacf42eabc3a929ccda7a4dbdfc0f,flooder,126101,481,964,1014,1495,964
5604,99c1704ee40ad7d23454d678ca1903e431213cd173779cf81b009fe1ea01e6f7,flooder,127520,516,948,1034,1550,948
5605,99c1e427a89e79049c10cf67f0c26aca1232790673f4ab07868d8b070e23908f,flooder,17984,63,146,154,217,146
5606,99c786bfc475c1c7009de44525f99c8375ca395e77147d7d3c53acef1b000f26,flooder,130992,488,1049,1002,1490,1049
5607,9a052e185ecc7b3d5aa81af626e643a308a8bdd70169a3df5c0847ae955a0747,flooder,126122,512,1011,1015,1527,1011
5608,9a81d4d167b82f697a805ce57cd448aa4d47d9a775651de8db0ba5910b91dde1,flooder,64871,264,511,528,792,511
5609,9a93b7ed98a288830910b9d95ac340a1248bb4d09acfa59320afbd0474156e16,flooder,126224,487,999,997,1484,999
5610,9a9897a088fa3001a3f010dbe06a499fe8da5b91e29f5b14e301beb3a8136de0,flooder,126141,496,1007,981,1477,1007
5611,9a9fca09ccb8dffa1a63f6f41adcfd6c8d5d3a308d59fa4232ce2dabd8d71e92,flooder,126015,490,1002,1001,1491,1002
5612,9b5e2abe645dd29832254b7673bdc88cda43b56e0bf55ebe824817f11dbac5c7,flooder,125998,497,1013,1001,1498,1013
5613,9b6e73bd5dc226a47478af0951aba4862832759e4acb02dd543ac2ff2837498d,flooder,131043,488,1049,1002,1490,1049
5614,9c014aeb0f15639a2fd0c36742ad3dd6f2dbbe9f85270fcb181819aed5cbbbcd,flooder,126209,506,976,1001,1507,976
5615,9c96fff0e8c534f802c9c74b3c21fb6a28187165872654a1f8eb277c1da6e28a,flooder,127505,517,947,1035,1552,947
5616,9cd88354d8f1f48620ec54572d37d4f73a653de2992acfb0cbb7c14026c4f172,flooder,126031,498,1016,1006,1504,1016
5617,9cf295627f038acfc938ff7d2e1fd4215822d39114539c06e885c4c0220accfb,flooder,130965,512,1043,998,1510,1043
5618,9dbab6cec2817930712288ceec63dd00a0072ac6c0e90e7643762472053327b6,flooder,130976,488,1050,1002,1490,1050
5619,9dff1cef74807d200c2a5c87162f49d4480e988b9388d683910450a9883db9af,flooder,127530,516,943,1029,1545,943
5620,9e1e14a92f61b8b539d80157ec7bbdf7f052b87fe3c1c30f684bfb8efa53c1b8,flooder,126233,506,1022,1004,1510,1022
5621,9e82cde218a3b8b5919b180909e59cd7caea9c1cad07b8166b8d7bf75ee3ca66,flooder,130957,511,1043,998,1509,1043
5622,9f1e355e18624a61b603ee435a5812421a67566133e07a205b35a3a20ed0e030,flooder,126166,487,1021,1010,1497,1021
5623,9f2abb5c6c093d57f37cfe00ed0abb5b8d7754f606785eecc67f370bc794a9d1,flooder,132007,554,1084,1072,1626,1084
5624,9fb1cd1caf96b4deadc97f07152b82b5be60453527aaee1d0548f9e441e27253,flooder,133823,502,1046,1100,1602,1046
5625,9fce4e79a3856f23825143e29131fa9497cf50cb6695587e957381b998accd97,flooder,126270,508,963,988,1496,963
5626,9fefb2a0dd1723f138ddbcd64d2fd7496d4ff3cab4f2f28b0e3d9ec74fd7596e,flooder,126645,465,992,1045,1510,992
5627,9ffb43fac2b4685e4ad9b3a8f40de79a0498d139814a5650aedb9788ab49b69a,flooder,126638,465,991,1046,1511,991
5628,a05c91a660c02025f97163c7e183b82433a5be38bfecca473b32963ab5563dff,flooder,126239,499,1009,1007,1506,1009
5629,a0c8f4aff206ce39f29025cf600f932ca3ce93412a7c71b3c860b4c803857b04,flooder,64904,253,491,545,798,491
5630,a0d3c697fbcc049500b833e1808fa043c0f2adaa96ec145101324f2bccadb58a,flooder,125998,497,1013,1003,1500,1013
5631,a0dfc2b975ad63629926868e0982e0c6615d4049fb503afd590b07d9d563a5e2,flooder,64861,258,501,538,796,501
5632,a10b204b1d2b507a270828d044c2e128706b0da062f211ef098db647522b1092,flooder,126033,506,961,986,1492,961
5633,a19aae0b776151f059b6f85d26c40fa4d0c99be436f18fe0f31b131479c0edd3,flooder,126276,539,940,1009,1548,940
5634,a19bf71228f3623a4cc0afff0672eb065314fc84bbe18e1d062f8bacc2df9cfd,flooder,65074,248,490,512,760,490
5635,a19fe43a5f04a5a51486158c9c1816b1f4692466eb26256958374ad604d3dfab,flooder,64891,258,510,518,776,510
5636,a235047223c2d521af2223eb6ed841120dd556719504421ed51c925af72800e8,flooder,126060,497,1012,987,1484,1012
5637,a292f48dc34f992f120cf40547201b6ff28b5d8c66778520970070ee77386db5,flooder,126020,501,1023,1003,1504,1023
5638,a32f4836f4ec157f03a3298d65cef9a727bfe902684255de622456f29bccac00,flooder,131008,488,1049,1002,1490,1049
5639,a3347424bee620899a03543a1071a388f30c4d45f7315dbb3ed3b9de333a8f66,flooder,131068,488,1049,1002,1490,1049
5640,a3998026325b7d85b4cafd6c94bca164e1ae9df09df3d52bddd6097363d3bb1f,flooder,133212,503,1004,1126,1629,1004
5641,a3c37764f74e93b2e892531a34133f98108152cfad2cd0113242da36dcc79e53,flooder,126032,529,939,1007,1536,939
5642,a3fddd5b9d91f673e55640dc07877f305834b8ad7f090ede13040d4c8138c8ec,flooder,126162,506,1008,1007,1513,1008
5643,a4db99a91c339b640511af79bfac30309cef70a8287e84604710392b2dfc6c0b,flooder,121623,457,939,916,1373,939
5644,a4df60bdbc8fc8e6aece8c21b81f9b08b0df8b929e2a75877ae1b8d225d22ec3,flooder,64863,257,515,530,787,515
5645,a503dedc3ab863f3480c5fe8d1beb899d48454c21d02ba677f6db467fde9be63,flooder,126113,470,976,1032,1502,976
5646,a550b6217ecd29ef1b8e2253e64f53c08e338f83677af582fc73a7a8bd1afb0e,flooder,126246,501,1009,1004,1505,1009
5647,a583fd9ce78be6d28475381b769c222b8b87770e297a8cf5e9db5ce664173938,flooder,117507,481,872,962,1443,872
5648,a60e6511f37de78cd9321200f87f70816f5a229f897109c491c38440b6ae66c8,flooder,64868,251,499,534,785,499
5649,a624de09cd949ae32b000990b37bd4c032d990ad72555d9e017003336d22e95b,flooder,126249,489,998,992,1481,998
5650,a68ac73b9f6a7e6d7894ef4280ccd43e66cc480112f64d263f3faaa5fd189139,flooder,126166,531,1015,1061,1592,1015
5651,a6bb6202428ce1d64fa4ee61697b9e707d243eb0645ea7731a9029fef08da37b,flooder,64869,257,514,530,787,514
5652,a741516f55315cdc03c4527e8420418fee50ebc350f93d525d4243b763fc8079,flooder,126196,529,1023,1044,1573,1023
5653,a79b3f20223c9a97fd5804d575563f6bccfa45bfa26e1f87af6b3b87a24c2691,flooder,126106,491,1011,981,1472,1011
5654,a8334cd20da273d3f66e00eda71ebb05462b579660e96712fb6893ab91ebee90,flooder,126105,504,1010,1004,1508,1010
5655,a858cd5535f0d1f0edc12ed8ed0aee1bdd93a4bd0c699a9ec9e1fbdcbebf6236,flooder,126122,509,960,998,1507,960
5656,a8d5052c101a16c9b111c68381afa25668a753d83363da65d6e1bd85b7b63763,flooder,126073,478,978,1025,1503,978
5657,a908cf4f3a26ff7fe1934b747368af2a40dd7423b237f68aa9bb0c2983500228,flooder,126139,498,1012,1014,1512,1012
5658,a9c5a91a3f50ff2b99b6e4cd26ea2d3957dc6ad41d69f682121d9415ecbf99e2,flooder,126043,489,1022,994,1483,1022
5659,aa054e098edf07b6f6386b4b40b4494143329d242e0bd990ed293953306f66af,flooder,126638,465,993,1044,1509,993
5660,aa13c60e1018cbca18851c3c04709454c2d1b3877ba08b0959a07917cdfe22dd,flooder,118276,499,965,957,1456,965
5661,aa1eaa1b0343ce5d4bca593fe862abb41115001b6f131f3f4490bbae06ee8b9b,flooder,126228,492,1008,994,1486,1008
5662,aa27aec1ab892da458c4e4b296655f1c47c60ab536e9192e3128aef52faa1893,flooder,126242,503,1019,992,1495,1019
5663,aa381fa909d8fab1a0ffd4c31c88857443ca59573a26da8987d51c840ced0216,flooder,126675,476,982,1057,1533,982
5664,aa548c85d5271f7ddc4854de198f8444ee0384ddc4f4f692f23336ec8ddd4cbb,flooder,126241,489,998,992,1481,998
5665,aa7b8e9c9163752a5a01cee9faa086984a705c17111f9200d728132761ae7262,flooder,126087,495,1004,989,1484,1004
5666,aa7f1c59b260bb61213bd1e0b43df39f6d0bfb8b8153be663752432c82d822e9,flooder,132019,549,1072,1069,1618,1072
5667,aa9479f1e2a26d3c5ed759069f0678672b02d998ea63f08e50ce033592c62383,flooder,130253,500,1053,1022,1522,1053
5668,ab2b64df1a124d3bfc9832fbe7ad5d94602aa750445de945181730d36a9fca54,flooder,126062,503,1026,1028,1531,1026
5669,ab726c2ce5cb0e7f9a7c845868342efda600cafc5583e4ad4c7cbe71c368cbd2,flooder,131035,488,1049,1002,1490,1049
5670,ab8187b44d6c4bcd3b9c17d9caa948d6db9c3e1453a408715c793016038517c7,flooder,126190,488,1010,1008,1496,1010
5671,abb33c5e7bd46345038fd6a7d3c4ae60926c003910aefde7222916cfe8d0db3b,flooder,126239,486,1005,1002,1488,1005
5672,abbb94ebef1dcedeeab6bbc93a4af4105052cca25953dff45a5d2bea3bd5fd13,flooder,126684,479,994,1043,1522,994
5673,abc909ee0caf6e621eac90d2a9089ebf2712887582b264fd7a1b9c2d7e8d6089,flooder,138728,527,1048,1139,1666,1048
5674,abe06c1e0f8d8a92fc21bb7fce69ee9216a7141ba64a16d5bb8013100f1ea982,flooder,130972,488,1049,1002,1490,1049
5675,ac22272a166f078315e925511b1427469d293f924650d795f562b037380c2096,flooder,130953,510,1043,998,1508,1043
5676,ac67830b0b2a3f246561245f9cbf430c5587446817dbf754bd66f3b1bb5280fa,flooder,126327,491,1011,1005,1496,1011
5677,ac88b8da356321bc0cc8b4fba1f2c1b768bf1bd36db8beef49368195feb08254,flooder,73265,299,600,560,859,600
5678,ac8f922a90740b6eeb6306a9c7602e28473650a03c6697a8375ee21469999c92,flooder,64912,238,515,539,777,515
5679,ad2700cb2d1a4b8ad0a7a9daef7396e99b08b5250cb3032e4e1e0c7a2c661ddb,flooder,126219,515,974,1005,1520,974
5680,ad3037cbdea26188e5da01f4d15c4a148de92751cceead786ba462339cd13fec,flooder,131015,488,1049,1002,1490,1049
5681,ad8b1be00db4d5813662421c3a8ad47d9ca420695065cb6300b6d4782670ec35,flooder,73703,333,537,567,900,537
5682,addb2aadbdcc24eb78db19fd9315d8e34be60f97f4ee279523ec6b1fbaa1c2d8,flooder,126177,510,1034,1005,1515,1034
5683,ae05bcd7b9f5fcc03dc86e7637226752b04add4e17db57267db6f51419908c2b,flooder,126093,481,964,1014,1495,964
5684,ae490287c1ac833a6e4a83896cb8b746b390a4b0a77c95189c24a96d9e235d61,flooder,126187,519,1007,1038,1557,1007
5685,ae4b3043348f18e1afef6a69c08493e772cf10652235c6f607274ac2b5207baa,flooder,126012,494,998,999,1493,998
5686,ae59152725139e2e5898034ec1cdead4ded94937b693f1f57979215d65ca80a0,flooder,130210,510,1070,1016,1526,1070
5687,ae5b08f02af0f19a10d4b6909640d4442a2f7de9273a35bd361b5e048db930da,flooder,126636,471,982,1043,1514,982
5688,ae9939e07446ec10481252de6a39422a447f96e7e8ebee32eaa01279ccf72e75,flooder,126038,498,1011,1014,1512,1011
5689,af0de1f5d35197a820667fd0df2af922f89b4c964c0f7d96b53d1b90c471c2e1,flooder,127496,519,950,1045,1564,950
5690,af239ccdbc5c9f68d971df301ba4e76f5e7241ea6b11e0bd1c3b6521d580d2b6,flooder,126021,502,1018,1018,1520,1018
5691,af49528ecb5a576e67ad6b10486284225b29f22acdd0acb2606863c8a35558c2,flooder,64883,259,499,546,805,499
5692,af7989f535bd4feba29ed0d364b3d615074c32a4e56a175f7d92e69948a0ebb8,flooder,126639,471,975,1040,1511,975
5693,af7d3baf8934fb494a685c0d913b580ee22cf4e508faff8a861504885bb99ab6,flooder,130984,488,1049,1003,1491,1049
5694,afeb5e30e1ac6089183686d59b00c523f10648f583c76de3f194ef4ac187ffb7,flooder,130961,511,1043,999,1510,1043
5695,b0679673936c2c85f632e8e9519a15542dd6da153bd664155363e8336e58120a,flooder,126218,528,932,1009,1537,932
5696,b0c9a09930ce421282489cf5eae0279e67bd98542d022a51050a7e56bcfd2f6a,flooder,64879,259,500,546,805,500
5697,b0f20fd244844b989f8c8659abed178b968a3eda4b4f6696f61658dd9804678c,flooder,54611,217,416,461,678,416
5698,b191e2129bd2e1e3ce656ad666bec42cb63e214da2e1437216dd5653a6dcf4c0,flooder,130968,488,1049,1002,1490,1049
5699,b1a84157d6bafc39b6e7ad36e8f570c59869cacd5f79f019107490df9fb454aa,flooder,125989,511,1021,1011,1522,1021
5700,b1a9f84e854209d557435e5f530a3fe3a80550fc44a4d9148ed312563c44b7e2,flooder,133854,502,1046,1101,1603,1046
5701,b1b0eed46d05140c84611e290f9cc3479ca4533128784429e7ceb0c8b1a183b5,flooder,73318,300,590,556,856,590
5702,b1f6817672e95aae84d78245664bedf9dd4043309513938138de2e645bb9c317,flooder,126060,492,1005,996,1488,1005
5703,b1fc617804644a0b0055f620e5e7762eda03fda5b170c1a7d1356b734239e46c,flooder,130965,510,1043,999,1509,1043
5704,b26bde2f669b60ea72535f8b3f8e26e67310ccb7b4b6b8a894a909de1722505b,flooder,127534,516,943,1029,1545,943
5705,b2b8a44b8adb73c3b3ead7691eff23c7b398e3bb1cd7bbd864fcf9833ee53401,flooder,126241,511,1007,1029,1540,1007
5706,b2ded64c9835e71fd5aaf42824cad954635465a9ebda193472ff6f72c407c0b3,flooder,64902,239,515,538,777,515
5707,b3076705aed8210e69ee3dd9705eddea734596f091ccbc0a6d26038b163d2c47,flooder,126238,491,1008,993,1484,1008
5708,b31e294289d37da9368fb2e57b3291e7723306b7117b26cf27605c8871bd9c0b,flooder,126279,465,996,1046,1511,996
5709,b36b38e0d2bb9c065ee180b0d1322c0538067b59024cf85b063c280b3fd5fb35,flooder,126118,509,960,998,1507,960
5710,b3797ac37a10a982de4f90b9f89a876dc4aaf3c707a1c189f21ec15a20423818,flooder,126005,503,1018,1000,1503,1018
5711,b3b5816c108bc9e4bb610e1200a4fae2c59c40345b013de5593ab47c9e36ed73,flooder,121619,453,955,912,1365,955
5712,b436ad61adce8f597caa3945af0b895ccbc3a3bf1880848c1afbb7b3b68b89b2,flooder,130949,509,1043,997,1506,1043
5713,b4bee71b6480b3f0875ecb151f1f93b91049f7441bc3495d4973a4f7dc32c421,flooder,126102,514,1010,995,1509,1010
5714,b4e4ea20897fd6b541d5d900a2a825bfb05b1c3653917c61e01a421f42e4accb,flooder,126065,531,941,1002,1533,941
5715,b4fcbd38783b1f2888cd44fc1ca8461b154fa78c32ddc84fb82d250e63422820,flooder,117511,462,885,962,1424,885
5716,b510fe789c5ea5e75a66a292d6f2f3f72f4809e728f7629d1559649a7ce88d1d,flooder,126049,507,1011,1013,1520,1011
5717,b53ca4801d24775d4b6f0bfd29d21b98f5c8bd8389b7abc62e6b0a77601c48a2,flooder,126013,501,1023,1002,1503,1023
5718,b56e45a1a23a9c90260a49735c2d116869620598e37d849e87b39f666d76c389,flooder,130992,488,1049,1002,1490,1049
5719,b588170e00b4428ea7d02384d7147cc0003f7440440e2f882448c75d1c46327d,flooder,126163,498,1002,1022,1520,1002
5720,b59d46379f9688134a37690618d0c1f392666d1ac33324fc02a150e2856b17b1,flooder,126277,539,940,1009,1548,940
5721,b59fae36b79bd8b1df96150f79cf961726285160dc3bea9d678aaf4e0892c304,flooder,126640,471,982,1047,1518,982
5722,b62c8c53df8e7e925c1140f489b60ca1b2d7b6b011f4e2577670c4ba983d4083,flooder,126657,474,1002,1033,1507,1002
5723,b64a4e886f24470477f838442e64ee06fd2fa9fad6da0b835499b2f79be36a9b,flooder,126055,511,947,1019,1530,947
5724,b6d8dc04f796ab2ff8e42827092cb4fa4e97fa314253cfe876d245db1a2a4572,flooder,127484,518,947,1034,1552,947
5725,b6e9eb504eba459d44c802d6903bfa0eb1c36a21d813245aa7472e0e5ce62e66,flooder,130995,488,1049,1002,1490,1049
5726,b70a49293b5d35b77cb3a81bd2df2504f833f62ee5bdb29406392caa227c7ea8,flooder,64927,253,524,522,775,524
5727,b732afc4c923809eb9b19ebffe112c12903e58ae93604603f97bfa366281fb2f,flooder,126260,503,978,1008,1511,978
5728,b832d9e4e9d7d8af5dd36e9ff9286dd3ba53a753900fa9581e99f9d032c51631,flooder,131134,488,1051,1003,1491,1051
5729,b877537aebb17d42fd3eb8fcc0125f6f2489e9aaaecc76a3ac6a188218c1a6f4,flooder,121632,454,942,911,1365,942
5730,b8784876b8032ac292054a8687e1774e1412710b3f30d1101c2719a58a692e8f,flooder,127518,518,944,1028,1546,944
5731,b9158ceed4595351bbae74d1b8d846e63a4d8a22ef9a279a1df6225ec66a5aeb,flooder,126299,465,999,1056,1521,999
5732,b91fc6dc2aad38c09139ee31959fc771a5c960e46fc111230ba3cd186d916611,flooder,125984,488,1010,990,1478,1010
5733,b98514018e496882e3fb3ab9f319ed77c1e4da3d976c05fba63ae746a909df81,flooder,64882,253,500,514,767,500
5734,b9a71fef8753e714b2aea83ef1f855cef00db64f84c7df9f97a80633ccc4b3c7,flooder,136902,521,1050,1120,1641,1050
5735,b9cd5fddb501dea02c8e8360c23f740d4d74fd3beac6b999d0c53e1886e5168d,flooder,126138,466,994,1051,1517,994
5736,b9e84013cce93b3b2e8d5c92c0bb5e00a79ad8f868a969f30079c0ce86878390,flooder,126218,503,968,1014,1517,968
5737,bab5c14ce7653cd5ffea98c08173afa8f0b82ba9d6b888c71b172517b63a8e6c,flooder,131039,489,1049,1002,1491,1049
5738,bb24e810edd25119ac9471502c4f75c6c885c59beba50cafd97ea8522cb10dfe,flooder,133227,514,1045,1086,1600,1045
5739,bb486068f611a2ce09039d7bfe40148b0bdb4b0850d21aa354dfc0443a334dc2,flooder,127448,530,976,1007,1537,976
5740,bbb8f4a46203eac5bffb1010ead424f69613ce14e40e5b61c6d5e97a1413922d,flooder,126040,487,1000,981,1468,1000
5741,bc2238ce1046adc92a2f85c042a8e07206b0d7a25d0e1d28632468cf612668a7,flooder,130956,510,1043,998,1508,1043
5742,bc9e404781754438fb8291d5939edabe9b5df3d57a57379bfa49c134172f6093,flooder,126275,465,996,1046,1511,996
5743,bcbe99a786f9c7eb61ab20b4f72b99d76230f1355ff1b4be460d438301466f7a,flooder,126222,494,962,993,1487,962
5744,bcdd11ab86a62131354c5c587238df074083eccd6e8836f4d74fe1212f501165,flooder,126210,475,984,1035,1510,984
5745,bcede19c8c7c06ea6597f90585d2568b8837541001056cd75f8b0f940e84397d,flooder,126054,503,1024,1027,1530,1024
5746,bd4281f366de1b248e076eff088388058fd46938a5c6eba31c0152a0cbfb3e01,flooder,126201,515,961,1012,1527,961
5747,bd5e982b449e1879fb25ebe9e8cc34eca830d2af0105406831cb922428c34ccb,flooder,64888,258,493,536,794,493
5748,bde9a25e266f6ac6dc86262c5dba03bb989fe5f7e7e91bb38573fa635755308b,flooder,64879,267,500,527,794,500
5749,be7cb47a5b43afe636c9936b24dea2c3b611a94c878529c11db842063e179d38,flooder,125977,497,1007,967,1464,1007
5750,be8a3ed2e7e24f22ef4f21873093c67e5bf156df317f046f610e221a5762cd52,flooder,126250,491,1008,993,1484,1008
5751,bea547d50d13da161e7118485248ca7397cd645594a3535d540ed7154da074e4,flooder,185207,719,1500,1475,2194,1500
5752,bed17ecf731c355deed224c2acc3e5eb5d2c95ee9033850ce7b8f6e06bbcc2f7,flooder,127504,517,948,1035,1552,948
5753,beff3b5c568dc7b8b4782af5de403e254fa10d54e8302987b1af071cb8972ead,flooder,126062,531,941,1002,1533,941
5754,bf0b6e7b946c38d3e47c45594cd9f96e7d07ffe199868eb51d9983f8af8c270a,flooder,130972,488,1049,1002,1490,1049
5755,bf489d78f48ffbccfcb8971727b37fef1ebfa6620942d256a183f0d1fe8ef80c,flooder,126102,489,1004,1008,1497,1004
5756,bfefd18a4ca91c1b21184ee28373b4902c949aca37b5d99665cb957303ce16b0,flooder,130976,488,1049,1002,1490,1049
5757,c005b2a8483d52c22f843daf039ebad87882ce4b99b3e9fe40644fa99a83d9ce,flooder,131035,488,1049,1002,1490,1049
5758,c0f5f16d5b6115f91ac55e584eaaaa8386556bd9c265ceba429c43a8cdd08385,flooder,64950,258,527,524,782,527
5759,c1c229f7d964ff09d4165aec4f472d107e8e9c4ad1e4f616dd1af510d87f1fe0,flooder,132386,490,1030,1093,1583,1030
5760,c246312bf6439c8f9816c361b043816783a261a90fa818e29a73821c0cb32930,flooder,126292,494,1025,997,1491,1025
5761,c2597a29fd043087545c2e3c6b3a564e1d9971ea0842022fa6b61a9d217ff880,flooder,75424,273,623,633,906,623
5762,c25d2d34a88aa076abd501467a1b553d79f87badb2460528c0209db7a3a4357f,flooder,126250,486,996,1012,1498,996
5763,c35a9275549283103a0f00427641e05d5a0b7f2f92a4f742f1e0f53531f9a957,flooder,126213,516,955,1006,1522,955
5764,c3ccc757c31e17564528bc6f1d7f5788ad92dedca6c52aaf4f40c3b5150d5b7c,flooder,126193,508,953,1004,1512,953
5765,c3f4488a07c576a558b6d7b3fbff92e339607951b960120239b1a7230453b51f,flooder,73340,301,583,558,859,583
5766,c4177a312442ec7337b1746686c1e8c464e7d0c2778352a62f2a545c07ea0e58,flooder,131035,488,1049,1002,1490,1049
5767,c4ed78bec00a3f852379052d87fbc8cc381d7ba3d6c551591a23eaa67bcd2f19,flooder,64823,265,513,531,796,513
5768,c50bbde0dcb9d305cfae30dc189e3d5ab52fde1eadbf59ca3f37e0ffd4b1d556,flooder,117487,475,908,954,1429,908
5769,c51e6ef06af1475e8e22978c75b2c57d9b8e60ac60172491ee9187046a0d498c,flooder,64868,249,511,530,779,511
5770,c5237b5d8ae20c5cc20443c5702becd90b6910f531e1fcdbc8e0b9f474636642,flooder,121631,458,950,917,1375,950
5771,c5319bfff01d0625b3ca06d7614d3291b2c7ae820fe2cfd7093301fa7ee38ea9,flooder,126406,465,1004,1030,1495,1004
5772,c581a7a0aea9fc432ff92d304edd6d5112ee2a4e829b04d5c918dd83e3444880,flooder,126161,480,1011,995,1475,1011
5773,c5adfc48ca47a9bbbf2c801b3527768325da4b3a91432701d5b6f0d57ee5c145,flooder,126660,465,1007,1030,1495,1007
5774,c5e4104fc0e82e1f4729a114cec90828c8da8a33925bb207f258872caac51451,flooder,126268,467,974,1036,1503,974
5775,c5e8ac74577071f139504ed2f2a6df927c229218f4ea4568ecacff25c72519f9,flooder,126184,527,1012,1039,1566,1012
5776,c5edb05aeb19be354af6faa198933407bfbfe4e49ecdbf8c0cd8b71b0355fc36,flooder,64879,270,509,523,793,509
5777,c5fb81ed417eaa798b4434e65874a76597dbe5e73fbc3d0be1205838fdd3b779,flooder,64826,263,510,520,783,510
5778,c632c06da53939768cec8542e188d9125e962c421e941398e35abc8fe11c0184,flooder,130957,511,1043,999,1510,1043
5779,c6376a04297b8c643ed61de78e1505b805a6f78c30f1bbd2bf4167002c8ddb5b,flooder,126236,499,1010,1015,1514,1010
5780,c653929267f0f30e1ff96b24b15e970685f35a0cb8b05f617ceb1ea84b3d9d2f,flooder,130953,511,1043,998,1509,1043
5781,c68f99effd920aed28bb01bc6459b0bfe8adfd192d01d8be2e3f0230826ea50e,flooder,126085,488,968,1013,1501,968
5782,c6ef79885741cb4d8756d5cf067c25619110add40315f47cf61f51d778797288,flooder,126642,471,975,1038,1509,975
5783,c714d58a95b563ea9999b362a58914e9cfafe9fff742a1f9d9d3f88747903850,flooder,126118,512,1005,1009,1521,1005
5784,c78207d5b6141e80ea187df0c21e87d5eec771f7fe3fc7845c43e17792377782,flooder,126074,507,1023,1005,1512,1023
5785,c7dea8d3c8e45ba6f7487637b632354caa17b5fe0428d27afed224938c4692a9,flooder,64972,251,504,516,767,504
5786,c84ef665a2e44bfe02eef11292a3bab19e7562c6d7a6519b5d54c187a5441ce2,flooder,126213,502,958,1004,1506,958
5787,c870851ec9cf7e06b876f14adfeafc7d089c7b58ecf361c70d6984b5c49e1d14,flooder,130953,511,1043,998,1509,1043
5788,c881dface84ca3abecd072cfed2bb5da2bded9a1b0f8ec85072db155d3b5daac,flooder,130972,488,1049,1002,1490,1049
5789,c8ce97d40cc6d647bae6dd1368ff440a6c510f3da40b7468f368a94d94dcb820,flooder,130965,512,1043,999,1511,1043
5790,c8db018a1b5e88d221f669764f1af794a919668b4b820d9241a37a2116476ec9,flooder,130996,488,1049,1002,1490,1049
5791,c8ddc867f0d81d018750c32cb5fa4826de8b9f73bc2799fd90558db96b79ac8b,flooder,126293,475,1015,993,1468,1015
5792,ca1ba3f75a169eb533f74cbe9e40b94a7cddf8931e469bfcef990afb23ee1302,flooder,126113,504,946,1009,1513,946
5793,ca36b26e05d8014d5b0737be38e20890f2ddcdc35f0bfbcbe3fe98c219285492,flooder,126055,500,961,1019,1519,961
5794,ca47fdb11245a83e7a065de385e6d3e3521c2315353195fe94a53d9eb103425d,flooder,126044,505,1036,1012,1517,1036
5795,caae9e6e177cf988746630fe1b42c7615ffca5e53331e82c300b07f4f80605f5,flooder,130285,490,1055,1018,1508,1055
5796,cab4ac438f3221edd6f102add23b1a305fcd640171781efe262062a95852291c,flooder,126066,488,1005,1011,1499,1005
5797,cacfc9077995989b4236f89dcfe9a5a1d2a087e9124f7506e0824d07c8eda041,flooder,135176,507,1057,1127,1634,1057
5798,cafa33dc009816dfbfcc23e5ca89993a920de0e3931fb91abff29b6fa634e15f,flooder,130245,521,1066,1029,1550,1066
5799,cb25cf78e6ce7217dc784861f049401df3445443c11a0a1ea5c34283fe7f5dbf,flooder,130969,512,1043,999,1511,1043
5800,cbf61211817d9b0a1613cad50a2b682d74070eaf83978fad8d99f3aef9246c98,flooder,126136,494,1014,981,1475,1014
5801,cc4ee0e69680302441df85f0b4577e27e9517546cdfc3148abce29bc733847a5,flooder,126692,470,988,1051,1521,988
5802,cc5963f04cb0ebb475e40364aa8d494461c4faf2c5bce7c9e85754f765b8f8f6,flooder,126191,490,1014,999,1489,1014
5803,cc5c1260b4189c9245f3840c7f41cbc752d95b6db045ac862e90a15ccdb39e1b,flooder,126092,512,1013,1009,1521,1013
5804,ccaa56b31eddad2569daa72e19f24d638a3a584ec2ee9995919029d4711f5a52,flooder,126071,515,949,1013,1528,949
5805,ccb7c1d5e3a6b778ed5484e5d7e40203843d5f148712f60d8828c184f8479433,flooder,126214,505,960,1020,1525,960
5806,ccf1e9905e689bba850576bc35b0443b8f6d4f510e3d902d8fabab32921f17f5,flooder,64886,257,496,532,789,496
5807,cd16a7262bc4d1836d7a0e469680e9e821f6db93fc9de85b8ecb76dc55603b22,flooder,121615,450,954,912,1362,954
5808,cd21e5f799764fbab8e6854972df878bf73ac0623d520a672e31548e6bcb06cb,flooder,133822,502,1047,1100,1602,1047
5809,cdc364c8c2ee0d4531d218a1edd747ef29fabf74240a7e796e7f43480ac84e93,flooder,126274,539,940,1010,1549,940
5810,cde336ce42e9a14d641bcf2a33bf822b913301dfa4ac455f6df58c6886b147eb,flooder,129551,494,1020,1064,1558,1020
5811,cdf0e12939d944091b59ca1aaf9146adb4bdca23bab138d46e380a36af47742a,flooder,64918,253,491,545,798,491
5812,cdff00cf9b6238612eeaab1b4b0d38b62cf68aeca2612905cde68aec7e5b5970,flooder,132018,549,1072,1069,1618,1072
5813,ce00bd0e64e350b74c9be5d42c042ae7712be882d44e21997e65689630008234,flooder,126070,481,964,1022,1503,964
5814,ce03a2ec097ea8cd739e5dd351cdc89e1e7a907d92a1c9aef6de46c689979eea,flooder,130976,488,1049,1003,1491,1049
5815,ce2b4e3afda6157bab411a59526da7dc5a454c58854933a6e3454dfc084394ee,flooder,126101,504,1025,1001,1505,1025
5816,ce7229aef317e76a712cbb7a484d54364d8d1b33cf0055e61079ca34c3de5ba4,flooder,126012,484,1003,1002,1486,1003
5817,cea5e8e086bdf7ba5d61bb5a0fcfe9ec0feb9c8bbc3c1770b89b2e57f941e8f4,flooder,126207,489,1013,992,1481,1013
5818,ced2ca49a0cc01323f51c68fb609ed1abc3efac8f13e8eb14f3b8aa376ba51ce,flooder,126051,486,998,995,1481,998
5819,cf9eee7dd3bb9415efb0c4df5a9f52934b7efe32116fb9a31aa33a81b59d0a64,flooder,127500,517,948,1035,1552,948
5820,cfe9105c348ceefa1a05349491a61cfe35ddd1ce6c8354616571e375fd9c902a,flooder,127508,517,947,1036,1553,947
5821,d064f2320c3552ff4bf213f7e01072b65f746d245225d8bba90742fe652548dc,flooder,121582,470,948,910,1380,948
5822,d0a2bca6e2f28c03bc7913861fc0a1c3cf06e4b9241794b558342f9c4cbddc41,flooder,133842,502,1046,1101,1603,1046
5823,d0ac8a5d0b644f64c4d5234de5128747b71d538572c4d693e03a23afefa60239,flooder,64904,243,506,525,768,506
5824,d0bd5271997e87f0a7a020a8ddc11cef5aa4cf1453943c6acb0ba24969cfcaf7,flooder,127452,530,976,1006,1536,976
5825,d0ce9d9dd300046ca7984eeb82fc3fa91c00e7ea3103c3db4a678d3f4e916737,flooder,130949,511,1043,998,1509,1043
5826,d1a771616a5bd4689493d00b7c4e20a28c7d71a5093f8910f5ecbf69af90b2a4,flooder,126028,531,938,1008,1539,938
5827,d1b97c8e6ac2511bb9984e5ac13d2ea855ee2bd2da21de6a3b6a8d4df5514a2b,flooder,126124,497,1017,995,1492,1017
5828,d1dd5ae574433784a6e2ba92d675afde1059e068eb68d65c8beac8a4a1436473,flooder,125917,491,1000,999,1490,1000
5829,d1eb0a2967eab644cc6e277b7911f636b767c48dca80e4fc878d1c2674598327,flooder,126065,514,948,1002,1516,948
5830,d20452fe4eeb2824bf37e7bcbaeb3e9ba66760aa8a5f5854ceb9ce77087426f5,flooder,130980,488,1049,1003,1491,1049
5831,d2456f68138918ce6f32aea750d340aaae3bb2c6be8cbf4eec9498a65e1337e2,flooder,126198,507,958,1012,1519,958
5832,d28afa43ef1636b72ea89e79389d867713b197f45d1c0fa0205677976613d4c3,flooder,126638,471,975,1038,1509,975
5833,d2ecc42204d9f23029554bf3b14e3142badafb999dc71d3456b1d55101575867,flooder,130945,510,1043,997,1507,1043
5834,d2fe1fbef8b8d010d456279f80546a4fbcef55b214fbf7ca56d2343c707ff99f,flooder,126064,497,1012,987,1484,1012
5835,d3155534c9b4f9919887be708a2478426703dfed71c6a71a6ca8b6d12e9650c1,flooder,64866,270,504,522,792,504
5836,d4082353bb48fa1bf3350c4b4e32c6e4056b6282e88d57b737854e0bb9ce705f,flooder,126638,461,1011,1048,1509,1011
5837,d42c880f801dce09955ddceeaf52208b4b71050d3d022bf109ecc09b490eab63,flooder,126669,471,992,1034,1505,992
5838,d5a5d29a86aa8733d58921fc733fbd2125c31c2f02fb91a490ed1434f2fa7262,flooder,126157,506,1018,1015,1521,1018
5839,d5b6bf39b367e1a136f7e978932a99603d704849b9fdcfe61db81e4013604b04,flooder,64867,251,499,534,785,499
5840,d66ef852d0860995f0360f4b1acb4c85d3c2f87dad0b3a0edc2a12fbc65f033d,flooder,126058,495,1008,1008,1503,1008
5841,d68390fb868ee508e1aff66c8257ab3ab852d24bf998ae14c5ca11eebe556d9e,flooder,121600,443,940,909,1352,940
5842,d687d51c3aae2aed8cceee22a21498c246826bbc81cb1870bff10a7d3165c747,flooder,130957,511,1043,998,1509,1043
5843,d692781d94e16b54406b90f49eb62ba875d164ab848e9548e1dcc584f596a1cb,flooder,133846,512,1029,1087,1599,1029
5844,d6b7c0b93342c43da8305404e2edef939a12796f6e1161b861cb13cb7b16a07c,flooder,126477,474,993,1051,1525,993
5845,d739bfeac210a7ad957f1d6b405e16d3be37c31c570b5b3a4c5a5581dfa2231e,flooder,130996,488,1049,1002,1490,1049
5846,d75c5ccaf823852d1f8f067095047f2164b9dcf73de6deb7a7efb704b3c1bedc,flooder,126640,472,997,1039,1511,997
5847,d80d92bf8848cb4486964702a3237b67d831b9bfc5e96ebcd295737b4b6fb969,flooder,126208,484,998,1009,1493,998
5848,d81598e21c21b48549734c5658035d9b7e16768d978f1f96c85582ffaec66f8c,flooder,126185,511,970,1007,1518,970
5849,d836e0a06f6ac7dd70eba7e1e37faa8a36fc00a8bcaa68c0df5969c9615f66f4,flooder,64885,265,519,541,806,519
5850,d83e66780a492be9ccbca954e9837686a6d7375b5b8a07755b2a516de8f1b089,flooder,126296,468,983,1045,1513,983
5851,d84886ba18c2956f706f611ded27754652291eb728f61fbfee08bfdf841b536c,flooder,130968,488,1049,1002,1490,1049
5852,d8a6adee749034d76005fdb8a4af433da1065705530e65167e6541410139f06b,flooder,73285,296,581,551,847,581
5853,d9223f09f57154a51231df63f664378dd09da4a9c6b5e03c04832677bd9d83df,flooder,126031,499,1016,1018,1517,1016
5854,d9258fda0e40259ffeb36e1d54d86a4e8fb142bd56d697dab5e28ff5ca0d2719,flooder,127504,517,947,1035,1552,947
5855,da5bb4f9c9114a65a978262f95c71ac6c6a22e736af60bd9191a7acf5680de28,flooder,130953,511,1043,998,1509,1043
5856,da5e39439f30ef3c7a9e84156c36e43aa716a97a9c100b9e016a4543a6204532,flooder,126167,524,1009,1030,1554,1009
5857,da9975f5f5f39882a715119b318c7d3fd0a0372abfe284c141ac889e29b119f1,flooder,64824,247,514,522,769,514
5858,dac458931fa3617a49049c3efa7cfe2325834e19a249aefd3cbdc574dc024c9d,flooder,126449,473,990,1037,1510,990
5859,dac4fbd2f94146e940c4019abfd3193fe6f78466f6164f1ffedbbd1e3a2fad26,flooder,130976,488,1049,1002,1490,1049
5860,dadb6eb06ac04f11144aeabaa670fe20180d3e60d1355d15045ae571cf16e3f5,flooder,75448,273,623,633,906,623
5861,db772eb0146eff2fa1cd7588ca6b6c056e8b568c5fbb868851874969151619a6,flooder,126134,498,1025,1004,1502,1025
5862,dbc5f094cab3c2588f66f36146324a79d1181477a467499760f50369c0c8a4f1,flooder,126211,498,1020,1014,1512,1020
5863,dbd3b27501c2bd0bb3390e299a01596920da6c16a719cac6b926b3067234ce35,flooder,130957,511,1043,998,1509,1043
5864,dc3f5a5d2abb443abf69b4ede761835799380640c7f8854d3370ae8abeb33ed2,flooder,130984,490,1049,1002,1492,1049
5865,dc87b4608081a69a31fc4b8cdfe312f14bf6e8ed26dbbe43d31dd894e378d345,flooder,64820,247,514,522,769,514
5866,dcf92c1ccc33ffa9ea28e30e650c4b47cda4b0d55ba869e649e7462b64209f23,flooder,130968,488,1049,1002,1490,1049
5867,dd0a91c0d8e30d1962d72171823cb6a0b0432aae9bf0bc88084832c0528bca15,flooder,73339,301,586,558,859,586
5868,dddec41f7a3d79916ba8937fe25232c671c38dede6257efa8deccdb39e17ecf2,flooder,126315,496,1003,1008,1504,1003
5869,de616a51fb82af64a3e71ae8c46f956e5da2bc9e6cd2d7295aa5a2a12a688e76,flooder,130944,511,1043,998,1509,1043
5870,deb0b700f27ceacd4ebce78b4fd88816a551dbc07281c6a7efe66946eb41525e,flooder,75391,280,602,623,903,602
5871,decee623657ea72b32bdaa8c071c2ff44045db8012bf26df398fd92f450c8acb,flooder,133854,502,1046,1101,1603,1046
5872,ded1d7dd30da030cb4d7b5aa3b100e7c92548292e05e7218e1b7506433dd154f,flooder,126637,464,988,1060,1524,988
5873,df1c08a82e9e4050eb633bb7b031a994da6f3532dcd037a940f691b7bbb5c035,flooder,126162,504,963,997,1501,963
5874,dfb1a6723fd4f8d6b5936b25d66f2db630116f76a4cf3be5a01202d8cfc992ee,flooder,126279,464,974,1053,1517,974
5875,dfb894324004221a35b624ba6b455dc5f1bac0310fbb0b7832e05d247afc6ee1,flooder,120870,506,946,997,1503,946
5876,e0896d39709f7ebaae79458b378c83c28d37ad71ea2637f25eb0ce2f122661f2,flooder,126072,515,949,1014,1529,949
5877,e0af860a19d6a7970333ba9f09dc08d6ac9c68cf29b9231d754c2028da908796,flooder,126021,506,1031,1014,1520,1031
5878,e0fc11442f9bb70f09f0ca608b1fd1221d2a22a850dabd9cb7c6eb010af04152,flooder,126285,498,1017,993,1491,1017
5879,e176c7fbadf83cc68c7dac8bfc9714c2c029151ec8377110b1821b3dca2275be,flooder,64840,252,493,534,786,493
5880,e1a0332b55e92da051c48001c9b8fc913fdea0b1c3350cff3bbe134291d3030b,flooder,126641,462,991,1053,1515,991
5881,e267f2034f938627a32f5f956b5aa4e805d0f95cae9a35df3dc195f9b8ef03d1,flooder,126181,504,963,997,1501,963
5882,e26c807c8e5d5ba8b41de497a24da81b8db0325a0a2c64bb04ee7beaae12904b,flooder,126039,500,1025,1024,1524,1025
5883,e28b131bc3e65e296fc3cc4a9f83a795f0959e1f5ae08fa05ff9a56677cd5503,flooder,126313,468,982,1058,1526,982
5884,e2aacb6bc990859bafa322832d7d2f52cfdb48582a749a832fa4385f480adcd8,flooder,64891,257,510,518,775,510
5885,e2b36a50ee58b60c7a67c1b3988e97f7125a39cceedcdb8b95bde7b4cc940d33,flooder,126161,510,1030,1008,1518,1030
5886,e2c1474b48ac59ebe6a42f8fa6b97883e18d770c9a36a2759ee84d121f1cf734,flooder,64875,258,527,523,781,527
5887,e2ed460c9368e57c50beb4b307033027905385d92e0d9297d4e8cc763c63224d,flooder,126262,489,1013,1008,1497,1013
5888,e31e7cc4ecb2b7b4ca2cca650a76c58fa3ea12483c7b87fe8cd3e99044dd2e1a,flooder,117460,471,902,969,1440,902
5889,e33ff0f51903c78a81c52d6ff2471c6fef4dab34e563fa30f6c6338593402614,flooder,126027,498,1021,999,1497,1021
5890,e3cdfaa149a4fd28550f1291a7837682c70e5f9d50fcad3de323bb6dee3f40c8,flooder,125993,492,1006,1002,1494,1006
5891,e3d8ce6cf605dcc6cef6507a905fa7d966fc81e11d254be2a84dd522bb08dbe5,flooder,126062,511,1012,1004,1515,1012
5892,e41844b26fc97a82a6219116105c90ba4d94d93da8923df751be983f7ad2b384,flooder,127496,515,947,1034,1549,947
5893,e4d119fcabe7e951090634b6c11765c36ad7fa306498d03094f3958f6a34c1db,flooder,64827,258,520,530,788,520
5894,e4f24b0174264cff4a121ec26e4ddf7a4677d8f62b757b5ddb1610e159df45f6,flooder,126053,492,993,1002,1494,993
5895,e50fc9dc701f248e6187e198f2be2c08b3648c38c417af13b308d81a9b405889,flooder,126170,517,1015,1003,1520,1015
5896,e5aa0dc26a61434da6c59640eeb9408501e81e7f4697910c2ea61ad2319b1a9a,flooder,126148,509,1034,1005,1514,1034
5897,e5e1e18961984d2dab07dc73144b3c37ba581b50178e04b723792dedd7409e1f,flooder,117511,462,887,961,1423,887
5898,e70902bb9dad5d0258fb7940ec6dcc040227e7ca996052b72b19027977f55229,flooder,126162,504,964,997,1501,964
5899,e7236d7199c6e0c1caa44d2d8475dc1f636b222e4e8f9f084ba0199ce94d0697,flooder,126274,488,1010,989,1477,1010
5900,e7652ee7e70a2f1c40a424e99d8041b651a6c28f5076443536698986f1ecbc11,flooder,127534,516,930,1046,1562,930
5901,e76e61a3b8d91c13a265282e9fff7ca5ba9140d6db1ceea67bbb979e87feddad,flooder,130953,510,1045,997,1507,1045
5902,e86f60376b0a6b70ce62a433c579ad8d8d5d5bfb88a636d7c16d3709cc56e9e5,flooder,126006,502,1030,1013,1515,1030
5903,e927a56e80af363e4e8983c729412e3be7616d17cc71f41d39a77f967fcded50,flooder,126165,514,1025,1020,1534,1025
5904,ea10b78b953fd585615d5fa12842ca957d09dc77d1bddeb8569a0bd10b68f1cb,flooder,126241,500,1030,1008,1508,1030
5905,eabc82a2a841b15c977f605c8d0704a09553c44484141c97b783044cf9e425ee,flooder,126213,487,1021,1007,1494,1021
5906,eac15fa5972f42aab7ef30a29bff832ac7829854989f0ff323a20b38dda84afc,flooder,127534,516,930,1046,1562,930
5907,eafb03439e855aab50ac17e5f90baa8de159d57ac7f3d591767e7ff64f5d032c,flooder,126098,484,962,1010,1494,962
5908,eb073b06ea439f04d9f4e97bf51e73d30366a607fa4034601fe0fbca820f6172,flooder,126164,525,1003,1025,1550,1003
5909,eb5c364ef45b9ab530c44183d3c98fe1956ed290e971e8081867fb16d16355a5,flooder,126142,497,1015,1010,1507,1015
5910,ebb262cbde91b5d5fb9622619f5409d4147fa4f1208aaef711738d3c9f2133cb,flooder,126648,465,1007,1030,1495,1007
5911,ec17f703fe1384bd554adb5fdfd8a1bed04c23ea91151d543d37a48cc11d78b5,flooder,127508,509,939,1030,1539,939
5912,ec19b352dbabcf001a8f3b0cbd1e3c884682dc2f2cb2a65360aebea5864490e0,flooder,126406,470,986,1044,1514,986
5913,ec591bda47348ad0be1c66f164ea807baeed1f70e2b3114d69b62afabbc89766,flooder,126642,465,1007,1030,1495,1007
5914,ec8aba648512f05a5fb3aeb5fdebe100911f4c5bae23867fdac05bafbe339519,flooder,64915,253,491,546,799,491
5915,eccb85b680dd1d60fd58472e3e99a4d50c5b47250845f2ff243f9a6482495417,flooder,130957,511,1043,998,1509,1043
5916,eceb80c49671a259b9519e965d46258ad0b6da3c18dd3ba9af0afe5e809cbb53,flooder,133855,502,1046,1101,1603,1046
5917,ed78a48f566ccd653868546532ea94d32563cd5fb995ab1c41e4ce72f927b17d,flooder,121631,451,943,907,1358,943
5918,ee2bbd0e95310690a86a70b5fa0700761bb43a410ba4263e5ae48bbf7b816edc,flooder,126251,486,1004,1003,1489,1004
5919,eec2556e67b5dcd3a7687a8464cb3232532912bc14f22748781ed9d4487284cf,flooder,133813,498,1033,1085,1583,1033
5920,eed89e90f887e25de539028461527c47e822291198715d9769faf362ad6089d9,flooder,126244,489,1004,985,1474,1004
5921,eee5e47326ee0b6b60e86c28407f4d8f7f143107fb3f29fce5bfa3b5f3aa3011,flooder,130953,511,1043,998,1509,1043
5922,ef60e86f4de492921f022638f9b52a33f8a43fed2eafcd2fb71502ab1b64e617,flooder,126043,546,916,1020,1566,916
5923,ef78b725c5ed9c59086683e43623b56273491bba4bd260c1350afd7156e12164,flooder,131122,488,1051,1003,1491,1051
5924,f034fba0a593834fa165fc3901747f0e753cf26d4c31b8d0dcee6298f80a172c,flooder,126641,472,996,1040,1512,996
5925,f0445d53ee38da1cea5c5b256ee882f6fdf06860cf20d4f5829265c85c559548,flooder,131043,489,1049,1002,1491,1049
5926,f0a225df00624dc6493b9b44a271dcba2cb6278c50d0fbde10cb7bc776213da8,flooder,126210,490,1013,992,1482,1013
5927,f0acdbbf4aee9d8d91f2b996f9cf228bcb33a5d68c6810901a31b5e3109e88ec,flooder,126155,500,1026,1009,1509,1026
5928,f102425011c08d98d7d0f26fa65aebec3f5c0b14de7abde151179106b0e754c0,flooder,127510,515,930,1047,1562,930
5929,f112ff79a6f8fb289aed3fc847a182230cc7d26028f3b45b51fafc686d50edbe,flooder,126031,507,1012,995,1502,1012
5930,f1189520c92a1fd30bedb78b9d7fadc2d40b4277c51e61a84a7644cd9d65df73,flooder,126219,521,970,1006,1527,970
5931,f1397457e8d05b5af531bab2472056b84f02fe96f954661b8a3e36c8cc448fad,flooder,130961,512,1043,998,1510,1043
5932,f165bbfa8588be8c1a4ebb9a187a7ed9d83df678a1bf5ee62ccc867784a40548,flooder,131095,489,1050,1003,1492,1050
5933,f186c73612ba3d58d507185808979a2cd2966624b1b81fcda880c88c0d51fa48,flooder,64892,253,492,545,798,492
5934,f1950c8dfc521d295f6ea681527f9e47447eb7ec7ac2f689b7bbbdccb213b97d,flooder,130949,512,1043,998,1510,1043
5935,f19d9acde366144a9fbc6c6850ed2013bfcc93c8d274f22454ccb8cf880d295a,flooder,126117,504,946,1009,1513,946
5936,f1c0e1c46f247117458efcb12386a60a3c5003090a18bba1aa0ea679fb9c2192,flooder,73704,333,537,567,900,537
5937,f21eff438b22ea903023ff39ac952b2089713f0becaa0470a167cac965e4d833,flooder,64897,263,511,522,785,511
5938,f266cf8882ef8e3ead3a6891b46f2ee45699304f350fd9f6c3d3a07e58c37b01,flooder,64924,253,491,546,799,491
5939,f2a7572b78e2cfc4dc9a24eaa00b303c61a50b3dc6aa19d988a9a4e5cdaafed0,flooder,126103,490,1003,1005,1495,1003
5940,f2d45e1c92a8ed2a24bd8c066a5c13a9ce7d1f0a8176fdea0e6a8175c1dc1ead,flooder,130957,513,1043,998,1511,1043
5941,f33475411755e3914f3c0ad3e6b0a2b305c06991d471fe8b6d9cc4ed0a900acf,flooder,126046,531,922,1005,1536,922
5942,f33dbf063cb7b917796c39ee2f1117a757c3320255dfe0902d4d6d3610bbf9aa,flooder,64912,252,518,522,774,518
5943,f3a4c9166b1f636948b6dc9f9451d8de6ad1a882bd5850aee0942cd9a0b35ecb,flooder,122824,493,979,1021,1514,979
5944,f3ae8531db07d588ea63d6e80a68db2a5f0c32fa2f8916d0233a490b0307ab29,flooder,126620,471,991,1045,1516,991
5945,f3e33c8866b2103f8ee954a83ef1c61762a959814866ab0c4aeb4fa22847bca9,flooder,126276,462,999,1054,1516,999
5946,f443d217789ad1429d2ffefe173001b7a69acc81b287c7a08d49995189007d6d,flooder,126124,508,1022,1004,1512,1022
5947,f50ccbfc7b9847d158e8ade1304c3a7283dc100546e79936071215f3a143234d,flooder,126223,505,954,995,1500,954
5948,f5839bffdae0c1762ea7e900a3aebef2149cb47005b100f377c7cf1c10ceabe1,flooder,65074,248,490,512,760,490
5949,f59a12c2bf2ee2a65a56cebf2f1d5463e8a98a7f0c3bd0f2f5f708ffe5c6ad65,flooder,130976,488,1049,1002,1490,1049
5950,f69c093c4b64705434a93e2194cce12f30ba5d786cf195140c83fb4b76a8ae14,flooder,126244,486,1002,1001,1487,1002
5951,f6a1272af802d1cc6a023228d983076d578e7ce8f9ddd6de752dde94b3025306,flooder,130961,511,1043,998,1509,1043
5952,f6d92ab8acfd3d51e0ddc18b8a96f0ad855caa212c95635564b08b85eff1037d,flooder,126250,489,1017,1006,1495,1017
5953,f6db943017121d89ad648c366c4e35f151003a08065d629d9cfc720d47a20af5,flooder,126296,468,983,1045,1513,983
5954,f6f346e7b823c6f8359ea6e432ec97106260a623eb8c58bde9758b7d0ef9c4da,flooder,126156,520,1009,1041,1561,1009
5955,f7a9e4a5590a35adae334d442a918962e8b71474e9ded8639b354ddcb3c014ae,flooder,130208,503,1063,1020,1523,1063
5956,f7ae7fdba7091bfdfa9414741437b570f5628a9b2131c9cd6149618d447c6d77,flooder,126184,510,1015,1011,1521,1015
5957,f7f39aa6980b8b3b62cb5fff466c07590a4f58d75bd4656811df0624ae1bea9b,flooder,132023,548,1070,1069,1617,1070
5958,f7fb8e97ac472892d54383f847038539c710d857ed42186e2837eaebccb67686,flooder,126273,494,1015,1006,1500,1015
5959,f8e5805933446706d0a1cd4980b9520a3b069d6f7528fa02fa27332cac40e5f0,flooder,126051,503,964,988,1491,964
5960,f8f21e5406f5342419ad7617befdf3cae946c0f662f603c5b388e965269f9de4,flooder,126028,529,939,1007,1536,939
5961,f928831029e23d58c1a59bfec3ed25d59c70ab705ded5bc2952f25b631ef5fc1,flooder,126248,492,1019,987,1479,1019
5962,f986942e6883718bce7eaec0e339fbcbb1dd706eee82de839e8b36625e77e7c8,flooder,126153,504,963,997,1501,963
5963,fa153106e66bff81219b525e4e1a196fab761d998ca53a1aa78bc3ecf1a067e0,flooder,130980,488,1049,1003,1491,1049
5964,fa77ac5ea85d2af72befe8c14159d331871242d4da3ef4c950275074dff486a3,flooder,126048,480,1002,995,1475,1002
5965,fad9fd0144b9f91e96eac7fc3208082a07bfe91ca9590d19e4431908cb57b704,flooder,130968,488,1049,1002,1490,1049
5966,fadfe123d1449f87ca98c853ad8c4f72ad0de526481f726e5da17f1592769b61,flooder,133836,502,1046,1100,1602,1046
5967,fb470a537f2058343aa5dda7224bdd765a304d634d27f173d309739afdcecac0,flooder,130984,488,1049,1003,1491,1049
5968,fb689696e16d22d89310badfeb278ab8e32a4b09364732e973e8ae2e0e5bf508,flooder,126240,490,993,1000,1490,993
5969,fbb75ada038cf46b3d7290dd7c1a97d672acd8aefc886b47a8fa2a91e1cc9450,flooder,133223,508,1037,1115,1623,1037
5970,fbc3fcb0e416f927bfa1490d1cec0ef33303a576e2d4957dc00e369b6b627684,flooder,126230,502,1019,1001,1503,1019
5971,fbd9762a4cb2adaf980482b5a2cd8cef77f446e8731dd96f5571c707ac087b1e,flooder,126086,503,1027,1028,1531,1027
5972,fc0e1a0980301f30c75426110993057df40e81ec78533cb94f7e0eee59ef82d2,flooder,130981,482,1050,1010,1492,1050
5973,fc2c7c5d4230a2f69f20a4d623e26292fec13fc57fdfedc25a446179c6bb0237,flooder,73290,301,593,546,847,593
5974,fc351d8a278a0811135c3d5f212ed3f9d52681e0600c4b1ccd7abcb325351d0c,flooder,127500,517,947,1035,1552,947
5975,fc6033437b2f8372b3682261e5298b0aee0945626b5011a2a997026db5d090a2,flooder,130980,488,1049,1003,1491,1049
5976,fd0fcd16e245092c3e406537501110f80cdb3374ebc5a6628e4baa43d2ff8f05,flooder,130972,488,1049,1002,1490,1049
5977,fd6446cebd56b76b13496e74065617599fd1aaa52988144ad90750e5f4c0ba65,flooder,126024,529,939,1007,1536,939
5978,fda6ab61eabaf32a71c527c5c04ae35f844e1899824deb1774a45c8480b88eaf,flooder,126050,527,923,1003,1530,923
5979,fe129f94a351b04fb7617686c4aff7d24ccf68c64ad3df48a7129fc1cac3c6b3,flooder,126222,498,1007,1004,1502,1007
5980,fe1c01596fd3a13326e31efddda9c8313e3d1682f3315064ed837220b5923ec3,flooder,117401,471,910,960,1431,910
5981,fe6ca3cea8d2c2fde99270433b0a8a84e68942a85444fe6ad863c9262756a4ea,flooder,131115,488,1052,1003,1491,1052
5982,ff4acf4a4959b0bfc61b4bd6babb29d2c25cd21c739a4f8f9f1dc90f9827ab7c,flooder,130944,511,1043,998,1509,1043
5983,ff596d7a93571c4838907680bf14d095cab1b9e0b3b92a498fe28e3b364b6386,flooder,126612,473,990,1056,1529,990
5984,ff85daadf6ba99c6bbc01a6dcfed8bdc1e325f2751b52722392712aafb3a35ca,flooder,64955,259,512,533,792,512
5985,ffd134217b6ad63f348c9d61df9bb46faccc22837c9c0f8540ae4f16d697bf06,flooder,126057,514,948,1002,1516,948
5986,fff4c1820195fa97ae7dec13ad8ed13a9909844455a348e0ba0b07b4c432ddf2,flooder,132018,539,1082,1051,1590,1082
5987,001204ff2459d531c2d7704c16ad9f9ced4e78be903c8accd972e572f4d69698,installer,280102,1119,2210,2174,3293,2210
5988,002371eae1c10346e51827310e5caecbf7f4d0d9f133323cf356e892a8119065,installer,3320052,13683,26733,27229,40912,26733
5989,00921741dbabc618bdb09ea62729225dc466655712f129937f3beb5ae9a1cb1a,installer,312474,1154,2474,2665,3819,2474
5990,00a4d65e2825c60e11e5b5f6c580f658caa62465aef4513140372574c5bd635a,installer,721967,2836,5724,5616,8452,5724
5991,00bd4967b6a47243fe824523b1b917484f033c7ef7e1f680fa632a1f9002d6df,installer,975014,3945,7560,7750,11695,7560
5992,00e2e21d45b1a8289688f3c2ab63eaaa0dfa74c8cefd516453afd16abaf1402e,installer,568497,2255,4393,4508,6763,4393
5993,0155cd2e6841a735655a19d57433ce14df68fa799ffdda4ce1bb372bd7c5892d,installer,503558,1978,3828,4069,6047,3828
5994,0181a7d11491774d142791dd5a51541a999e6cab787911cef3f27e5f9ea6bf11,installer,974617,3925,7805,8027,11952,7805
5995,0196c4bd85368c8091153f71c14527a6bd7dd5ff133183ae4ddbbe548e86ff5c,installer,562984,2266,4615,4434,6700,4615
5996,02058aa4e8a0e7698a0c2c47cc8dd751823096628d9c98bdf2912e587d0b21b7,installer,568799,2115,4451,4560,6675,4451
5997,0241e10e0b6e309e6d328d4ef95f494e2a4411570d5d68d79316d7d9143b3b85,installer,548381,2079,4252,4271,6350,4252
5998,02bcea14d59c0800db3ed28f7b11f2ecffd7fd48ecddff7e15d507655bcc2a6d,installer,94770,338,757,816,1154,757
5999,02c2cea2e14c2a0e6a22265bc3e76acd706a35a88385dd29b1a503d6405da7b5,installer,854213,3447,6767,6566,10013,6767
6000,02d44de2acc51611e36feb8660b09b6cb703c650e51bf35ef2d4f0eab615928f,installer,523076,2099,3975,4219,6318,3975
6001,02eb73a61fcad0e06ae2e84f107732aaac54f9dde2696bc5ab95da159a29db11,installer,638773,2544,4932,5237,7781,4932
6002,03448019c4afb9adf183f37dc5fa40f50055707eb6bf48f7d60d951f2758ffd7,installer,271992,1014,2109,2160,3174,2109
6003,03c3a8b4b8a3edb5824070dfc3a65668bd5f80262450d63ce1b92a3a4342c430,installer,286697,1169,2249,2288,3457,2249
6004,03cdaa509b768066fe92dd3792d265e5f8bc8560bb741d5c8cf1d02a4ba8a582,installer,563039,2231,4364,4417,6648,4364
6005,043e356fe4f6d58c7a0bc48fa616c818fce6122da50795bbf96422bec2850c5d,installer,1093613,4474,8914,8941,13415,8914
6006,0485a6081d009f1b7e3e479c0f49b10b7c10c77d1f38ba21a7ccf4afc5c31cc4,installer,333164,1276,2620,2608,3884,2620
6007,04e09844a6791c31d210d6fac8d6e66f745f6c0285e20101abc7a5bcd8bb985e,installer,1011607,4040,8148,8375,12415,8148
6008,0564dbdcdb162566803b68e8c124c6b7d25afe6eed017c69a0018b2b8e3c90aa,installer,2950920,10904,23902,23095,33999,23902
6009,05b8bf1b29078e79761d9dd12f95b8ffa48e8736317c4c32c0d2d9da1c79c248,installer,286511,1108,2294,2260,3368,2294
6010,05b941c84e9cce0b2777d3d24cbb4ebade0b80802f9b9cf28124c38d6b607bc3,installer,107712,426,857,869,1295,857
6011,06b91ff0f493a6034ff0c7b9ea56e391d29a894ca18179ebe457635ea95e6eb3,installer,3557525,13636,27622,28780,42416,27622
6012,06cdac73f22ef8ddcdbd27cfcf93525d5967ae21ecc255efa5687215efbe6e83,installer,809168,3104,6268,6470,9574,6268
6013,06f6b2e82c4640d8505a51937adeae4eb8a6b2eaf5181b6f00275da8ecdc722c,installer,801635,3131,6211,6480,9611,6211
6014,0755e84355ade95dd5c154fff32b1c1fcb21a3e1787c999bbc28e3d77fff2783,installer,563031,2180,4409,4322,6502,4409
6015,0783b5dffc6a13ec806cf6588470eb0ba50726f45dafc914a612ff6b2e878e7b,installer,870425,3403,6855,7147,10550,6855
6016,0794cac29ae81ece763bee53eef911a9ed03dd4e55426ebef12f50a5ac9f0e12,installer,722640,2864,5606,5827,8691,5606
6017,07bdc67ac84400c6bfe0b5c2352d3171b1caa9cb4183bb47e141ea0c4a0d15fd,installer,503561,1929,3851,4062,5991,3851
6018,07fad8de3e306c6860f01f4112752d011276761cc27effb5b149db8361946271,installer,1089876,4401,8699,9042,13443,8699
6019,083f62fc6879df25178e35528a4739e2286a1d48c5fe4371263c6de9ab44f228,installer,742847,2989,5709,5896,8885,5709
6020,099fbf136084339dde053fd09f83a60258285e0b7dc88bb33effe515fe78f4f4,installer,803004,3098,6150,6312,9410,6150
6021,09b023473f709cdf86c6eee0e70fc4aed57197b172b32836df5c009cf4064c0b,installer,93178,360,743,786,1146,743
6022,0a0e5b9690f7b3032cf1abe55aba35280edd3e53009e987cb758fa867a5503a1,installer,803007,3093,6185,6313,9406,6185
6023,0a40131cc5a5443faa1d6ad7994f302a899116ff0b6b100c1f71553308db0af8,installer,571865,2210,4657,4575,6785,4657
6024,0a79ab6fe8aeefe1415c7580092a0babb7d4d965e5a94f47c77aed0586e9bbf0,installer,803056,3111,6162,6317,9428,6162
6025,0b514ef820a734cd72ee75f36acc6c82802bce430e6e996e77a304398afaf889,installer,584772,2311,4505,4574,6885,4505
6026,0b6677f8ca7bba630d6f677cff490fc27d3ac0ab423f2d10aaa22c39b6250c14,installer,703722,2714,5500,5469,8183,5500
6027,0b90550296ca714ad9964704b8e1bbf8418368841ee5b0237c2a22af7cb5d2b7,installer,759072,2904,5870,6152,9056,5870
6028,0ba0f8e8057016a435ab2e22f89b2cf2f5391add7f4269f215d16df151466969,installer,568809,2122,4410,4560,6682,4410
6029,0c426612b30ce383a5b90c8c54bef9689d246a3d246ce0353f504a95b0a689ab,installer,286525,1097,2285,2328,3425,2285
6030,0c741b256e1c07cdd97e4516774771d4525b3b3627334122d23fc99b91ce50be,installer,563079,2272,4334,4421,6693,4334
6031,0c7cdf6e6e5a01741e8e6c8aebed2509120dde5496abdd85608d2b40c60cee1f,installer,578183,2261,4523,4452,6713,4523
6032,0ca22e455d3cefc83dcbb8912f16010b69b37aa95796f70814e6ac61084b4b06,installer,578490,2299,4572,4561,6860,4572
6033,0d3c76790d7a248f7bbe392526645a825cc82a839514e283cd9830a480dd02c1,installer,720290,2867,5505,5520,8387,5505
6034,0e0ad72097427a38496f0ff0f4d2e2d2d431801cce5035aaf700168710487c14,installer,4672204,18530,36302,37453,55983,36302
6035,0e117153373e8f15159e2fda953512d9b6fe7789f7a3de87acddbf14270a301d,installer,578223,2209,4549,4644,6853,4549
6036,0e247cd8e5cc52e58b4c5656bc198f49e1ed2ac8829f2fb146dd3dbeef63f48d,installer,974696,3940,7588,7933,11873,7588
6037,0eb124dee6cd7548aaf64abf7951d64ba906085f8a748c0539441a28c0ee11d5,installer,280374,1128,2120,2169,3297,2120
6038,0ecdf2ab7f39d47190ffb0ca3013753f410977f4896fd579247ac7d0757c1e46,installer,578483,2230,4517,4529,6759,4517
6039,0eecd466bf0329ca23a1c178d25b5d6fe8bcce66283bb2d51218a7de490cbd05,installer,999222,3953,8060,8253,12206,8060
6040,0f0895df615e506b9ad6644586f332e0572c05ab92c62927298be3996248751e,installer,487807,2010,3817,3833,5843,3817
6041,0f32f94967a879873604dc7de4f3ef21f6c5efb101a061619d2946c54098a0cc,installer,584413,2263,4561,4500,6763,4561
6042,0f5881a9b01d2ffe1b3bc2db06f4ccdaa1a09dde2c3a31d076ab2900ab582edf,installer,562651,2193,4371,4450,6643,4371
6043,0fbe0c302e5027a17892c384988b021ae7a10da70ccf5d54e4825472deac75a5,installer,486506,1860,3837,3849,5709,3837
6044,0fe3cb4f58275c72fccdab1f295ba21359cc9dc14b27465ae751647c4f07ec8b,installer,789657,3152,6320,6395,9547,6320
6045,10026a7ef4bd28d0cbba7748499e0d527cd7c9d1f33e759d8efed9392a804774,installer,854221,3378,6582,6677,10055,6582
6046,103ffa59338ef34ba5691bed459514e86377d4fc1ec2cf663fb2098809cb990c,installer,436937,1649,3387,3452,5101,3387
6047,1088fd594a24ea9ad11e16b103924da5cb1bbb4f2ae6859b628337ac9f3df005,installer,503558,1952,3889,4091,6043,3889
6048,10c3b8711a4be45cb08cf50ae3ce2baf05ac6e377406c881d37ffc22a18a5c36,installer,809315,3236,6375,6558,9794,6375
6049,10fa68bfc20e4d77eaec9488e04ac1fff098a35f7c046d4fc48d870065048b20,installer,851728,3663,6647,6614,10277,6647
6050,11902546bfaf42651c022dc9a95f9016f6df3bfc94a2865f9ecf0397a2a46b19,installer,93184,357,750,732,1089,750
6051,119bf8f0df45bb4a2f31a032f01522403c6463faa67118b19977e40e01b3ce53,installer,570055,2202,4589,4470,6672,4589
6052,119c1f7269893e9f64e675f3fa8c4ef4db4fd17496a3c2c2da3320cba0ad90f8,installer,760124,2949,6143,6170,9119,6143
6053,11a89f14f5e527f83c31fcf33b5bb9e9fb0b4e8ebe09a33ba72a8cbc4fe30422,installer,488944,1840,3906,3915,5755,3906
6054,11a91d61dbd3dbe3455607d8008eb8c50de3a70ff80a75edd43d559c1a745c5d,installer,286542,1093,2277,2301,3394,2277
6055,11c3bab2f3e6c999153fdf085c9808e8d77bbe9c71314d94b9510c563e4b97e9,installer,286546,1108,2282,2291,3399,2282
6056,122d020932d605174add9b09e25fc51d828073c5793a1a0d3dfd2ee407983a2b,installer,801656,3134,6243,6476,9610,6243
6057,12d86cd98ff45ae49d0eff8ed5171f1d6a80ae6f7ad624d2fff3993eb3f2eda1,installer,3891265,15355,29387,31230,46585,29387
6058,1304c45547e70df53d945b95a4778472d4834196117167dc8cc6475ffa479529,installer,901725,3709,7270,7553,11262,7270
6059,1332f65cc59582ec62aedb4bbe202704df62970837666bd7aeefda7905725da6,installer,518544,2155,4115,4174,6329,4115
6060,137126a960dde1fdb96cda14e0b7e612dc6218b69ba6ad28978b848f78cdeb69,installer,720280,2847,5675,5563,8410,5675
6061,140897ead309a8781808b0094f91b75a58ad8a8d8492d763f35ce25f702f4ac0,installer,854110,3297,6778,6530,9827,6778
6062,14569324dafbe91e127efbc48f2c54ba5c6a580f7219f90cac7b699ad8671cbf,installer,487752,1995,3825,3806,5801,3825
6063,146163a87a7eee11127c002d51d2f45fcb80e1ecd2e342b17fc0b7a855c5733d,installer,704947,2722,5446,5526,8248,5446
6064,14ec508fa6608c212d5a18f8c10b8af2c3bc3de4666b23d5d89f41eae266b596,installer,279187,1131,2227,2176,3307,2227
6065,15048878f8a2de950e594da77bd2358318992ffde10eb449644dbdfe22db36d2,installer,282744,1076,2206,2157,3233,2206
6066,1534c8de2af10ca1a561564c749d042e9f2a30f10343aa416cf40c15c874cf2d,installer,1013664,4138,8214,8253,12391,8214
6067,1564a685583bf721a2782063740774b68741c2da2a810d8e7ea12b6e2f91a2a7,installer,286626,1153,2266,2274,3427,2266
6068,15a5d9bacdbca6eccd49ebeac42dc6b9846a18c41c8ee1c0eb93b88988e2c8ed,installer,277561,1046,2107,2228,3274,2107
6069,15d3bed07525278a12503e7c53581a356aad326c2e7eb62059694e553d4a681a,installer,568475,2265,4381,4507,6772,4381
6070,1622f771c43f45f27138feebc1f1f42c4529cbf10d485bfd67fb4ed8b1aff1f6,installer,2980224,10724,24382,22909,33633,24382
6071,167ca95e6b63545a65002706d3b8b7b618b9258a3b1a15b811dbd4866f83aee8,installer,873081,3358,6867,7033,10391,6867
6072,16b8a2b7971c717c9a2a28eb5bd7822b8a6cfd87e6f52e6f0830054970b45acc,installer,286633,1210,2303,2393,3603,2303
6073,17765ab5ad62c3f61af3d8ea38612ea8b0e9599daf58d0d75b914333cf98542f,installer,1017608,4080,8153,8249,12329,8153
6074,1781d51b08b7b7d3571fb8fc164827ef991cc914d672824cd49c7c56b69dd993,installer,686954,2605,5400,5393,7998,5400
6075,17d887d11c65eb61b94c1dfc68c086084aeb1a31803482a0ccf04cd1607ea1b0,installer,93241,360,751,729,1089,751
6076,18d025e505f8550f15bd4bb7c15cac2b3ac21dbffcb2e640dfad5730729f6cf1,installer,503028,1970,3823,3971,5941,3823
6077,19a4f67743ceb042d441c76ce061665291f5b2e87028b7adab34485af9f2a6e7,installer,503560,1949,3839,4088,6037,3839
6078,19ab40577d4389057df3e5bf6b0e22810de2f3eed668b27dc03fa9dc5c81e21e,installer,809166,3096,6301,6482,9578,6301
6079,19b0ea749c27bea7aef503a68f31a7d366388628e72c9b53ef8c0eb3c99598fd,installer,503559,1986,3828,4073,6059,3828
6080,19c25579b3b858c96cda985842782fa531b3a145aea5fcc26cce32efbe08e064,installer,1070810,4232,8452,8738,12970,8452
6081,19e839e2d1e5eee19ee1b09d84ab7029399034ce76532ed052ab56d4be5cd797,installer,561984,2217,4444,4289,6506,4444
6082,1a55e119911a65c515eba69fc4d0d2b00e9ed915eae107f8b51250aaee4d36cf,installer,759244,3070,6040,6149,9219,6040
6083,1ad83ee72cae8e536276c0db71b05e6d8c55a60af202bf0ca1bd40fc3e802b76,installer,563001,2286,4360,4417,6703,4360
6084,1aea74d659b91c5eea88e01fc965dc08bd8a1aa049f610898e6552cc8acfac95,installer,481715,1879,3754,3853,5732,3754
6085,1b3cf86f90f73597c7f887e67caace9c59a0e63e597d7653115a178adf21cc41,installer,684381,2626,5387,5402,8028,5387
6086,1b608268737a9a982f547b560f2349ba408cddf799451216eec8b522747ae92b,installer,853487,3610,6639,6678,10288,6639
6087,1b9456649f9fe7e6b60375d606713219161743bf69b6651fb9be63a96f66ce56,installer,286587,1092,2219,2283,3375,2219
6088,1b9c3934f35ece2d0b5f31a791fc90d0d6a0064a05204a008e459f38e6d75ede,installer,559780,2097,4380,4408,6505,4380
6089,1bafddd8dab9e86b4fc755f67b90c879e4f6fbf64d9e0974439f0160fb4223f2,installer,215029,801,1702,1831,2632,1702
6090,1bb5f93b00893a7e79ea5b77cb3b5c063c9d351ec27fe25f334c8c3d59aa072f,installer,999134,3950,7929,8188,12138,7929
6091,1be61f5a65a275697cde9836d70560a90e4d4b51272887b434fd0b87ad6fa8b0,installer,562527,2188,4372,4454,6642,4372
6092,1c54ebaf99c7549556ed792b70ec56a735a3b2a9ea7d04a18a6018010bd34ad9,installer,503560,1971,3904,4095,6066,3904
6093,1c627b0607fe08adb763af00c7dbfa4a4dbe1d1ec109c82dc535c02d61c012ef,installer,1014035,4148,8136,8456,12604,8136
6094,1cd0c74b49c109b2cd6eea1ee9334a2e63c47848b4df91e4b6b7b3d6981f95b1,installer,974696,3916,7813,8036,11952,7813
6095,1d0097cb77171c3da27b254692d3575bf65c8a8df9472bf704f0f22ffb762afb,installer,318928,1304,2599,2530,3834,2599
6096,1d02b1a77f922c538fc741cd4432b650f9616af47e4305b89efd572096c8d5e6,installer,974730,3888,7759,8005,11893,7759
6097,1d0daf15fbd8b865fe2de9090690dddf71d1dbe43e6328b3b09f0b0388eec886,installer,277659,1033,2105,2230,3263,2105
6098,1d458f002b0c93feebf2a1efc895d5dbfb842edc6bdac4ec9b41283f9545466a,installer,3733160,14958,29706,30600,45558,29706
6099,1d7412db5fe578f30c8828d51891699c3055f53f24aa29fc181adff83ca0c0de,installer,599083,2413,4816,4790,7203,4816
6100,1da1d0407ae3c6b881ba770db030b1d0d7949f59b87d823f0150c75e06466bb2,installer,563045,2247,4390,4440,6687,4390
6101,1da3e5982f3dae42e65f4a1abbbc7a6949b8ef262ea4b3853c2a1cb39c521e19,installer,812280,3188,6485,6409,9597,6485
6102,1e02d519b5ccaf335294ff42ce3ab6f137084bd4953d6a678c923fc2cba5953c,installer,560727,2102,4205,4370,6472,4205
6103,1e0f47b82f69f1786b8aa88eb05dd186ffc8642da1bbd5b932ec0fe1a266d664,installer,808145,3140,6353,6477,9617,6353
6104,1e6a5642dd28e6b2c851429e293c1e72f0a464bcc78cac740563c3e9df6c82da,installer,563046,2228,4397,4423,6651,4397
6105,1e9a08e2fc1f60e936da092f13776f45c140bf5371853c3c6f133f532a64606f,installer,283348,1143,2187,2280,3423,2187
6106,1f08dd9081fee1c914f3693cbb9be5c9d8e412e56193af78063c8bdc6329b32f,installer,294130,1067,2273,2302,3369,2273
6107,1f1015ff8201ed64710b3cc1df0d7f627bd37c572b7c69a8fe85c517e028716d,installer,563238,2255,4352,4458,6713,4352
6108,1f51e7c235761e89d598c794cfb41d512a2b585b4e04a516e99589afbcebc3fb,installer,586013,2223,4479,4629,6852,4479
6109,1fb9c8e845cfe50b5da535eb615766d9b20bb6f5194f96943265c518bd96e8b7,installer,851762,3709,6691,6708,10417,6691
6110,1fc6596be7f35ca620741cb6c1170ed4fb883425d8dc59f7370243d2a41567b7,installer,3869151,13922,31975,31034,44956,31975
6111,1ff6725d2544005ce119ce1f8d5438c3715e8107e4a33e0c592816b31588a8de,installer,720278,2886,5516,5520,8406,5516
6112,20c3c6040fbf527b8b13468a01212245b7ee8534dee7e161e59077d861773dd6,installer,851777,3617,6760,6649,10266,6760
6113,20da2c264becfedc92ba03d107d1dd866057215e314a7bf9390657f63232dc29,installer,286519,1130,2249,2257,3387,2249
6114,214d8425ff871153c7c07c715278f41208d132faaed1fe4bdeb3b52295388c39,installer,284521,1112,2210,2304,3416,2210
6115,2159e21240b2680f6b2613fe7f6d10e9e846ea6a7bd1a6e89b90e8b652590601,installer,563154,2221,4377,4402,6623,4377
6116,216c5ffcc4f906ff31fc4b80117df920d749cb215a630f36dda321dba9ad50ac,installer,802219,3156,6395,6426,9582,6395
6117,21d60b04890db4b0048c66619707da9d001f896c14ce1597418df2223a3572d9,installer,503560,1927,3870,4033,5960,3870
6118,223006b1eb040c8f94324a6e3ee8bbb08ddf705c3b03ba679f57711127906413,installer,1013997,4139,8021,8292,12431,8021
6119,2285ccdad0896eba1ca2b74fbb5f4c061f2903c380a09eff8fdc6fa5eeb1e8bc,installer,570015,2180,4615,4466,6646,4615
6120,22f963b114d8e41ff82167c02b809803602b1e7a9ea1a8867c2b78e15ae1988e,installer,558680,2166,4379,4360,6526,4379
6121,23059f2518f33ab5b58f6e3e2fb24e0aa34623013c23b46afc2f34fb58a69fbe,installer,476050,1968,3651,3707,5675,3651
6122,2335a5c7181086d4954f5d82dacdcb1cc614c71b597fbe3fab2228d28019af89,installer,813032,3173,6446,6638,9811,6446
6123,23527caed926ef90a19b5f83f21e9e2747b7374e01bd835283ad83cd236abea0,installer,331923,1348,2566,2532,3880,2566
6124,23b254b58aa833e8b3d26e1c911887829c4a02a4fcaf79c19ea5037026004956,installer,286633,1223,2304,2375,3598,2304
6125,23d7fa2e07c4d6ea3e45ba5af3a67cd0353da625e25e3f2037b38df5b9db6e98,installer,563081,2302,4355,4448,6750,4355
6126,24266f4dc68f0edf6c29f9de4af5854636bb94f3cec770172a34d46dc0b91118,installer,503560,1919,3873,4035,5954,3873
6127,24f580b5a24f9dfd6312b5671b8d6ba45b78d43edbf0592669ea29cc52c6fc66,installer,476040,1941,3672,3691,5632,3672
6128,256d925f76eb05df3292d3f0952f118b0b269407fa1f42c085f80289cdffc195,installer,277628,1062,2134,2218,3280,2134
6129,25a08a1f54b72ff5a12cfbf260f78d99d5b64f2d0457e625df83ebe5aa1e577b,installer,571698,2285,4367,4580,6865,4367
6130,260b469297a570e06d5b37de55d75bf9f811aba31cf6b71fbacba1b153ed795b,installer,487747,1975,3803,3760,5735,3803
6131,26936808fb1ad6f4e19a91e22b6488613a76276a7419ad2641b98b475b03909f,installer,484642,1901,3858,3934,5835,3858
6132,26f007d047014269cdfd4ea941eaa2647997d440d352024f36f1f2a6ff61d3ca,installer,869290,3401,6805,7089,10490,6805
6133,271c14a2b24a7d95fba4d32d615b39a50fbb8b7b9a33fa364719fb8e9dcf6a7a,installer,720287,2882,5516,5523,8405,5516
6134,271e54589cde461e3884cdc7936e5faedd03b3ec4c0a85d9955fe8e9a1cd8253,installer,286433,1087,2163,2255,3342,2163
6135,274cf41780f11f863fb2c4f6b2cf962206ca24e204410e136774da1569863fd0,installer,500932,2031,3985,3877,5908,3985
6136,27683281b1d04bef198e39a36ded57c835c9d2037584d5d0440ab486d392119c,installer,809592,3209,6385,6555,9764,6385
6137,27b2f9319cd2366d5dd37e38a8759014ed1274d7d9abf1c6f8e37cbe6b364ed6,installer,523076,2107,3978,4214,6321,3978
6138,27d8a2852fc9738c8416011a7f7926210fda8a00f031d23269e21b3034089f64,installer,487710,2002,3851,3859,5861,3851
6139,27f73ce567a062aa85e9b45e78ad87fb750789e958c6f4ff8e6cde3544255f1f,installer,868409,3314,6927,6929,10243,6927
6140,280e0f516b5b71084032ff2fc05305a91a53d7ba8a1932fd995c740f5654850b,installer,860362,3317,6861,6838,10155,6861
6141,282da89598128db4038a89f839f38051c5dfae3cbfd6c7e1aa9d0ab593ad04a3,installer,720268,2846,5665,5582,8428,5665
6142,28806279c2257eb3e7e9a5d34e08d808343427cf850322e2055d5ca704668e77,installer,286554,1095,2293,2253,3348,2293
6143,288de0a6d193f7c86ca45cdb55735b9245d7c9cbc75bb6bebbf086ac2b569065,installer,288006,1122,2260,2332,3454,2260
6144,28af90d1d24ad8a5f40adeafb16db7703acf0c3738c2edc641f7bf2dc664ab7b,installer,584413,2226,4646,4677,6903,4646
6145,28e1a8a335183eda37bbd169166ab25d5c7ecc687169b8bf18278e0952b6eda3,installer,716778,2786,5542,5591,8377,5542
6146,293d9ff58def4b7266721563ac2dd042f97b209f3c9247b942c89e82b5fbdf9b,installer,503559,1967,3939,4043,6010,3939
6147,299f20a056c42300aa5311584217f94e7da1e0cba74ce020348791e67c4c2797,installer,571165,2186,4400,4572,6758,4400
6148,29b6cebbc49d77fe5f70552cbaa9f1a043fd020db6a2c55dff56faba9b8be778,installer,684273,2632,5378,5413,8045,5378
6149,29e7f30b18743d8f65ee2414f7a4a55768b55ac397936b6b245d4a959dae77bc,installer,94822,373,752,798,1171,752
6150,29eda7511eacc933f42dd293780c7e64a3df00f5f4d0d3e95d9072266852185a,installer,759295,2875,5976,5942,8817,5976
6151,2a4edfa8d11f7d2780a77f2aa5d605b1a7a86e1ead1a8845d1059a6cb2d02a66,installer,512012,1975,3969,4036,6011,3969
6152,2aff1e25bc7d3d91df1b3f41cd2af01a651fe28a084558f7df48ef90ec94fdb8,installer,909817,3641,7141,7224,10865,7141
6153,2b557592df2bfb6e09bfc6f7ec3aefabdf999c83e85446d0927ef0a977f6a425,installer,109889,458,870,827,1285,870
6154,2b8603a6cc478909db15d957aff1f6b54bd1aaa5e50a27bae86fcd66e593776e,installer,720266,2849,5669,5599,8448,5669
6155,2b96f441c26d6d6afd906f6e083337cd5844da076474c65e9fc46adc7d771c94,installer,602269,2404,4690,4896,7300,4690
6156,2c09402576540b31b54aba812df9d091d86e1c7e9e6f461484393a3ae2c9e8a4,installer,503069,1956,3957,4009,5965,3957
6157,2c516e887760c145aa20d85b9d5d3b0d17a05c5328497548c3475e0272390b20,installer,853436,3659,6684,6669,10328,6684
6158,2d206d482f6ce32a6b9709216570d93a6dc4781b11f88512340d2a6c9981c94c,installer,569763,2175,4580,4488,6663,4580
6159,2d411ed178d6778aef71a56dd7c25a2688885577e3a1f280bf2b4b010d67256d,installer,851751,3662,6674,6679,10341,6674
6160,2d5cf1d1bd8f4154f6ecdee17ef39bccbb1b6fad5bd6d7fe16198f8bd86342de,installer,569585,2229,4418,4416,6645,4418
6161,2de5fefec2910dba0648c343afa83f3f25625c1b5ace1fec930462ff03fde6ec,installer,576801,2275,4459,4522,6797,4459
6162,2e12f975522f806a3a0a8d2420f98f0772d07cf7d99dfbf64c03e12bcc8db81a,installer,802205,3148,6395,6438,9586,6395
6163,2e629f02ba760123e06d7d3c33c611a51220ec08b8fb64f1d21645a6f459c35f,installer,94822,370,760,775,1145,760
6164,2eac3a5f4600ffed5e434f587811c7ee9093a5b130d3e0bf62b1e51cdb88bc05,installer,1012032,4173,8227,8142,12315,8227
6165,2ec325bbdb653aa3a1223a873901e8cdc41404edec4904a56c6035712196dc6b,installer,869279,3231,6824,6866,10097,6824
6166,2eda604e3c4f8e2e448733d80c268cbb21ea857ee2fbe3fdccc456487f31deec,installer,568570,2169,4389,4390,6559,4389
6167,2f2cfc35951a0fcac340605ecd86d0544f7a97c4611f08ee212da7e0e790e61c,installer,475787,1825,3785,3879,5704,3785
6168,2f59eba79199471d9912524eeb6a4d353e843216f694f20213193ea38d93037e,installer,94828,393,732,800,1193,732
6169,2f919c18f20dcc34f2ba88af61f004ff3db9f0981a6a6293f4c3d79bf537730f,installer,569665,2287,4406,4504,6791,4406
6170,2fcd60f0056851c824df7761b5104c8e56d199d647bd7aed369a3db3f4e49670,installer,974701,4003,7636,7892,11895,7636
6171,2fd776cbe94371e85763377b5758f7adb1da4b3c4ea7ae632335b2822d58de9c,installer,105901,467,845,818,1285,845
6172,3008f1e1503fc40214a4850fc71ab15070563cf6f25c6e17d1602766b6871270,installer,274762,1049,2105,2177,3226,2105
6173,3034f915f505bf9caf977c2b96b97142fb8e0f21455610032e39dc55fd0c12df,installer,505190,2008,4000,4087,6095,4000
6174,30d76699c14592c697138b27cdfb7508a22945513282421430ee57034570244d,installer,1012044,4208,8150,8277,12485,8150
6175,31072b277b2dfba7ce53bd01523dc09fe0e80f7da3148cd719332c2cc50afb66,installer,1011994,4026,8129,8409,12435,8129
6176,313555875e176b33cd7e8d1a127dd76ed2722c0f524c2b292c3f4321139c5950,installer,288011,1116,2262,2326,3442,2262
6177,317abb453ba18630b60feca46f7a4abe623f5754fa0c7e3bd217e5f69946fa85,installer,493514,1894,3866,3879,5773,3866
6178,319937a94f52f2b968be7f447384a184cd0b9f87ead3fe6bd1ab6bd1c398970c,installer,722042,2739,5541,5638,8377,5541
6179,326afefee63c87ecd4d7c85566cf390e3b25bb438e28855bdc0c86fbb9e6324a,installer,503560,1971,3904,4095,6066,3904
6180,329926bc2536a4965d187a20bd39464bcee21638ce7ae8ddb3e2eb6914e11e8e,installer,476054,1889,3639,3685,5574,3639
6181,32c39d1218d2416b72b5bf2582053c4ac71922297b8b720576fdbde8d676021c,installer,585374,2283,4728,4666,6949,4728
6182,331c090d8656635e506113f9026dad0120623d93cffae8c9d0c50998881217c0,installer,513339,2136,4135,4091,6227,4135
6183,33757995bba726e4a70d56c22933823b7aed7fd8ff0ed80684e7de7ac1a97541,installer,683644,2599,5386,5389,7988,5386
6184,33c5282db26602f76b9a0ed71daf074a68ee903a3bae1b8151c023429d987f90,installer,503557,2016,3902,4094,6110,3902
6185,33d4017a31b54fe918fcef62aae734e1409a61ee9bc33a28b312a1240f892f10,installer,3662064,14850,29210,29971,44821,29210
6186,34086c8035f957767307fe2c3789155c62dcc5678965fa34511cb71f66315bd6,installer,808184,3125,6325,6719,9844,6325
6187,342eb1b074826bcf7e33a1baebac477f5629a1d06ac0dc6240209b7fba3cfe8f,installer,563154,2216,4654,4412,6628,4654
6188,3451c2c334451021d4326be80cb7cb19aa16c10e6070465ad4e44888572ff108,installer,275857,1084,2227,2132,3216,2227
6189,34adf0df832995f6ec5988d28e73629deb8d2f14d4453481bf27bb31431a279c,installer,278340,1158,2192,2183,3341,2192
6190,34c0201af3cab79bb92c429ae2bfefd4fd470affec8d26da9237e1a0306f46b7,installer,3891261,15365,29386,31212,46577,29386
6191,34e5607af6c4038661138ac8f4ecca6e2911b3501c711e507d51f9c40ca95954,installer,279246,1133,2176,2207,3340,2176
6192,35a7c5ea1e10e5e6fb0b8cfe9b6f55985cf7173a9acb52da39e9ddb1280df714,installer,571610,2271,4371,4543,6814,4371
6193,35bb8e55aa60c141974af4e6445c5a248c9e28f0ddb5e6419d1186d168076623,installer,478903,1876,3796,3725,5601,3796
6194,35c896075c26ceb1a2108eecb37c05a1d86f41b9096b22ab81ff59c21d2c4426,installer,720274,2784,5722,5598,8382,5722
6195,35ca9125c998a73dfb7117e78aa8299e1ec15054ed286c522656b3c13612a163,installer,308957,1199,2381,2489,3688,2381
6196,35dd2224ce06e663d759372bd7821be93325b16a14bf6602423bbf1ee008991a,installer,850561,3582,6710,6648,10230,6710
6197,362b9df2c3f68eb166705ced90d7f8fd039e5636cfd9108f1714e4706c9a5ca1,installer,515030,2070,3987,4077,6147,3987
6198,36841450059a18fc7df17fa0f73118cef24e80315a83ea46ad7d2589229f0767,installer,1004527,4131,7995,8322,12453,7995
6199,36a702b130a1a2130bb3df6022f29f372ac5d31ad57174b8cffee860cfb60d10,installer,503558,1935,3880,4088,6023,3880
6200,36ce5681a3f6266f87aba7c1ad4a9e17c61bebd2d1dbfb37afa44f37653aca27,installer,720279,2837,5663,5579,8416,5663
6201,36e8151397556b2c5fd0eaba2fc13a60fa5f0c81b1855c987090032321fb3023,installer,105871,400,834,823,1223,834
6202,37099fc8678140dc7bd4785e1d956e81a1eea43968e29c04f068cf36989700e1,installer,869170,3384,6872,6906,10290,6872
6203,3753e5a72f6ff689d143be3b654606b3fabbd6f588444b0d22f89e9524c9cd18,installer,974562,4032,7666,8019,12051,7666
6204,37a78fcee0ef2366b5342e1a7f6463a575b1e0ff74e4968314b983e64561fe9d,installer,802625,3141,6467,6506,9647,6467
6205,3825c29227ce2beae96a4d99c282d4c34de8d5510e2b21d16fe85b454a15e83a,installer,803011,3111,6181,6310,9421,6181
6206,38821c414726ec78aa2e6c7ec5f7a6204990ad624e577df58bbf96ff6bcf29a5,installer,278365,1137,2213,2187,3324,2213
6207,38a56911513463f962a5601c89d681c22a51e6671b5bee57b89c33bd9cd8f658,installer,3437470,13360,28386,27702,41062,28386
6208,39ecc3d358f16f8583cb093e83722512c681e92ce5bafda17445527b3ec3080c,installer,923013,3750,7163,7421,11171,7163
6209,3a585c3b7869ef346347e4990a3fe0834e51a5dad0b60ae45faec6edc0146d18,installer,720261,2843,5641,5586,8429,5641
6210,3a5c150fa3f63784cc3983176667de4475ddf249ddd6975d0e5754a91a3ebdac,installer,684146,2616,5446,5405,8021,5446
6211,3a5dd26d0a2005476d7933ef3e49ae72293b16fa27da53f1358ac3316ad0bc6e,installer,503559,1978,3828,4069,6047,3828
6212,3ac75ae313f5a625a6d26c96873e3007421ba2dd9bf58bf00704655ab8d8cb50,installer,286580,1086,2225,2296,3382,2225
6213,3b294df396d6530d46efe3dfd27bd6a870555f570cc18fd53fb94a3b75d8f17f,installer,809872,3102,6409,6534,9636,6409
6214,3b75909195e9550635e9ec271c51c98a455926576e76bd1d60f3cce4c97046e8,installer,730063,2842,5790,5718,8560,5790
6215,3c44a262e91b9eafa4aa0391cdb0c4a5d3246de969adc72bc53eddbcf6f6a81a,installer,868780,3443,6833,7017,10460,6833
6216,3c8e787ea146d82ddd6a9569cf43d022a9cda91d5fb195d08e86f3e89d041a88,installer,563172,2295,4433,4389,6684,4433
6217,3ca4b575757b6d7d938c3f1bb1f5cd92aace69f636d126cef44cd48cf9d9b6c2,installer,332042,1323,2573,2698,4021,2573
6218,3d1d981181065b90568be3121fb882a03481700d9523b0d424669734263f862a,installer,809600,3207,6362,6584,9791,6362
6219,3d27d4a3941bc06e78126e1240cfe1168590f6b34321062428bfeea9459f48b2,installer,476039,1910,3636,3655,5565,3636
6220,3d41448df3eabe450c54b4e726d2457b1e70e4898c71723b0ef75bbf084c02cb,installer,1008885,4073,8173,8201,12274,8173
6221,3d7ebba1053d4405e44169f66cb4a72c9084f1b7914129ef827245d149f54681,installer,792375,3148,6299,6254,9402,6299
6222,3d8405119e571c363e1fa719d645b4d457968943aebc05385ceab3366b4e4d61,installer,571236,2175,4398,4567,6742,4398
6223,3de7e2272cc195424c7432d7b43a0166aa08eeb9257ea0a5b5e3f6394beb2fd8,installer,515030,2105,3986,4075,6180,3986
6224,3eed3b6edc69a13497cb119985cef0f722db02692c4286981222c0ba5e82e8e9,installer,502404,1935,3981,3882,5817,3981
6225,3f10b48de291e8ebc2e91e92d77660061558c8f8f8109687e28146a64ad24f31,installer,868778,3461,6650,7054,10515,6650
6226,3f659f97acd6ea126ba24af175f7c8abe8684a277954fb7837e7440e1e4204ec,installer,585371,2264,4674,4628,6892,4674
6227,3f97e534254ea3e9545c8df1f630d834677a88fda53b5aaa9af7a82a99f2394c,installer,570872,2199,4428,4571,6770,4428
6228,3fbf49c59141be87e7615e2b19928f24a30b1c8555b1e978a5730b1d009e5a11,installer,720275,2767,5703,5555,8322,5703
6229,40b824d4648e44070b9990e4422560702273611eebaaf774c31db703e78e119e,installer,578876,2340,4492,4512,6852,4492
6230,40b943b38193b0e8222addffa539f43654d4682b05c367add356a7994da3879b,installer,485036,1943,3724,3942,5885,3724
6231,40c359e909fd573554391a29f58f29bbc1a0f1cc78ba91336792a58a0f0aff95,installer,808143,3140,6355,6474,9614,6355
6232,40d4b9f77aecb174f20c2a13eb0afc1ea32aa308e2ee3b001f3e0611499c00f3,installer,279009,1075,2229,2188,3263,2229
6233,413163dea22c4107ebbfb2e1db62cc90f1cbce535acdc0e272c45b557a653c98,installer,286522,1098,2271,2301,3399,2271
6234,419aa23514f48a23fe34226a3b55425c86ff326e24e171ea83f213671a086a35,installer,94799,369,765,757,1126,765
6235,41dc617645d1bed76c498aa56475d1ee4ae36997fb7f4423668f490c83ab37e5,installer,513515,2181,3959,4057,6238,3959
6236,421b2694e83c1873d495f71f5ccb659e5cc4672a089e89f2e76d2bc0d8b87a35,installer,684526,2621,5374,5444,8065,5374
6237,42dc3c8d7e95aefa3e938cbddc728bfcde99bb521c79398badbcc73d1d2e3c97,installer,503560,1957,3906,4084,6041,3906
6238,42f1f52fdab9d74eb7b59a5132cc4495fa2f4a2e6b8701a015bc9387483f235c,installer,869224,3407,6969,7108,10515,6969
6239,43103e9f838f0b20bd35bbc9161664f09e6377de8ff781cbdaa6388df943771d,installer,1024904,4049,8310,8148,12197,8310
6240,4365be16d7068342a175481ea011c1b0dc7f26fc8f518c81e777f1a0d477892a,installer,562551,2159,4406,4437,6596,4406
6241,43e4e65840853e5fda1666046d8c2f64f9f09a5fc23ffc1f7c006ce4b85672c8,installer,512063,1957,3936,4064,6021,3936
6242,43eebc997d0abd3f83555d0c18f51322f0251a4de5e4bae9d68756b4dfab99dd,installer,277844,1093,2114,2238,3331,2114
6243,4403b517343928ce28c749d7532db6ce31920a170643cfa734faae707a9420cb,installer,563010,2253,4361,4416,6669,4361
6244,4413872ca38f1ab68eb94ed8efc167fa1289ef0f0f6b90e5e63c9ef86e74733a,installer,568538,2247,4350,4523,6770,4350
6245,44561bdb69d3dff507b4a8fc41477c1600a95d3b84abaff9e2ae0d8e2d106934,installer,563039,2269,4382,4426,6695,4382
6246,44abe43029e4b2d42881e7e96025d945b8dd7a656dd2351e06788fe1fc3ff074,installer,271939,1019,2091,2158,3177,2091
6247,455e56fb7e9949b63941dc9d7fcf47a71d8a8edc84bb45f1d34a08acb48c34a2,installer,559547,2211,4402,4253,6464,4402
6248,457768f3e77c7211108482476562d09b915ca8ee763bcbac2cabe3f61073b753,installer,563010,2239,4406,4415,6654,4406
6249,458ca2d91700f807520b6cbe676dc038d2e4bf3dabdb4fb1cdb971ccaf300cbe,installer,554003,2161,4363,4439,6600,4363
6250,469c389382face98e913488da220589ad949addc2ba44c28801efe43eca861e4,installer,809881,3110,6380,6547,9657,6380
6251,46e75a993b11d0409e7967fa3d2269ccc5df6c9d206cd9659a39ec1e1bb7d946,installer,93227,345,737,774,1119,737
6252,47046f377f28eba45cf6e87a15c45a0b1a88f3fb50e7157111f0f11e45147209,installer,286587,1106,2224,2295,3401,2224
6253,47405eb9f2caf66cffc9ab4a633654e7b185a07c524e54e8800de6a47c558ccc,installer,779348,3026,5977,5915,8941,5977
6254,475eb59d8e352375ef461d14aae15b3c081820f98e2621efe5e044785976b111,installer,563089,2261,4403,4405,6666,4403
6255,481a69b2ed9e77124e6446e20ee9cb39b3eec1f273d29e0ad163a592f868d165,installer,482815,1886,3717,3890,5776,3717
6256,4824de24932be3ca2a08e41913f213a8667e1ee3135d8971ef02aba5f34e128e,installer,93178,376,735,766,1142,735
6257,486b57f653fcd8b8c555a6ff5aa38a8a7c2536ef1a565f13eb2afc115d8f4c2e,installer,809590,3207,6385,6577,9784,6385
6258,489450d3e438060cf36fffa93455a6916dfe54d8d9252243b423148dcf2aeac5,installer,476051,1931,3647,3728,5659,3647
6259,48d037eecd7e54455516227e27448a91f84bf437b9ec6708debd767f5196f6da,installer,503559,1963,3906,4091,6054,3906
6260,4924a057a2ac03544684df8f51b7f154b7dff56c3401bb45c638b86e43480f4c,installer,277623,1054,2132,2211,3265,2132
6261,493805d56187d0ad0726f2743cc79ffa20a71b60b0cff4ec0e4644979ff3c9cd,installer,3649727,13480,28043,27967,41447,28043
6262,495043fd4ee3afe4e824b2c62d5931d5e98aa4d15cba37ad126bdb17d6bcc7f7,installer,93183,356,749,765,1121,749
6263,499b58325afe27e3a1d736c078df781d78e5f0babe22b01be41d39bc831de684,installer,568581,2223,4465,4465,6688,4465
6264,499bda2ee36ded5d875e9c913915dd38084d44c322b45ee5023857133ca1c0c7,installer,568802,2113,4449,4548,6661,4449
6265,4a6a1d71840b5e5498b2c39476c9a3fb9f038773c11e2b873dd3ac5af0e7c791,installer,811345,3328,6426,6518,9846,6426
6266,4a97b23c6e78f7a01d9b7097b0547450e3d70a2d069fa2d1df96ef5f0dc9bf03,installer,584718,2301,4632,4686,6987,4632
6267,4ac98656b702da10116dfc1a7c1c785044a5a0e6c78750cc592172b5fa56bc2e,installer,562287,2142,4374,4457,6599,4374
6268,4b49052743a3142a61d1f7b5c067441879653cb9f481817d01379ce11a6a0d44,installer,571130,2181,4417,4553,6734,4417
6269,4b8cc02be797efb1eb788c8d9fd4bf61ac3fa9b56a34737edf5b3f8a72e0f219,installer,94824,344,738,819,1163,738
6270,4c275e92d88d9d47223df8ddc6d02a34eec6988f38671dc61e0b471bb51926dc,installer,93185,343,755,780,1123,755
6271,4c46e591fcd8bab5320a0572b9f1ba536306bc1f2e7c7e8eb57c1e5c3469a1cf,installer,856668,3317,6664,6645,9962,6664
6272,4c664b26f86618351d92ce144f1c51e353e8cd5e5a9511b8acc5f89c56029bab,installer,563035,2237,4407,4395,6632,4407
6273,4c7a9f9609d69387c11bf8d6be9b4906e430dbfdec3fc24df44dfb22416c255b,installer,873087,3322,6861,6971,10293,6861
6274,4c8612b3afe2222c2975d0bf7d7ca500d546147471a3b530c2db337de7a034ca,installer,559875,2233,4340,4233,6466,4340
6275,4cdb39c71cd1b25eaceaa9a9645711a8e163ff6e8b014b751089bf834c567d83,installer,722019,2726,5648,5566,8292,5648
6276,4d27c0125626b776159d356bb515501df18927bd0d49119a8a0d972754622756,installer,974705,3941,7639,7915,11856,7639
6277,4d5c8b84957de79f98fc23df89ce9ad111975b7651bd8cd034c760e79465a5b5,installer,584498,2252,4486,4543,6795,4486
6278,4daf49b033f9efd286cc55de3da3b710d53b56e2cef52404871c4f2c171ec167,installer,523075,2033,3963,4187,6220,3963
6279,4e51cff6d98e937d547567382e513296335e67b5f33e3cbe3a3d542dc922b57f,installer,286600,1145,2218,2288,3433,2218
6280,4e778fdc8607d3fcb98e103bd0e26c3d3b69cd597c12d9afb25750d4625f9da7,installer,476049,1927,3659,3707,5634,3659
6281,4e8a37421be183b8d723b2828543ee6b22ca5ea735392e54fe08f9e607e46ae2,installer,476047,1946,3627,3671,5617,3627
6282,4e97631e56819939151a5d139ebcb32522332df6f0f0b09df6a35e0c575d07d8,installer,93213,364,712,771,1135,712
6283,4ea63d4ab638a17a76f247de94690a71099d5523d4a778d88287dfe01ea8d1c8,installer,503560,1917,3853,4051,5968,3853
6284,4eccde242706749ac6e3d5fad52796fc90306a482532d394950c376d3448635c,installer,1017547,4143,8094,8176,12319,8094
6285,4ed3f497c6e7a68cf2f098f304d5e50d31d864dfe84b8d6a9e9eb8e4567b7992,installer,1013654,4074,8194,8135,12209,8194
6286,4ef6466328889defba187eac64dcdde10365d01bc2e594d06d9c506be6fa41e9,installer,1012036,3967,8012,8191,12158,8012
6287,4f103f96fb4c6863e027ec46054196dd58d67a5dfd1457da1267685932a127bb,installer,563007,2169,4352,4348,6517,4352
6288,4f80bd6e70085ad5ed0505e50d562125b0a4e4bf36594e8de73577a5f6f02dce,installer,563101,2226,4603,4413,6639,4603
6289,4fd2c14e74144c8fb43068610c21a269f704225c918dc125f2757fdd50e8130d,installer,503560,1929,3851,4062,5991,3851
6290,502d3dc103169e2ca1190fdeb83ccf0a958561b19d8e250d34adb166b75aae1f,installer,286526,1082,2304,2285,3367,2304
6291,507d37abbde28c14e54e38b6d1f1f3ef61352fb6ce5c3ec8ae90367f2335672d,installer,720268,2851,5657,5568,8419,5657
6292,50a00f9620a17e3e1e33c990fb636ddca4849c12ee896e632297e076283f1e75,installer,970874,3986,7653,7905,11891,7653
6293,5113eb8b1a408a65966c39dc0b1967ee48889ff9518d69aeb9011e831cd1b635,installer,720282,2877,5512,5498,8375,5512
6294,51329473082192c53a137b0586f8236abecfe0051abb80cdfadbb672830eff01,installer,868865,3312,6778,6877,10189,6778
6295,516c29a62e9c9057d010278ef6052b2f63790dae0517e3404e6f2673b28aca85,installer,874830,3405,6916,6965,10370,6916
6296,51912fae4db8d7eb64597ace502d45ee3cf051f80f50a0ea0d2794536c3325cd,installer,808673,3054,6394,6466,9520,6394
6297,51dd6b38e8b6ad5ee740db89e9e2dcea16e8f542977b74b4c153777e9aa65ef7,installer,461667,1796,3602,3572,5368,3602
6298,52453dc8019456146a6cc433a8891ab4616a25cf028d3e2266bb25cdcd06e93a,installer,476046,1922,3653,3644,5566,3653
6299,52565dd18c40cc9c517e4073187db9afd4fe28d665078cd9371ad940558a37f4,installer,563003,2155,4377,4345,6500,4377
6300,52dc3a46ea3d604d7bf474716610893290a376fc7eef01b0cb0b8f28e5ed234e,installer,1017594,4093,7932,8285,12378,7932
6301,534d7886fe3c68c50a13526e0d520dbddd8f6b2065cd430981a64b2cee456276,installer,792119,3069,6161,6362,9431,6161
6302,535aefa8bbf75e24ddb0662f7d82df6df180742dd671f3a2dff8a1aa8466e455,installer,94822,374,757,785,1159,757
6303,53c60878e243c97adf5158d05b3fa09f068a5f71156f1508e374ccf734b21d91,installer,286726,1129,2216,2348,3477,2216
6304,5417eea305df26705f3a5e8b80e56575e3109a4dbc15c42ea436e3d38e1f1c15,installer,720696,2765,5734,5702,8467,5734
6305,544e3215329e62acfdf027e321350bfaf49f3cd500ef593be6819756c78e2b20,installer,503560,1960,3887,4095,6055,3887
6306,546392f94c9c2ab574653d3c6212e325bb41607d2e56f0e9ac824e0213f78fb2,installer,521470,2075,4059,4212,6287,4059
6307,5533491760538bb4a32bd4ac5b64f9ffcd772da2bd1a3c9b75c4aa2deb88b9a8,installer,720275,2847,5665,5581,8428,5665
6308,555c50a74ea738c972fccf2b71fae020434cbcfb3279ac13f9d8c5561460a27c,installer,797461,3154,6432,6340,9494,6432
6309,55703976084d5863c3ecfff5adcebe28d008c48213582d0f00abe40d3d10e1cd,installer,547252,2209,4253,4346,6555,4253
6310,5577319dcecc230ad634718238d6e9b4835be4fe1b8fbf7d9214fb18ec798d1d,installer,978951,3984,7664,7893,11877,7664
6311,5582cc6959d4159617d1463949b96ea3a6949b357a5c96774a9ef304842e1902,installer,563111,2198,4624,4408,6606,4624
6312,55de6245cbc26791ea86cb384c52c3574b2257861fd657c15ae6b308d4ecf272,installer,286631,1105,2252,2347,3452,2252
6313,564405b989ea94c5cf02ba89d1bb3013a22022771bee3e0fd64cecae5f7e3e22,installer,579029,2284,4426,4611,6895,4426
6314,567eefb72e6d97328bd9d41edb8e11dfc640f6a16a82cca0503dfbb3f32c581a,installer,503560,2005,3894,4113,6118,3894
6315,56abc9d748035226c8cb5cf64a0f3771ad69e623d33a295ef5b9bf799e91830e,installer,807129,3171,6292,6424,9595,6292
6316,56b1dd161ceaeef63e6aa2b37c905b5c15b0178647129cea59b3f1c146df4062,installer,493514,1898,3856,3855,5753,3856
6317,56fcc03d47f21724ac48bfd681dce646ea929392f856d6e209c93ea110b76a8a,installer,286625,1120,2257,2348,3468,2257
6318,577b9121bf951a639fdf3bc34a72541e12e4c4a08a13800e3b30eb9bc01911bb,installer,487762,1996,3852,3843,5839,3852
6319,57d9191c20eee96f3545b518b50cb07a5724ac28633876378bb21dbf9ea38f3e,installer,1014022,4184,8295,8323,12507,8295
6320,588b73228acd5a762c21f89eade6d749ef37696ee00df56eee81420412826abe,installer,273678,1111,2154,2202,3313,2154
6321,588d358da178ad38ae2f56b236a6f55553098b40fc23806cd9f23d78f26bf717,installer,808183,3118,6324,6734,9852,6324
6322,58b291297a7e919f04331d13f0c0db59306472a79e35d17c468d22b09a19f7a5,installer,1013652,4044,8122,8310,12354,8122
6323,58bb7bcd0e11946a570bd47851e1f90b4f390be302ef84964baa6cd94af24850,installer,475979,1845,3734,3746,5591,3734
6324,58c678b7e6b83d3ba1c751f3dbf139c5534f0c34d9ae2ef73ec773c7063df5ee,installer,979114,3888,7824,7963,11851,7824
6325,58ce5c3c9f8087834c72ec7cf44f8dc586f309ed9dea901e57f0649488587d05,installer,722005,2784,5674,5669,8453,5674
6326,59109ae582122a413d89c842c6228281b40974e59886dbdc863e3e6c03dad61b,installer,503559,1976,3849,4099,6075,3849
6327,5930a676d8007aecc10ee890f62c4184a4ab95cf3a5ae0eaf62df8ff50382e69,installer,1070792,4129,8413,8603,12732,8413
6328,59363bfc1284474412a70994ccddccad5973ce7296289ea8fa7f202dfb981902,installer,509837,2011,4026,4111,6122,4026
6329,597f6199c576539106c20cf5cb6c0a90807e5cfd6882f4f135cd662f33c37130,installer,434019,1748,3422,3422,5170,3422
6330,599f4446d13e8c4878bd73d862c8987b3842cec7d5df05843bbbfb9bb5716398,installer,672382,2571,5304,5403,7974,5304
6331,59a912e77fc983362ed376398ebb19088626fb16c0d09962cf9f50a630765990,installer,497473,1929,3945,3942,5871,3945
6332,5a7ebcc012d5f4daf75a3bb033e0dc74c2318625300775847df2b04a67655299,installer,286620,1155,2145,2257,3412,2145
6333,5a84fae2627fefbf0407f9fc775d7d4432786da29d1b6390a74e8a561c5b0617,installer,808664,3068,6381,6465,9533,6381
6334,5a8e387c91b08b6dc9c020f8239e7d2625d910efdd2217772ac14fd83ffa7332,installer,793159,3174,6221,6455,9629,6221
6335,5aa5ca8eadf5ad889bd8c8d57557a88071eb896396fd372e22ca9a017359b763,installer,978962,4070,7680,7925,11995,7680
6336,5adc8de7f9bd0213618b0d16e0788015afb5422b7db2cf70fbce3165e2886fe3,installer,562987,2290,4340,4440,6730,4340
6337,5b36be8c6c03ac90180774487de058c82fb20258383fb973a8e2ba19ef7ac204,installer,1099095,4637,8772,9158,13795,8772
6338,5b76784a0e9ac96d73403f3a3131c0bbb873169aa5b27c8789d09c293d26cdf2,installer,487747,1984,3812,3757,5741,3812
6339,5ccd603782ce88c3722d8d0b64777e4745329b9f3f12b443d7e8bfb0e45a581c,installer,503559,1966,3828,4039,6005,3828
6340,5ce3e58e9e6a8036f2796d1353f4e2668e2f5450cb72bbde92908465fac1a36a,installer,279289,1120,2193,2080,3200,2193
6341,5d10ee35baba991adfd488f900491cf5abf49a83bf078ca3d5479a37516b8c68,installer,563007,2230,4358,4410,6640,4358
6342,5db17304c747370badb7580ab9827bc023dd6ac83c2cb35edeb58599445b2abd,installer,277556,1054,2093,2215,3269,2093
6343,5ddcb59d2dee1728a0563739734b357aaea5eada71daa15bb7e10d01f05a5ac7,installer,569162,2301,4505,4404,6705,4505
6344,5de4c8711772bc14077b0c6064ab0f637b0ee26575648751218afec28b5086cc,installer,720279,2781,5719,5595,8376,5719
6345,5e5e064d859b20b2b60000031cc610d3c1fc2749b8deb14aeea53b638066b583,installer,324847,1295,2584,2594,3889,2584
6346,5e5e2a88b71315795c9483836ed6c714938d9b575f46ec2607e6b353697d3163,installer,720286,2871,5513,5497,8368,5513
6347,5e7b2a2a0b3e46e055ce438cc39939e9e3df55d8b9e13df722795985cd9dd382,installer,993102,4086,7877,7889,11975,7877
6348,5e7c09fbab62a0e4ed3c84707dbff138fe60ee98e57e69715723f3dedbb6a835,installer,274848,1067,2132,2160,3227,2132
6349,5ea05ca8af70bba1dcc0677110faaee26d218f9b1899db749fdd9b3eb28d51de,installer,482131,1947,3722,3776,5723,3722
6350,5ebfe1647311b9ead49f55e338647691e910aaee8fd669d74853abe4f31335a5,installer,1011998,3958,8156,8140,12098,8156
6351,5f2bb80b4f07e2c98558f2993dcfa1b551c1281bf852a11f88c6a34ba05034a2,installer,3639705,13580,28628,27415,40995,28628
6352,5f84de2ee73b1049756f7d8a920acc633bf9f5ca1bc633b03ac23027bdbfd46b,installer,576666,2284,4352,4538,6822,4352
6353,5fa6523cbf8dd921cb6ad8370413e2914c5f9f38394e2065134e02f5bd395e81,installer,503559,2023,3902,4106,6129,3902
6354,5ff5eb6996c9d57649ff3f9d43128f14c9c624dfa6753e9b5ee5e9e3e20b913b,installer,276821,1090,2185,2080,3170,2185
6355,603227f792f01664469f92703aa8ab76d6ffdadfd672be0e246e7fb7281042a7,installer,3472677,13461,26965,26756,40217,26965
6356,604223bf6d19bea9f472d536e7cdf304a05ac709f32e92059ae450d166f29243,installer,1092601,4425,8681,8888,13313,8681
6357,6093718adf4d496d5bba22608087e2d6189ceb73e446ed5fb525e8193b6f619b,installer,869156,3390,6865,6908,10298,6865
6358,60a32eb155a12a683aff5d1f629245ed8f9108f2e3230b7fdf28155e0d16f81b,installer,803027,3110,6166,6305,9415,6166
6359,6109b9975dcdaac2debde5e0cc908df3d86c2101dd068cb0eb08b6a3b280e2d4,installer,868100,3442,6733,7024,10466,6733
6360,61902c3f6484bb6dc917b4171078864c6641cb1cc05f675996e3c1a1449bab2f,installer,811366,3339,6446,6506,9845,6446
6361,624ecc1b324b37d77559fbc532fe64809e1830e60da737ab02c57bd81e535689,installer,809882,3104,6402,6531,9635,6402
6362,62553ea85851aa3da53e6372be13225d9d70368a0d325a9267d63be4ad4dc7f4,installer,93055,366,731,785,1151,731
6363,62a5615662bd1daf25a99d7a49225fcfe3fb4131abfac6c1e48588f8914ef70f,installer,434047,1749,3396,3418,5167,3396
6364,62ae34b38e34c215e9633eb056a8434a5d26c1f3ee2130ccdd8dc8e3276b1692,installer,503560,1982,3847,4106,6088,3847
6365,62f625c7c88b9e6cb7b1cdf1e9ecd5cfcc361bd79d5d167e589bc1e2dfa585b8,installer,799737,3099,6325,6392,9491,6325
6366,631293c7d2761065200fe2052f5375d86896b979aef17eb684678fa4059389f9,installer,860325,3366,6632,6871,10237,6632
6367,635529cbe9612d34aef326d152ea075f9b12e8ffc13267c5f0fff53761af2545,installer,506849,2013,3864,3949,5962,3864
6368,6383161f9ca17c6de7079ebbc23efb08c2336a4ed880fc12f38c47495156cf6c,installer,525427,2017,4020,4011,6028,4020
6369,6390e2171079c1e16980de55e790fa904cdfb0b0ef58d611436c5c6b3f05f19a,installer,599713,2277,4771,4853,7130,4771
6370,642a4e8b81fc8d56a28ea96221c7dffd0e2aeccbdf4735d499279c36279cbb32,installer,722055,2745,5536,5648,8393,5536
6371,6489510ee5e65d584baa0ea34cb92c2a32e83ccc1e3af6c50dcf6901eafcdcb2,installer,503559,1963,3907,4091,6054,3907
6372,6492bab7eccc017d5e0cad16af3978e5ab3f355cfb52ca512abcf9ef50ea88ed,installer,809186,3099,6268,6466,9565,6268
6373,652b499f53135bd1247fa5b2fe59e0be195f8e86a19dd5d1819fdd5da7f6a02d,installer,563010,2267,4338,4387,6654,4338
6374,6535ad6f1b64139822179c2569aaaa24edd5c499b9a21167314282290afa3ef8,installer,438672,1757,3485,3460,5217,3485
6375,6573523e7c157f9111409aaf068638f4b4c2ec1674e18f5ab150c87257d94156,installer,1073133,4172,8555,8843,13015,8555
6376,659d96503530d3fc2dadae1a0a3c8ee8fff3b504e1afc52765c0ad305765e743,installer,503560,1963,3905,4091,6054,3905
6377,660cab28e8ea7226ff5024bc1db3dec364f13952ed607e57279f8c461eb00808,installer,555270,2119,4390,4479,6598,4390
6378,6613d1de04fa82e6fd723a83e27425f9ce5f0f6ebb0e2710abcb4d471793ff71,installer,4395017,17577,35019,36517,54094,35019
6379,665f6e30baf3d20224277010ac72820e1770401fe192d2bd7ef03335f5d6897b,installer,1014024,4190,8287,8314,12504,8287
6380,6674e617362f8008265e0d809f8294f4e7e12b8c53d709b58e35b3e69be7bff1,installer,3660207,14810,28919,29761,44571,28919
6381,66b3c9fa4aca27985031ef471360ffb5e560ebbf3730902de60379c0f21776e5,installer,559930,2113,4304,4388,6501,4304
6382,66ee692e025fea8d34c67db2ae949de970f1679c414919b8438dbd5929dc38bd,installer,560923,2121,4381,4318,6439,4381
6383,66fac1b0e436f8b3eac7d1c762667e593ff2fdfd244a5240d7e6406c585283ab,installer,276861,1084,2185,2093,3177,2185
6384,67173aa2f572792726af810b9bccbbe3cad4311e789d2098b24ca35b0d958056,installer,811353,3342,6413,6530,9872,6413
6385,677249fcf5cc292775561000eb61c0e92d11bfb0a0a6d3ea344f948e09254bf3,installer,484954,1988,3820,4017,6005,3820
6386,67815c484b59a0cba353b945b37673d4d70f4fc5fbc7d3f9aa4abd6441331a99,installer,482129,1965,3654,3765,5730,3654
6387,6787cb5dd257f435f1b55a23ab5091c32f548e04f02ff529e449de106401e45f,installer,1013656,4042,8165,8158,12200,8165
6388,67d577ec672c9ecd474052bcdf2439aac7f8e364dc36a7434c3ce58d25d738d1,installer,803019,3137,6155,6304,9441,6155
6389,683e3f05136db8ee074d65ecd20e3fd8b028cebc001776d88d70f7a3cb659a0f,installer,283340,1114,2232,2263,3377,2232
6390,6893e8ab7ea1cbe032f40a83f76f55eeced4f25c88e55ae939402a3f6466971b,installer,571640,2306,4404,4537,6843,4404
6391,68c28fdc95fbca41777dfd8e0e3669636e3ddb4f28545e572f60e518c0bfb336,installer,578442,2218,4470,4523,6741,4470
6392,68ffdb5cda4ec1b4b0e793199f12327199985f212c6f54f5dc63767a87566382,installer,808189,3145,6300,6741,9886,6300
6393,6900b7879b8b653bd1083a2430542152b65ae8f310ac8d66a1a093202b771af7,installer,331768,1333,2646,2519,3852,2646
6394,698cfa19c36473cf407bf27923aba7f3218c9ae807972a95f5063fccff3ed58d,installer,503557,1971,3906,4095,6066,3906
6395,69cc2837c0c8f573bdeadadc8e49451d8904bf62340faccec35ef4cf435b23f9,installer,503557,1981,3889,4092,6073,3889
6396,69dac50666476fa43fc55ea165085d9eb0f7fe4fbb5fbfb8be496356f49fbbfe,installer,1191821,4868,9573,9744,14612,9573
6397,6a5b45eee235a79a07dc13ab986039858bc20c35759e8372efdd57b49a6cb95f,installer,683548,2598,5394,5386,7984,5394
6398,6ae19d242117f33489d53cfde75b6ffeb0aa742dab1dbb30539072f08ad12f92,installer,563022,2236,4383,4409,6645,4383
6399,6b2ef33e28a557d7ebb074e0c7825563ae8ab4bffeb6a63e4653e922e014834c,installer,808203,3120,6344,6720,9840,6344
6400,6b3c0a7e2d904aa05055b213fbda5c278f256e4e0c285cbb25e91099066ca210,installer,789665,3149,6326,6403,9552,6326
6401,6b477d51f6287808571c60741fd325e7df1257be5c4f4f51c8eb19b6a23adaf9,installer,720271,2849,5656,5589,8438,5656
6402,6b4e1f0dfd75a436fe7a2c4846c1e7b4c7f63d87cd736bf44a01077c610a8f0f,installer,503560,1968,3879,4111,6079,3879
6403,6b53cdfef16f021a552422ae05867b35bc262543b89a91a1c448a87ec02e2267,installer,584841,2299,4557,4620,6919,4557
6404,6bb0ed2ca0dece257abe5317d222c7e14f76972dc6bd8876b73ce8d3d23856d5,installer,502390,1910,3940,3873,5783,3940
6405,6bb673807baa517e19282dd857915293effbdb370cb3eccfac1488d955368d45,installer,790474,3098,6180,6524,9622,6180
6406,6beee6011c5692d06cfc177efbf8ea159a0f19a4173edb599b6c32be6098ef1e,installer,489787,2061,3762,4153,6214,3762
6407,6c28eb86277e8743b9e6cebb0b09fe90151404d8861c3a63fdfae681ba9a61ea,installer,851727,3593,6696,6602,10195,6696
6408,6c2ea47c2132479f69cc8264935eba5decdcc6fd462841d3b65214ca6d0f2ee5,installer,869498,3385,6972,6891,10276,6972
6409,6c3b9465c405448eb5ecc6c59e2ffa80a24e52743f20926bcc313304e64135b4,installer,1073161,4201,8436,8686,12887,8436
6410,6ca4a74b33a1e8b3314ac8ae56e99e01257b0f5ab3ae0c71170f2035ca18afb5,installer,578462,2285,4600,4596,6881,4600
6411,6cb71f694c61bbc44a816f449859f0e31e184296df8254a2fb61bf7743f121b2,installer,974742,4003,7624,7841,11844,7624
6412,6cfd88f46303c6c8215836e8e125407b7f51b8b2fd3b786d499237e44f90ee57,installer,547097,2180,4274,4335,6515,4274
6413,6d010c0d2fabc050283f4dd1ca59fce690d02bc6d5a71d2a22e8531285186e1d,installer,286447,1092,2207,2310,3402,2207
6414,6d1f2e48034dcebab6c77a20a88f0b0e752c91d4e34cafec8668c2e1a8632baa,installer,1025001,3908,8269,8118,12026,8269
6415,6decdfc89b09afdd9905224d2c1c665066ca31bedd7f5ac90f85cb8c68ea989f,installer,580103,2291,4456,4627,6918,4456
6416,6e1c23ee1b9514323043f27303f3d62dc8f7e9cdc2930c8779494a5adc341b8f,installer,487746,2022,3857,3777,5799,3857
6417,6e62496c606dae40ab50eae81e69a6121b5d6ac4f1b1b0ac5959449c332b6e83,installer,548500,2068,4286,4363,6431,4286
6418,6e8499a9b64dddd48bfd8f0a02470e1620b3c0e090441b4370c2eaa45f973a95,installer,276352,1062,2126,2154,3216,2126
6419,6ef8226045f0ce1791fa74b7a296a514a1fa3af107904c5d90baa9a39e1a411e,installer,868783,3436,6635,7055,10491,6635
6420,6ef8e565dee03e8e3cbfd54efc9459a78340991c852f2cdf827c49674c994ad2,installer,759579,2974,5941,6189,9163,5941
6421,6f01534872f6ddba54c73c21bd6d1b806d915d4775891fde6ffd6a60aa852db9,installer,580063,2356,4465,4650,7006,4465
6422,6f062aa63e9a08b2602260862018930644d6141ea6c9191cf0579ee1725705c7,installer,286777,1174,2260,2388,3562,2260
6423,6f5b9201da4db2673265fffee652d51fea2e3d1b7104c6a0ad28c567629a73b2,installer,282742,1097,2200,2117,3214,2200
6424,6f8fc39bfa1587113bb5f46081088e27cef1ad174723697b044fcefae5e17bec,installer,686246,2709,5267,5494,8203,5267
6425,6fa6cdbb98891e5eff6220e612b1a31d92642acb0b910e90aa247275d04a1a0e,installer,276406,1070,2094,2148,3218,2094
6426,6fd64ab0f81d1dc683293c8098d8d3d1a45401e30611e3c6263039cf33294247,installer,563008,2270,4399,4414,6684,4399
6427,70dd4a741f364ba3a9ac6da59825658dd10059a7d513772b79c711c8f50001ad,installer,790892,3152,6414,6393,9545,6414
6428,70f48270c9fdaf1ce453cd95ec103e0f8bccd3465eb7c376ce75b7e5c51b289e,installer,1013660,4083,8330,8142,12225,8330
6429,710fa375493a99156dbb03ed98801a49e538ab03b17881e2f21c4fbcee7f36a0,installer,476038,1904,3638,3665,5569,3638
6430,71383e63c1b04425ecd98b5dcc4cf5ebb2c8201a419d08a30924b0716c763b3a,installer,1009178,3952,8020,8253,12205,8020
6431,7196105cc2c8fa0933846db28bd21c5f345b43ba1587a7bcf9290559ed4ae295,installer,571208,2176,4427,4550,6726,4427
6432,724aa48548a2c26e8a79b8ccb125001481974a5036e4efbf4457254b4738614f,installer,105600,480,847,798,1278,847
6433,7334764aecb6c5cae5af8925be21c8644f8c503e577f79234e2648c7c6de969b,installer,476037,1936,3630,3662,5598,3630
6434,734a111833f4f2ae367c391d90a89ff7bdf4b7ba0c835388328ab735eeabb3d3,installer,571617,2285,4332,4558,6843,4332
6435,7352ea129d9c8cb9d41ccc8808a3dbe3b26be43545eb7e0299df3ed21180dbfa,installer,803027,3105,6159,6322,9427,6159
6436,7394e27b39df3d2cd0f358d555fc74cecef2659d72b732ecdae8ada852c78ae6,installer,869280,3217,6906,6936,10153,6906
6437,739d416e225dd4628edaf12c90c728d86ac771b22689dfef17d1ffca5b95bcbb,installer,808548,3115,6419,6356,9471,6419
6438,73b342736e8a275050114bec56b8f5a0b09727584811a53ea2f1b327b70a5e6b,installer,548437,2080,4213,4434,6514,4213
6439,73ffb795d70aaf65f23c814e0248ec83d9335cf7d07d041c500f47c103f36d2b,installer,287986,1121,2257,2333,3454,2257
6440,7413ddc69ed5db3f0917471b82bb87c5fc92155cb9fe122ac846a32ae58b4e3d,installer,711276,2784,5666,5542,8326,5666
6441,746638d35b09d884cb7cf8387deeeb18a108da48031426b27397faa6547a1091,installer,922983,3727,7403,7421,11148,7403
6442,746c1abf40a78de4adf2d889a5f7c08922086e1b9086d5c0d455b197912200ab,installer,569174,2256,4545,4535,6791,4545
6443,74c6f7e4f45c9b3be0a0a32e1ffe2dd6482c0a91399979f1d51e59022772a60f,installer,94826,364,760,804,1168,760
6444,74ea1bd8229cc7b9432860d49a8f6bad08df6a576ddf52c960936c2ff05bdd99,installer,1017539,3925,8177,8176,12101,8177
6445,763af2e25e45ef0662844157e49610a51d4357f037736526a04c5f6e239ab517,installer,876998,3439,6861,7027,10466,6861
6446,766ede96e81031d1a0794498db6898aac4faee9fc0dabb817d874a86f525c6e8,installer,770978,3065,5969,6031,9096,5969
6447,769b7964d99865ea2c2c26f0bc79b25fe6aafe2bc5790d82e119a6a4197c9291,installer,559587,2159,4326,4222,6381,4326
6448,76a1a07379a45b81a456083dab5fce2f34b8acb1cc07f481fdde784211f0b747,installer,563037,2255,4338,4436,6691,4338
6449,77261320399de378bb27f30cb213ad1433f38de6124e578faedadb3b14832878,installer,792373,3159,6333,6240,9399,6333
6450,773682240b54ba3cc79819ea23d4950df99da92ba38edfa47aac878eb0dd3d79,installer,759188,3035,5952,6093,9128,5952
6451,78433d2bee554aec92a9e1f34ac7bc3046d897cf331f651ac14bfef27e321f34,installer,503560,1948,3879,4020,5968,3879
6452,7844cb689c957cd743ddc38d6c6c2085a7c4d00fb36cdbf039d7b6169764e46c,installer,477480,1899,3722,3613,5512,3722
6453,7846cd40b09fef6e1e871c96316203dd095fc25fc5fca97760cba996b3827a66,installer,853430,3655,6599,6672,10327,6599
6454,7856e77fa706b59bed97b3ecdcdab23c8346b94bc686d0c4299e3af65fc60600,installer,974609,3886,7856,8156,12042,7856
6455,787651b115f85cc9952f446b14dace54db6320784314487a437af9e7968837fb,installer,3472672,13466,26971,26747,40213,26971
6456,78ca120cbae44f8e8151768b45485295f4722eaaa9f1585418efa29481b7b77a,installer,923271,3630,7383,7516,11146,7383
6457,78eb96ab46c63aaa5a2a17ecf1a70706628a015d23d7630437b13e45c3400f85,installer,873354,3424,6862,6974,10398,6862
6458,78feebffe7cb3052623f46439eb762541e96f1074d336009f7135b528eb444aa,installer,500558,1983,3889,3793,5776,3889
6459,7a2c5043b4c0d29b73218ca563d4750cdf3d20fad415246d8d4fb06b69af1fb3,installer,974717,3991,7621,8162,12153,7621
6460,7a5bb4bcfd1e5dc9ad643394e98e736fdb8ec66eb04a12d6c8cc3c90b5b5e8d3,installer,851847,3663,6666,6576,10239,6666
6461,7aeee9775ef7aa7dd9dcff6058f311ac294f2f4d439816dbbb0f628b69b41290,installer,503557,1953,3890,4083,6036,3890
6462,7b76eaa0103aa00932cca963f1a0131dd62361dbaf19a4d62ec351c37de16a8b,installer,503560,1929,3851,4062,5991,3851
6463,7b95c1879a43ddb01be2fcca97f31964a8f59aecebce5029a68b623b9841b214,installer,563007,2151,4320,4365,6516,4320
6464,7bb4f541afff625f9c2c12171d43caf2f6a80621e21b9f6742922db866988129,installer,682252,2606,5377,5446,8052,5377
6465,7be85393c33c75248a039191fc90fd11b51985dcde4869a6160c58798638b6cd,installer,287979,1071,2263,2349,3420,2263
6466,7c27d2aea938d12c896620e7c61102682085657c9410dce51e43d39ae73ce5d5,installer,634717,2426,4951,4917,7343,4951
6467,7c66d3df4ecd7c883a31790193d5123c71afe293f76ef3c4b57a97bd76ed51f0,installer,851747,3667,6760,6630,10297,6760
6468,7c8beed68e54f37f99ea300fd284ce922e409cd84fc27eb37e6f3a6bf18a99e2,installer,675225,2696,5332,5410,8106,5332
6469,7d2e53bcb84164abd740315051127dcd29a4c4c054e901e14ebe9d261cd3d485,installer,578261,2264,4598,4612,6876,4598
6470,7d59668ba4f9a124441919029e368e1c765381856a539f3f08d9f415af0ebe0f,installer,94800,374,731,798,1172,731
6471,7d9d1b22a7effbf1a73e2c4a1bdd7a6b61fd37256200980ef705e153ab1da766,installer,488945,1845,3890,3856,5701,3890
6472,7dc582a6a77525eadf1f1e02ab68a55d0792549437d46d0e9938a025d27f51e6,installer,3642499,13601,28641,27429,41030,28641
6473,7dde42640eeda0406cd7ddab5361426e5cbc9eb84dc15b3d55d8e4a25c5f78b2,installer,563022,2270,4373,4433,6703,4373
6474,7de8363b0f88b528ab60437eff999146a34a150709d196a57c2d6d5c0496ad25,installer,3751603,14108,28998,28283,42391,28998
6475,7e192a3fe8a4a3c69f708679c2e030ec898214f4a905b800b6b8bce86d109389,installer,999156,3944,7938,8195,12139,7938
6476,7e653f1df50abb6f94c848501f39ee80b6ae1840ac46defa04fb9a0fd052045c,installer,563054,2256,4356,4429,6685,4356
6477,7e6bf71a5313835ab96a4d4ac5922a57a23f09b98cbe36a5ed3bbc3e09cf2885,installer,571161,2189,4420,4563,6752,4420
6478,7ee4ac182854972c1c1b5f69dd7b420127b89e0defa34fc35e7bc057d40a9e2b,installer,792375,3163,6293,6244,9407,6293
6479,7f05cabaf897d0907082fcf1cba8ee8e281dec59c61ac881887c203e3c223bf5,installer,584502,2261,4490,4515,6776,4490
6480,7f34cae72168f313af994eff9760cc9012e2a23fca6867bba787283f2e06f9dc,installer,94824,362,757,785,1147,757
6481,7f82e2aed021452a818d4249e1254c6ba0559597a9a4e7875c9ae2440d408d18,installer,503558,1921,3853,4058,5979,3853
6482,7fb83f9109a6d8de420fe7e7fe9fcb9c8fc7fcd219d39cca82a69efd287a2163,installer,476038,1878,3643,3680,5558,3643
6483,801c65bec582a4f3c8e15b90cce080e512c5f3cfd5db82828a70bee73b3a20e5,installer,523072,2103,3945,4174,6277,3945
6484,80437daa4348918a033efcd3fad48624a60d0fc47ba89d0a862a3c5861fb0fe7,installer,502397,1949,3956,3854,5803,3956
6485,8059ef786792911b79acd9f8809bf4c05d9e9509f0cf3d44cb066bf8bbd519f4,installer,571234,2192,4380,4581,6773,4380
6486,808d80a739d17d050cca48b8416623a4f5168ece7115c5f2e863bcb1df70f339,installer,974549,4059,7691,8008,12067,7691
6487,809c44257e23794e4e69e1347d3022beb22d48db1474fe748be62c5567d50a2f,installer,562992,2196,4324,4362,6558,4324
6488,809e3fc00421269facfa05f9527cc76c807520b8fbb34266fc863d7f5817c50a,installer,803002,3111,6150,6308,9419,6150
6489,80af28ebc4c7ed960a8844b6e05d292e50d295b14a2e225532630cdd32e038af,installer,723576,2860,5554,5762,8622,5554
6490,80b476e3a8589dcd4034eac815d2990612860a4e8a9574ad9f7cfb5d8cab557f,installer,611095,2478,4799,4859,7337,4799
6491,810859123e44e7d1e733af844a36f3753c936161a115c3a1069a9dffdba36ffb,installer,487742,1988,3821,3794,5782,3821
6492,817605b58fca71c17b9a8924ee7e10976a48be41328f45cd2ba8c66177e95e5a,installer,578849,2260,4566,4491,6751,4566
6493,8189087955a3e35179a8ff891dc5ff9f0abfcd535ce1884abd9ca08dc9149a92,installer,212971,804,1722,1850,2654,1722
6494,81bcff8a34bd1f4c63074786b219608d618db6f39c0a80bc5b01a7f6ac291a9d,installer,523074,2063,3942,4229,6292,3942
6495,82624bb950d704063078cd9b4d419b51242c7bbde59938641f39c419f1d4a063,installer,1011655,4048,8102,8269,12317,8102
6496,82fb9cf567c8af4bf91cf94ea223d0540ec997482e7d623b94827c23d914219b,installer,503561,1971,3904,4095,6066,3904
6497,83dbe280b71256b85b9642098d15fed59b67ec582ca42c36a6dc0b28f04e0178,installer,503560,1985,3846,4106,6091,3846
6498,83e85eb857afc09583ef1ee551cab067d113840cdd91a0f983963b85b4fbdab5,installer,606583,2280,4642,4898,7178,4642
6499,840e00caa0d65709c2553eedc6a55f6f24bd63bb1e3d8543c88847d0748a605c,installer,600149,2258,4751,4810,7068,4751
6500,842b25ee416fb32d8239d6567ee2823d8f611c812eee00c93e4228736d7da875,installer,286429,1106,2201,2223,3329,2201
6501,844ab3c3f3c1ab2cac65d18e9aa31546bad47532286b658a452b7eac9913108d,installer,571641,2084,4301,4665,6749,4301
6502,846a7a9ca981def1da0afdc53216456867e9c15c1fa939d7e61784fbd2a34601,installer,720271,2854,5671,5564,8418,5671
6503,84e532dc12e8d3113004ae4ef472dcfea40f9074d781dacb9238a3bf44df4a3b,installer,724448,2770,5873,5578,8348,5873
6504,850e581635db72336666f26eab47f606387f56b3d1455c4536fd664ac37f22b3,installer,716714,2816,5558,5615,8431,5558
6505,855c5bbe09c15b85a13d67d4c10ba96a6b45fd4a987ec4cac85899d3e0235993,installer,503560,1973,3858,4077,6050,3858
6506,857333ecda139eaeaaa96ba0864bfd985125272b408cf85b61eedf0a87e500fe,installer,974771,3934,7633,7964,11898,7633
6507,85aad7f5aa9fa4a21105d22c2e9d279c1f033d107b0bb0784b0a59465a5e37e8,installer,568807,2130,4448,4576,6706,4448
6508,8671b75c4cee1f32ddd391c59fd120a0a49b03317d5b7d93b7817f2f011bc1a0,installer,694586,2731,5465,5674,8405,5465
6509,869dda016fec1f969c20a8651da2b094e836a3891645af17a9c0426e1cb44284,installer,851762,3647,6739,6633,10280,6739
6510,86c696bc1401638dc86fd78c3b1fb9fc64c038c4963df2f7109bb3c2b5b37311,installer,476039,1879,3645,3680,5559,3645
6511,86d627433e8f6a7c9eb69731efc2c335df0510d42eff5bf8b9b7dd1dcebc0b81,installer,858731,3371,6899,6851,10222,6899
6512,87c8db49470def7a0906b706174bb739a6326dd21af10909165984f35b55ab24,installer,510932,1973,3969,3983,5956,3969
6513,87ebc4c33feb06ff171f97e9babf928c2c485deed0e2ddc477fc160b8b58b26d,installer,584416,2223,4633,4708,6931,4633
6514,87f0dbe8b5ea77e6c7274980a0a2d1be2245d1d0f40aa38554872cdd2443a379,installer,584734,2302,4619,4683,6985,4619
6515,87fdb22ea89300da334a1e34a6ed381bedbfab15012917394cbf0daee2d21a3e,installer,286546,1094,2291,2295,3389,2291
6516,8844c1ead76a3599abb1d1c05df80ce3564c7c71349ea1c484c2f52fab668dcd,installer,802402,3093,6372,6491,9584,6372
6517,8845f68f0546bf737cafcb780f74c90f32e737e46be1c2c67ac8929e4e6dee7b,installer,276817,1070,2192,2086,3156,2192
6518,885b1c133c38b368bfb1054cab8ffbd5d551f143e0f230462e2b341ff52235cd,installer,286535,1177,2258,2372,3549,2258
6519,886bbb205b236df456874e3b5812f7512d47d3e07d7309453ae6f117a8026fe6,installer,530264,2057,4058,4375,6432,4058
6520,887d9409be9399783b0a9c204fde5c78424faff4d12321b681781682d4c13c9c,installer,873092,3326,6851,6983,10309,6851
6521,88e5b283dc8432037a50e9336e58420c728eef5afa367085c71001e0f27d0f5b,installer,503559,1938,3880,4052,5990,3880
6522,890bf6892cfa4dc66e9b5478e803ac24e2dabf0f5a997d0a95838bfb73d43cb4,installer,569365,2231,4477,4534,6765,4477
6523,893ef0b8efe0306d9b2cf51e070db70554c01eed2c1deedcebc1c869c5689618,installer,487751,2011,3864,3743,5754,3864
6524,894748c61bf2fd7950b7232a14a5afec104176d810da2a8b694087d003eef889,installer,559571,2191,4417,4253,6444,4417
6525,8957d951816224f30d2a3d73b16865cf3010f5771a050ecda55993e186beed8c,installer,684629,2612,5373,5396,8008,5373
6526,8a9e697a52957a9b1928d57334ebce702e7666beae9e9c5e39dcbab6d571a36a,installer,562998,2287,4333,4449,6736,4333
6527,8aae83d7dfaff9cf3fd577b1f0e9ca39834b91138cefb2393432bf3f784af9a9,installer,3662986,14866,29252,29947,44813,29252
6528,8ac1d8e76af0f45e22659213caa3d05ff116a66e7cb2e5253afd92bc7c58587f,installer,476039,1936,3629,3662,5598,3629
6529,8b338e7e4c2dd44c9ce918d587a5067e3d331fed86801edc14ca371a576a1c7f,installer,570857,2180,4463,4569,6749,4463
6530,8b63e3f6d47e716505d4fbf1c755b39822ebc14ede36dad5ed57ac706f8a5b3d,installer,571163,2193,4382,4575,6768,4382
6531,8bcb9dd91c34a5f0ea473ed20b139a212090da52e0f92ce378c7444a8ead2699,installer,272496,1126,2123,2152,3278,2123
6532,8c378fb83c35b9897d3f6ad66f6adbc42072fcb587448ddc9d8a02ad2ac69a8b,installer,563072,2226,4404,4422,6648,4404
6533,8d0790020bdc7dd57e55c516dd6d8c74bd4af83eb0a090d69ab4f785bb9450fc,installer,809180,3092,6277,6480,9572,6277
6534,8e69ba4a9bb2d16335eeefbf00fe048763e6ed30ad445507431c86631e7dbe07,installer,809603,3205,6374,6574,9779,6374
6535,8ea85769fb23bab874016ce08cef44ae7151dd61a01c1488f9532dc21343b322,installer,854176,3292,6599,6835,10127,6599
6536,8ec7811cf18664d49c60a0337313a62c352d657e8155e8d54bd33bc773767f3a,installer,3659160,14769,29065,29716,44485,29065
6537,8edb4768bb17e9a01e2231c8ced4e277c1d7f49051480eda28ab3fd835492684,installer,563075,2240,4351,4407,6647,4351
6538,8f0160c33929846e633f3430f8f46069c36bb841ff1921f9cea857082389f1df,installer,487745,2002,3822,3818,5820,3822
6539,8f09b8d5a0d32a66ce97e94d166fa5db0b153b9f24b30bed9a82107faec25b2b,installer,555282,2134,4376,4466,6600,4376
6540,8f16046c80a5f2f148eec4381953a50a1b423a8bbc89c78eb0f8f8b3ee3f1f4b,installer,809589,3234,6367,6560,9794,6367
6541,8f988b3a8a349573225a1090f9ab2ca532c41123d4a888a52d680bd07eda17d3,installer,286547,1164,2260,2279,3443,2260
6542,8fe42a4afa6093d330a07c35107cf8a08b8985412790d0b594456fd2d3d01e59,installer,503559,1915,3853,4051,5966,3853
6543,901884a783c30fa285c79fc665023724f378d3e56b78faf6a28b5996d8a730a9,installer,851690,3642,6697,6722,10364,6697
6544,90657842558868b8ad799a632f71a1d67b96ac628ebaf883b7aa784c4741669c,installer,578162,2245,4591,4597,6842,4591
6545,90737952b5e2f3858b4f2f46c32d505de3e3a1f6af04323c1e4a90e477730431,installer,696490,2853,5576,5778,8631,5576
6546,90a9d13d382aca67a11e1b100d6905d354331760fd6cff68b26c144aa56d41fd,installer,801627,3145,6235,6473,9618,6235
6547,90ef89a167d309cf53376a906db7b440d604ab76ced392d0880bfea620727d70,installer,277591,1041,2110,2197,3238,2110
6548,91eb1b86838ae2c1ad8135fcb85af751b8fb252c72a197a8f0e0a4b9f4d7e9c9,installer,720276,2836,5664,5600,8436,5664
6549,922a4432f89558a4450fa27a58ad045e63221d5a7c737c26ae75c0eda9408927,installer,873088,3327,6858,6957,10284,6858
6550,925b5106646dceed8fbcacfda40d64773fa1fff29ff31ac2f106bd5a5a909719,installer,689341,2771,5348,5333,8104,5348
6551,92b078fd91cfff7473add89965b110b3479eae352d3bb7c2c07bd528a7ed2e88,installer,860335,3312,6927,6980,10292,6927
6552,92cf4745715e8be56a1e7ffe25c31d2ba9f6a62c39eb28913c0b7d4ac952e85b,installer,1186570,4947,9801,9667,14614,9801
6553,931c0a06b9fa084cf21776a803941ed13af2998c5bb9c4050a9c5e58e51b8323,installer,93178,346,766,773,1119,766
6554,93381f4d90f0ee93f9c798592f464caba0128d013f5a2281750256545784c593,installer,484875,1953,3898,3807,5760,3898
6555,935b9e97ae33d96a88b5f3f831e9a5f04101a88cc67e4b7b3256f0da351780bc,installer,792114,3082,6272,6392,9474,6272
6556,9389ea1bb533c8a320920cb78e9a91b104763bf757cc262054c9fea0949e1e23,installer,563022,2242,4595,4432,6674,4595
6557,93a2d6eec033572ead110ca9888a4e99b1eb3c2b3c4e5e2903826d0f2b3ba7f5,installer,563037,2245,4379,4444,6689,4379
6558,93b0a964d419e483d56951f9f9e0029f5cd0afbb3c218810dd2644a1f62c4e86,installer,696566,2816,5438,5753,8569,5438
6559,945f9210953a17d8ebf3898ee379ea1173bd26f1f60ce29afbf419c67dcd5023,installer,775304,3021,6020,6099,9120,6020
6560,9595d92873d23f3815133460a3dabf61b00a0848b6de914d954a12aa41025b09,installer,279334,1105,2195,2104,3209,2195
6561,9666045064c562d47f01b58dbf0954cddf4f6c4d6b0dad61bfc416d7a1d3a19b,installer,482897,1884,3734,3837,5721,3734
6562,966a808b01e0fefa379a85d41cfb9ccfcf7669e57d1a22b81c4de1de62dc2cb8,installer,476038,1893,3629,3692,5585,3629
6563,96878c21adcfa91a6641a65bbc38ba01d421e19fc875328f1f711c3a4c350676,installer,585373,2273,4691,4671,6944,4691
6564,96e320a5db3ea500d2d6502f1ece06ad3b98cd534cdc2150649e92d3820971e7,installer,3656212,13942,28128,29323,43265,28128
6565,97a6386588dbf4a3627232a0d431dcee3da424e6d435cd5cd629d1154dfbb74d,installer,484409,1969,3769,3949,5918,3769
6566,97af9e8682df06e04219c1b5d0a68f1c9d946ef79c7d0e29f5600b471f9b172a,installer,568809,2123,4458,4582,6705,4458
6567,98455605081a378b1a3f1e9e6038cc2594d387b42322c7cf44eae19cb5a4c417,installer,4260180,16898,33314,32291,49189,33314
6568,9855bc2a72e63ec53d872f853a9980c173a6378fdb3bee9749714190e40a4387,installer,578906,2291,4598,4599,6890,4598
6569,986abcc84c77f4f2eebd1f95659a07d796d6b8909dc9274edd672f0c39747002,installer,485564,1890,3869,3811,5701,3869
6570,989896eeccc56d5446d4b8aa628d50d8d38e2e29d70da64c1f349efa807dc965,installer,1073165,4160,8570,8811,12971,8570
6571,9941610e1bb5727d15221804a1eabeab78462754c5ef21ca86a320168dc867fd,installer,94823,362,739,805,1167,739
6572,9949ae59681a74a66496a9ecd5ac8b6268ca595f49f825ca257407ce14d38f93,installer,974547,3978,7693,8044,12022,7693
6573,994a9026347983d504e72f5af680d78e604007cf830743b12b6de1b83777fef4,installer,792082,3091,6287,6386,9477,6287
6574,997b40c98ed0d530c932f4d0108762bcb9a1520920b308aa9ca778af0e4d0a27,installer,563068,2250,4391,4415,6665,4391
6575,99efb75665cc68bddacd5d6bb00738c331ed38bc5b196636adcc03a75f26d931,installer,515028,2104,3928,4033,6137,3928
6576,99fb7c984ee1292da6f9f63ee84f9143ca01a574d9d295051e739b253436cfc7,installer,491808,1921,3773,4032,5953,3773
6577,9a1769a61254bbfa7655cb40a3baffaf66f7b89ba0c822cc9f7f0f056c94af23,installer,528255,2175,4195,4336,6511,4195
6578,9a21a06499484cf87223051f85438e73573d06d3a906be1bcd78937242216730,installer,1070758,4129,8394,8628,12757,8394
6579,9a604b9d17c2306051d5f9af27539918c4411d077ad80fe17af1eee557e669ce,installer,683036,2609,5367,5399,8008,5367
6580,9b64d7f435be51be8ad47c1afe842348b82eafa55b8f11b7092edb6108ebd5b7,installer,93227,369,758,744,1113,758
6581,9b6540adfbc8c033286610d97390b5477832f4acef42c2fcb0b85c18c963faf4,installer,519445,2146,4034,4047,6193,4034
6582,9ba2456bfcb154082f59db562bea528e538e021eeba5153d4199af9f8bcef7e0,installer,684519,2588,5414,5414,8002,5414
6583,9bac60f09ee55552ebb0017896c6420bfbe8f8d0fca126c34afab22889b10cd9,installer,571720,2281,4347,4548,6829,4347
6584,9bd68053080be59a437b389766a089c7e0930be79fee64acb2a9a1ad1a5ba3d2,installer,684221,2595,5411,5406,8001,5411
6585,9bd7739d09603a564df01a14d9621a82d4b811c1afabfb5e7ffd7fb091417e1a,installer,600751,2397,4595,4651,7048,4595
6586,9c6801d1da64663094db6b77ffee2ab57af6fc2d00654fd2467729fe11c76b28,installer,1181838,4591,9450,9480,14071,9450
6587,9d9c0fc8a3d729c02ff2d5edadb24366ad96404a9c9eca1ebbb8bc79656f4152,installer,568573,2218,4459,4421,6639,4459
6588,9dd994d974b2d13d3dc9b11162b95a27c03ccee63901dd067e3eacdc40aa4f7c,installer,808652,3062,6370,6463,9525,6370
6589,9de60c2d727bc9b02b6bbfcb134a9015606ac045965fae842f6bb56ba935209e,installer,93228,363,766,763,1126,766
6590,9deca27f74f379ee2f7b0e86c2db046fca7b05dc7add199a48a5bd48fd66e232,installer,812291,3183,6433,6414,9597,6433
6591,9df61c945cf3eed8f31a039cbeb01c78d93fbec7f6ef82bbc690b098aa875071,installer,503560,1976,3847,4099,6075,3847
6592,9e2b90e89084b6e8ffcd30cb105bf103bc2c14860d0de02761dda237856dab68,installer,503559,1925,3871,4042,5967,3871
6593,9e8426fd3ed1e322f3f04e05776cb1dfdbe451a5f1e27bb91b69f0a8ad2cb1f9,installer,1011656,3965,8232,8214,12179,8232
6594,9f450a8fdb94adebd5d995d888cd70922a55b13e9f9d10d6e9e344ad833fe46a,installer,563035,2220,4372,4407,6627,4372
6595,9fa83ab232b6a2201255f93b83fb35454745fd298689600ee37b49121a334103,installer,811764,3086,6489,6573,9659,6489
6596,a2597eea473ed40ba08e9205edc8c90d95159b45fd2a55e5a04d0e2c13c59c73,installer,690888,2663,5395,5412,8075,5395
6597,a26dbafdfd43a18b3af9832a4cfc64f10126885cd430323c28828bcb1c80c1cf,installer,999153,3945,7955,8184,12129,7955
6598,a2b3a3d9dcd6daef246ed659e83feb6597325428b18a14e7f84e4ef58915cc1e,installer,808080,3249,6356,6613,9862,6356
6599,a2c943df8ed611dde1446560a810a59f694df3917992f5a3945e1ee108492d1b,installer,792086,3070,6174,6349,9419,6174
6600,a301aaad224ccdbb929734593ea38c8a5018b2552e36f0e7162f7793d66d849d,installer,1097475,4558,8843,8983,13541,8843
6601,a34c72caa2363c771101b9f60b2f37c5307127bc5e3501b41309e63f03a314d7,installer,585366,2266,4649,4655,6921,4649
6602,a353f43cc3e9e84ac169807772c690afa0bb4bc1eecaa5029113765d845ec011,installer,571149,2173,4377,4568,6741,4377
6603,a3661cf19e43f44ecd566ff431a12b3affb4ee86bc1ee3d02c542c98569f4462,installer,944363,3813,7316,7659,11472,7316
6604,a39a5db751ad6b0b6e0436d4d7533c8dd669ed1c9d7e51af49d5f3cef99303d5,installer,476037,1940,3670,3691,5631,3670
6605,a3a777c1a793375f053ac9a5dc532e02398f9266e0188af2f37a96f8886945e3,installer,274537,1078,2177,2058,3136,2177
6606,a3b417e536c14eb34ab45608aad42b792ff7f5303a9729ae4a2e02a5cc9bb714,installer,94823,364,763,783,1147,763
6607,a3b4877ebeb9c874f6dc5188401faf259df2c0c9701977b35acdf93b2b10321c,installer,510435,2098,4008,3981,6079,4008
6608,a4ca84b3aae4b0de9a5bcbc874f366a5317eae3bcaa92c85fd5c60e262f7ec06,installer,993103,4082,7891,7885,11967,7891
6609,a4cd1152dd3a40a423bc3e347d063fbb131b9215998befd9b489e43deaf4e6e5,installer,279096,1112,2136,2195,3307,2136
6610,a524e518d8363178c51ff8dec5e0540a38d61951e651bd147ef1f69894530706,installer,874827,3388,6921,6959,10347,6921
6611,a5441cc3739632e1f8fa781f9a2715aca24eeb94ec8fe51b5be10b429feddafc,installer,561328,2157,4394,4363,6520,4394
6612,a554e0e56e7da7c905d094da0a1a23a757a4f709d70c6883900011410db00cd6,installer,477110,1857,3727,3698,5555,3727
6613,a573fba114506f0036a27dd25a9f93c2e823a8fc70edc50498ef0aec550e7971,installer,94825,369,743,753,1122,743
6614,a5767f47c48e6629901ff7ec54e1c200d823366b6e7cf070fc62bd3c68fe63b2,installer,721970,2838,5725,5631,8469,5725
6615,a6aeed407f03cf659a075c07c64fb7e4f110780273d3e6e76b0e83a6bb150140,installer,622292,2561,4813,5027,7588,4813
6616,a71b261edb6c9960ec3f53132c33dc8508b5b8e3612b9c4c5a69e5379e396b91,installer,210504,779,1648,1851,2630,1648
6617,a72c96ca69048ca346c5631e58cdc4b04a0f2be3932a50ba908095aebae03928,installer,571553,2288,4393,4483,6771,4393
6618,a76ce85890192926611c6315e297738a2e4e2dec28da690edd6e22af385f4ce5,installer,286639,1132,2220,2203,3335,2220
6619,a77c9fb61f49ef8cde9016eb71fea632fa8b651b6a1220c705deae6fb34d36ff,installer,484893,1987,3814,3897,5884,3814
6620,a781dfc10743a77e89ad7223b0643563582dd06773e5feeab2e68a85be74c192,installer,94823,360,779,822,1182,779
6621,a7f6c5e7fe82c570c38b8785cbe8cab502e6ca583e757db89be6c0977cb4ec1e,installer,93224,370,745,793,1163,745
6622,a7fe9d9c9405700317a5ea7b80faa481421fb120479ed6d490d1a94750daf076,installer,868781,3446,6642,7070,10516,6642
6623,a8117da5e77898ba0140df6f1b015df88c06d37dcbe12fea070e405a6f6171f0,installer,312591,1187,2425,2640,3827,2425
6624,a82f7bbf40a9acfec639f4039f2359058ef513679cdbf62d0833b540d05ff0e8,installer,286633,1104,2205,2285,3389,2205
6625,a88b5a695f9735128947448ab192811599ebaf7164d3fbf0fff88b325f5a3a0a,installer,286433,1148,2188,2251,3399,2188
6626,a9b2cd74500e241a70398ebb6ad4f9055973d3127d850514bfb47768c61b5d36,installer,811340,3341,6398,6511,9852,6398
6627,a9ba0e4fd4f6d3043728e06477b6f6a970b8765bb8354c4e99b085ca4bb643f3,installer,719254,2783,5650,5661,8444,5650
6628,aa0a6f1838bab3456361b222af53be9f4e852780512fc251683f69f7d46d0821,installer,515414,1996,4020,4005,6001,4020
6629,aa4fb45db6260a086489db07ea926b0a8015f8da9108db38ea74b9c1f9f996a6,installer,563035,2197,4644,4369,6566,4644
6630,aa902d0bf9fc9c2dc1b608d03d39c1a2146b4c819fab47188e0d3ce9ebe4914e,installer,498523,1935,3978,3860,5795,3978
6631,aacfee525d1648ec8f4b8448c634fe631ebe201d43ed7401d8a77ef8840154ac,installer,93176,364,734,785,1149,734
6632,ab1943087fd785547a7f2daeef9a5872ffa6c9a47981ed8271565e5b9d7967d9,installer,93179,373,714,779,1152,714
6633,ab2c2d4c52d0da954f93271779f324e563786992f407badac2f935a052e51cb1,installer,1011602,3974,8195,8317,12291,8195
6634,ab38b923942444aa60b07a896b4f60677ecf8e4cf467009d92b616e05ff3a2f8,installer,556315,2242,4295,4394,6636,4295
6635,ab653d7af08f9f9f7a14cf651a34215f2935f15b0b8d4705b0b7d7b837f8f618,installer,476041,1956,3662,3658,5614,3662
6636,abf033f8db895b60fe13edbcd0633f7be92e12e67318f36bad8820f0dfe102fa,installer,801638,3141,6217,6483,9624,6217
6637,ac246d0b1ff004bf9083ac243f0a6a992a204cb8db36a4644cde0959af790b53,installer,500558,2004,3891,3855,5859,3891
6638,ac69b76ddde71bbbb983cec533ed56155e358ede8b9b4ca0a3616f0dd96779b6,installer,493512,1937,3826,3826,5763,3826
6639,acbb8e9c80f50c9fd710350c87fc06c8b0dec5eb595640e8fc60b218972abb8d,installer,286578,1133,2239,2346,3479,2239
6640,acedc9041d8315db027548b2cfd172d38eabc16f70af6c8de40a4bfe3d404518,installer,488944,1840,3854,3854,5694,3854
6641,ad0de5ee2ae057766be8d7171cd2eeb70565a27a1d53d0fd849b5c15c01e7bd6,installer,3996206,15226,29754,30630,45856,29754
6642,ad1e47e81e908ef26c39637045c9b5d7631a388a709a4a762431990f6d4bfcca,installer,108661,457,920,880,1337,920
6643,ad2dac72f88a66af626d0712c031b2436f318be608b52c3c8e5e63a9f886bbab,installer,3673688,15001,29208,30164,45165,29208
6644,ad355b76448cc4ad7e2d0bef0c1742579cc9c91321585bbb7d5edd867c9309c9,installer,602707,2390,4632,4786,7176,4632
6645,ad9b83f755a5b7f8f4704588eb7652d75a2eedf69132ad312d236f4ba4e404f4,installer,526304,2082,4099,4250,6332,4099
6646,aded7b5688f5df38710544a5debc7c6ddcaf0d40236049aa48e7fa84b8974f96,installer,492391,1991,3794,3846,5837,3794
6647,ae97de898cb7ced7a29eb336ac48aeffb25475051201370f1a737a459076ee20,installer,93179,365,737,790,1155,737
6648,af1538a1a052a54b1c532f397f4edbd7f6ca224ba16691dcbb93418d6274a362,installer,534086,2197,4166,4311,6508,4166
6649,af1757e2187d3debd06091d7286bd0643144fd703f93e58867abd578b120b9e7,installer,487750,1996,3838,3794,5790,3838
6650,afb326ec1fe3d2bb75b37755a64854f154e08df2ed77c8a15f22875a925558b0,installer,562204,2219,4266,4409,6628,4266
6651,afb90b95a8c382f09b75e2b208195007e59d6b91d5d8e7901b985f9add63b0bf,installer,288028,1137,2280,2311,3448,2280
6652,b00163647905189ae7b11c9dee0d22a97b600d33ca71737b9136388b17d07c19,installer,563059,2262,4357,4480,6742,4357
6653,b0258a07136215cdcdbb8ea8f208ae684b75ea6a92990acd19f5dd9bbdb5f455,installer,496125,1912,3787,3985,5897,3787
6654,b04c17f78870221dbf71dd7f52ad38f911901aa8fe3f040f84a5cad6ca573147,installer,491805,1966,3697,4034,6000,3697
6655,b11843a09584f181dc29c59978d3502480b02ace84aa77b226b8458877112ae8,installer,851657,3651,6625,6612,10263,6625
6656,b14219c0ab9c2c7c155a0de79213f1492a604fedc62817138799b97f948ff4f9,installer,286485,1102,2195,2288,3390,2195
6657,b1b44b4d67a94af609c6ea0dd295eeb7973dc4d527aadd64c8e5988414599a47,installer,286371,1053,2281,2293,3346,2281
6658,b27b2dfa602cc3268cc34c4d6ba45c140afcd6f52ee40606a14927f8a5112a69,installer,812290,3186,6454,6416,9602,6454
6659,b2cfe54108abcd2ea2dc79dd91141dd4ba72911351f5998461c80d51660d8f01,installer,974743,3985,7613,8004,11989,7613
6660,b3dc5bf6d506d6db3f71c6a26abdbcf508c2ea4bfddd1f9ec00c4620e5d8b091,installer,792105,3088,6279,6405,9493,6279
6661,b4127e134d7d38558b7579e46de920a0e332e2890e4f199d941dbc867e07bf88,installer,851773,3631,6692,6620,10251,6692
6662,b41d864c62bd5ff824d6259cd9be39c43190390851a65d9fe8dce2972bbd52f6,installer,3662985,14876,29228,29953,44829,29228
6663,b42165aa9b94b5e8c0a0e89f43f66d042d45c692cc4f7ea913cb303dae6f7b06,installer,91589,338,712,795,1133,712
6664,b4d0b251f51db55abb2ffe16047189f65493baca7d57a53b83a7df35a075cc7a,installer,922986,3617,7295,7492,11109,7295
6665,b4f73ff6bf38c7611d80bd971b56a526d856a31d6ddf5f8a67a7bebb9b18eeeb,installer,874824,3405,6922,7004,10409,6922
6666,b52ecc7a550ed9c2e9baf61379b07727a2bde9731a5c8ff1457054d45794f702,installer,808537,3104,6430,6318,9422,6430
6667,b5560bb9a188fd42325315150ae27b5640d5b3e8d1c6bc7a91b45815cf826c84,installer,561305,2167,4393,4331,6498,4393
6668,b60d802b8bad5496372821eaf179a596c7ecf9792921ee0395af4b810b2c51e8,installer,571572,2284,4342,4584,6868,4342
6669,b67dc9ac0301269d0ce2e02e4d3827763c9e3a4b004c272c90a2bb06dfdd7f47,installer,720297,2874,5504,5511,8385,5504
6670,b685f2caa44b640fb4cfc903001d728dd46f5a4543b9a71d897b2c950493e179,installer,562523,2204,4392,4431,6635,4392
6671,b6ac07efffdfb583a5571d575ad5b8745731cd37b926cb79651ad23ab42f226e,installer,851619,3610,6683,6630,10240,6683
6672,b6ad541bdb0d7d9596610d136f3f7a019992d43310fd8f454776aa5db77de756,installer,1001294,3936,8011,8272,12208,8011
6673,b6ae2268b3e579feced759d79ac57438a69c274aea48e8a4f35f0635d63eed3c,installer,1073112,4205,8494,8812,13017,8494
6674,b6cf9cfdf812b00fa1142ce8f848d7a37d5056be063036ece716071a7da3613c,installer,2913532,10534,23751,22772,33306,23751
6675,b718dd891c01bda98f6611936e2d9c1c809983bc8848e356967c8de1bede4383,installer,563045,2237,4382,4408,6645,4382
6676,b71e93b2e8c89ed36a1893c835ff899bec85d2c86b677e4fb6ef615457ee6a90,installer,377101,1503,2912,2882,4385,2912
6677,b762500708d56e51a0c72deee244953d317ea37766707d0aecd878e51408c2e1,installer,501604,1941,3856,4008,5949,3856
6678,b7804a648826e4a3e3b9ac9d007344bb1a14da7f3cc818f0642f6595f80c8fe4,installer,576525,2190,4522,4669,6859,4522
6679,b7d444feb85a03d12c5e18f08c9ad81e411ae7e0f736394ff911f30f3fbef936,installer,481114,1866,3674,3899,5765,3674
6680,b7e1d4c9c62c9f3f76139e4effddd2152ca628d87162efc994abd863d479246f,installer,720272,2778,5717,5569,8347,5717
6681,b807227d811ee3b00625d333b41e728b83e1322545943df4b76dfffbff04bac1,installer,1085590,4376,8569,8933,13309,8569
6682,b8097649ee46ee27ec57de80f9975694dea298503c6f9fef1622fd1981e0d06b,installer,1097165,4476,8699,8885,13361,8699
6683,b81e1bec132f09a1b6242844c787047ae6737a82e05e5b8aa2845c198b8e7e04,installer,563042,2246,4374,4409,6655,4374
6684,b86b1845cbd0606d1ab2be29423e79e0be9b5bb8f00bd1c8b9c9417c41749a6b,installer,803009,3107,6158,6317,9424,6158
6685,b89bc878c946c36669559492d3975003d9f419aeb2ef77097a57c5d2d358bde8,installer,809178,3083,6270,6474,9557,6270
6686,b8a189b4a6f72bfd4a87fde68c9fe55b44991463dbfac377b659b2e5241546a5,installer,503560,1990,3845,4110,6100,3845
6687,b8f04438595b771e88d28ccb77e141b17398c6e9ccee6243b22d25854961182a,installer,503558,1953,3892,4093,6046,3892
6688,b8f62dad3641090b76381094f03b4646da9b59a84701bdf22ada4c6c69e3425c,installer,568805,2119,4450,4559,6678,4450
6689,b8fa4694a560f376f02411c11ad6473b37d65829751fb5bc1b8851fc388e6d2f,installer,578558,2276,4543,4654,6930,4543
6690,b92b07b5f88c0d6da5fff890cfbd7c2f1981e530b7b0557d5a53c03ca0adac35,installer,563044,2271,4325,4451,6722,4325
6691,b9593e164f6dce925eeaa52a90446154f5e5affc812123b06743af5afe8646d8,installer,1038672,4026,8160,8438,12464,8160
6692,b98eab602e021605d6820f2f9eb15f7e9cef901a6b8648ced749822973829825,installer,993101,4086,7895,7881,11967,7895
6693,b9e5b2e51de526af23e022f641648a580e06a905d4c6e4d681bcc38522644ca6,installer,974562,4029,7715,7939,11968,7715
6694,b9eb0913350755eca995028250623f318823983be916023653f1eab7e8979d3f,installer,286568,1103,2278,2310,3413,2278
6695,bb3bf47d6ac2e10d8193247c387d766341a8605e5cceeb2ab044e509bf743084,installer,578526,2363,4577,4598,6961,4577
6696,bb581fa856e2da558cc38bea98fa1cccbf8f4f0b3b8e57af512a1d4915d78488,installer,974692,3939,7561,8018,11957,7561
6697,bb91bb38d29d3905adbe4123c6b5d3d923618cb0f53e8a6b47914ab776acd0f1,installer,1013863,4101,7907,8148,12249,7907
6698,bbdfefb5d29a02150ae82804485954ddadf53843007ff2c6f06d50634bdeb6a0,installer,93229,326,770,773,1099,770
6699,bc26f070efeee3f336e78c3a1f510592bad9e0c0ed96a0da22939c82eb504c25,installer,578723,2352,4437,4488,6840,4437
6700,bc482f222dfab9f6c0ec6935b3fe4cca0c4f56c570f416b045f6bd43a0b31a60,installer,508105,1998,4012,3988,5986,4012
6701,bc52e218bfeffe108c83cbdc8c1c8258246fe1c56dd93533ce8545f75bb2a820,installer,716778,2795,5562,5585,8380,5562
6702,bc9a2f9da4c7404f1e62eb1acc3fc4ea0cb0636868b9bc0f5419d0917ae1a832,installer,571150,2173,4409,4552,6725,4409
6703,bca7c5fcf8e68a99cc88ff4b2eedf0b3e21004a88e097d71e9622b9fba73f755,installer,563030,2175,4383,4400,6575,4383
6704,bce97a4ff98b5e7ea9cd9e18ad87edd041e819192be338243c6854346f734729,installer,94821,351,759,799,1150,759
6705,bd0e7e26f578e725f6d4f804bfb89edb13358c2bffdd1613f3bc69044648a92d,installer,1011650,4032,8291,8174,12206,8291
6706,bd50303617a478c05b4f286d9cb037154eebdca45e2287fefb38808a6c1ddb33,installer,562610,2198,4380,4424,6622,4380
6707,bd56522fc43bf6b41ea65579e329845f1f39d5a95e67f48ee1632a7aabf08fcf,installer,720272,2882,5505,5480,8362,5505
6708,bd70e62a77969e1e7f322c9e34cb90a2e47b7e036889ef7da54cd6bb44cc653b,installer,568622,2244,4396,4516,6760,4396
6709,bd735046fcb5485eebeec0de9eb0903830e3404dc83f1677f9ad1c19c459b3d9,installer,476050,1926,3659,3707,5633,3659
6710,bef981de422817d65fd2c85405b6c8c13bb016580c55339d1f890ad6da27176d,installer,667290,2630,5227,5150,7780,5227
6711,bf1298821fd919edb70c5c5fed94ce3603b4918b83757a595cb7962be20f6b7e,installer,722023,2723,5640,5545,8268,5640
6712,bf64b4c24c151d6335e0ee4d7bc3b733ab85c3ae393e357c1c78599d8cb8a297,installer,923040,3603,7225,7518,11121,7225
6713,c001fe348da087679d2d7da765050d84c0753e94686ae07923aaa43cd899f065,installer,803017,3109,6180,6315,9424,6180
6714,c08d4ca9e97d0e1ede44d1e4e0981f7bc75d1bde7f0e4761a0380e72ddf12a71,installer,563027,2218,4408,4425,6643,4408
6715,c09f1aaa28ca0a8bd27115fb83ac4c3e8e182b4ae8d091dc730a848c8795a34b,installer,790475,3088,6201,6531,9619,6201
6716,c0af2b706914270b8ea6226fd8cb8c572edb33d1a912d82db6018363789006af,installer,481229,1866,3683,3889,5755,3683
6717,c0d33615233fc65f7e6dab7f23b5f0323266b370ec644c4f873d35ee7fa5b07c,installer,569847,2164,4521,4440,6604,4521
6718,c0e39a8bab814a6b483ceaa497acaab7ce0c49bd8284f13f419dd2acc1c93907,installer,563444,2183,4338,4326,6509,4338
6719,c0f27b2a7ff9c91a8eb8518ba349655597c6156d6883d2a5069757578ba10627,installer,508237,2005,3971,3987,5992,3971
6720,c105b5ae3562084a273a69d4669a8da883b453af6ae7e8e3a691b41b5c4bb308,installer,720275,2850,5667,5588,8438,5667
6721,c13f9b17fbcfdf8a49b6df09c6ffe33faafd55190b560377ed5fdb6cdb22a411,installer,93179,365,762,748,1113,762
6722,c1ea19e6f0976c6c7c9778eab5550b56c099b21e0a1cb86da79e5c660ec09c5c,installer,555263,2130,4394,4489,6619,4394
6723,c224443a97f04762120a8057ebf58e73a1dbcaeef0dbbe342787eceeccf6d925,installer,562613,2207,4366,4464,6671,4366
6724,c2cad4668e39e7df2e6149a17775a263e918b4485ecfa8d760f6a9bebcd58ee6,installer,725588,2758,5901,5495,8253,5901
6725,c2f27757ecedf880059e034adfa009e96bf10df79cefe5a769f063914f6379a5,installer,1011990,3945,8143,8150,12095,8143
6726,c3297a1a47f70e3b9b7042edfba71fccb6ca59f0295448714e4b3543af2025df,installer,470391,1914,3641,3597,5511,3641
6727,c33ff007a36d895c61a8679898745cdb437700bb43f3c1b943a679a24fac0811,installer,984551,3893,7782,7865,11758,7782
6728,c375eba341e0a3ae35a874041620ed9499766d4f4e49a445c36fcc97b1db5fee,installer,93224,367,750,729,1096,750
6729,c3a15096e03c9507ec93b803fcc4b6bcd319e65d5b43df806c37bbc1e0bd8644,installer,487742,2002,3852,3860,5862,3852
6730,c3ef7713caa3ad50fb151ba6fe13344bf88b0782700d74d842f75cb702801ce2,installer,490046,1941,3766,3717,5658,3766
6731,c457977fe39f2348dbbec65caab97c17ca793780e60c820610ee6a102766ee0b,installer,563092,2213,4637,4423,6636,4637
6732,c47f4c9901e0d774fa42357bf1778660c919612770f74fff109c2df3609801b5,installer,502446,1906,3988,3931,5837,3988
6733,c4ec9806acfb59620d4b732ee75b6aa75ddf08e1b624a7831d53c84704b32737,installer,571879,2211,4619,4597,6808,4619
6734,c4f8d48ca4bbe62fa42733564659cc9308cd63729ad498c8187b2998948cd215,installer,1063654,4245,8388,8680,12925,8388
6735,c535456866e897ff69728bdc640ecd98f3f0cced1d5dc514632fb3a6cff6040c,installer,503557,1916,3843,4057,5973,3843
6736,c53acdaf8652b78be45b4ec1fd53457673a17df6a0474640bb6228541fa6d3b9,installer,3320050,13674,26726,27228,40902,26726
6737,c53fd77e2a45b42272703c1fd8c9f119df0953a71890e21cd802a0bf927eca32,installer,279258,1126,2170,2166,3292,2170
6738,c566f10ab598b79071bcb3aae28c51ee7c92f75a7054840b90d845fcac4c8b48,installer,803009,3100,6143,6318,9418,6143
6739,c5e481e4dfb797d5e8adaa31a422da6a4ce438c571a9f9a135710bfd7ee2e324,installer,279113,1101,2126,2206,3307,2126
6740,c5f53216cc510e6773afc24d856f17e842e2341ba1db484091321b3ac4cdd52f,installer,523076,2088,3973,4209,6297,3973
6741,c60b02ea2f805af7ab022ffe935248940a5c1d2f00151109d585592245f8ef93,installer,641503,2535,5155,4994,7529,5155
6742,c6664340805df1de0b6b0fb5778448bae0df71a234e15bfe1f79296b977d5a48,installer,561937,2177,4396,4317,6494,4396
6743,c719ce83acd7c6eadaa389bee89aa1233d2ddacad435f3e55a059d4cac5b736e,installer,503560,1960,3887,4095,6055,3887
6744,c7c8e5a32122a2b0c9cc87757faf0816a7cacca65dd644d6507a6e009e4683f9,installer,509864,2013,4046,4104,6117,4046
6745,c7e120034165ffbfb14c3837f6769acea13e95c9bf6db74d059dd04171afd086,installer,520557,1975,4106,4004,5979,4106
6746,c84a05cb78dc0f8096caec954c84507fae8d65da3f7eb49a357534c49233bf82,installer,571684,2282,4372,4569,6851,4372
6747,c87e935b6f01cf4852440196068b9a1bc4dde83980825396309b8f4828804ead,installer,563133,2247,4389,4406,6653,4389
6748,c9da8f91172d983f20727c0a095aeddc41b0b69ba22761b387303a816848cf32,installer,559831,2210,4340,4437,6647,4340
6749,ca464429928d58c061dbb834a7b4684c9e9583ad6daae60d5e69d7ccb8e0b51f,installer,578538,2228,4551,4536,6764,4551
6750,caa098b52abece8e87716ed72aef22d65998a7afbc96dc99927735691c93044e,installer,476037,1908,3645,3733,5641,3645
6751,caa7ec6d1e4e836af38138e752d5da2ae6d1a987f448a98a6511769bfaed9b98,installer,850588,3603,6727,6650,10253,6727
6752,cabaa3b8c116869a23dcdbf89acbfccad6d7b60c80b19a12f30075929f4e2f66,installer,571781,2283,4466,4465,6748,4466
6753,cac85b74422a2abd7ba8b9fd51ea5b7b45173e62c0429e23d3c8a00281ccced3,installer,562977,2173,4313,4410,6583,4313
6754,cade5dfbfeb6bd8e9ccb7022379e9d2435e1cc931cf7219fa34842912954feab,installer,274169,1010,2103,2155,3165,2103
6755,cb01d6b5ce936c8e42a3c878d4c498bac150935dd0aed45c54fdd620093d19b4,installer,578899,2306,4501,4513,6819,4501
6756,cb121365078f13f5c4785b0174a3bd806e8366502f7e153862d26681652ef07f,installer,851657,3658,6717,6615,10273,6717
6757,cb371dc7c424162fff8d97a64c311745f5b2fdd3baf571834b2af22351b08e25,installer,808555,3110,6437,6333,9443,6437
6758,cb77e5c67c835e434dec592cbc23caf8f0f19694c7e0f97c8f898fe29d88c123,installer,1013852,4101,8101,8215,12316,8101
6759,cbaf0ed2ab3e532c24442275f3ba5b75e547e86d3289045092de2c6234aa6cc3,installer,858734,3304,6845,7145,10449,6845
6760,cbb7b7b609fe37962d9ee5d2caea44b81adea6fa1dedfdf08fe7d82b05bb5946,installer,584590,2366,4487,4588,6954,4487
6761,cc266d4b18f8c956be42b3bba0baf5da6dd5df44a05b36332f15e3778954c35d,installer,562333,2263,4388,4379,6642,4388
6762,cd289ff308753a3e83ad03be2722a643f0bcef0fd2900a056245a308a28b34b2,installer,854244,3436,6609,6683,10119,6609
6763,cd9de0016c40963d516fffcfbdfb41be8154dd3a566af96e9ffba365d1716d9b,installer,513160,2202,3975,3980,6182,3975
6764,cda1d517e7d68a76ec1db2b6dfb564cf066c8b286088d0e50eb713d5cdd1f848,installer,488941,1818,3911,3880,5698,3911
6765,cdfc0e9fc80bef7520e4342fd4c9f09ffa481fcc67addb75aa73d26c3d5aa48f,installer,502444,1959,3963,3904,5863,3963
6766,ce33f1a07540b9c77b8fe7a16f23741cd90ae91d384dccdebe25e66eb434b88d,installer,759077,3032,5901,6207,9239,5901
6767,ceb4ceade480dcaba48761c988539b68841e49e49510faf468dc5b3fefe117ac,installer,851726,3676,6694,6674,10350,6694
6768,cf074ac62510d2b90082fa3bdc8ad119c69e334724be1251e31f5a0f603fe9d1,installer,513501,2100,3929,4073,6173,3929
6769,cf4c8587939d393415fb7fff2394345865126dca29693bb6c183216119a210ac,installer,570008,2219,4540,4363,6582,4540
6770,cfe2b738a52370a98592522090be2469587e491e960ed7a606156b4545e6af06,installer,1017539,4135,8091,8265,12400,8091
6771,d07e15b7e558cae08952881ddf7067cfad11245379072eee4dd81d2d18d455dc,installer,974749,3875,7643,8096,11971,7643
6772,d082983cf27a634051dcb4621a2ccbb572ae78c2bf547bd1afc308fdac5855c0,installer,498792,1993,3914,3849,5842,3914
6773,d0ed33d07a95434cd0d9c87b4d8cedc6a9027a55537e38aa62aff690f0665c8f,installer,504831,1997,3939,4018,6015,3939
6774,d10bf1ff11562a4054894459ba935b6bce23d4879f19e603ddfdc64d0df5b10a,installer,286618,1147,2177,2270,3417,2177
6775,d1f980a93fd0178c48a873745a6985ab3f8ce3059a7677a2185b96fff4318770,installer,719272,2765,5649,5814,8579,5649
6776,d259d296dcd5d6d24d6d57b387ec9e64ad5247ae62410a755cc75f6586f9f098,installer,493515,1917,3837,3789,5706,3837
6777,d314e1a004540a51b3da08ab3300cec7e24fab515bd388e6e1396f6cfe6b284f,installer,312372,1193,2448,2638,3831,2448
6778,d31feaee1c9e18368f92014c9157b0c7ecd01b4eb444d12683bb403cf3bacdd0,installer,503559,1990,3847,4110,6100,3847
6779,d3a4740b08888fbeab17eabbb40ff7e16684221467e3b49c3deee71fcc26c11c,installer,568804,2112,4463,4550,6662,4463
6780,d3d17cfd8fe4483be434eaaa19f372a5e6904075fe05fc5eee4d87490ad2ae99,installer,94824,347,750,780,1127,750
6781,d3fff1d7494e29ce5adf2faf3fad5ca752b55c64501a06469c4d09763bd04dcd,installer,279131,1095,2102,2194,3289,2102
6782,d4119c27099b9b88b75544efc5e892a086249b1a4bf10df9f433124be4aede5b,installer,691649,2578,5393,5520,8098,5393
6783,d4a219bdbb9ab24ea33425078e52d582bbb17723b98ebf89c64facc69d7b0f09,installer,94819,380,755,783,1163,755
6784,d557c1f8710af0589e99fb4dd722474d1c898a7283e99f1a7782310af05c72b3,installer,562980,2198,4339,4381,6579,4339
6785,d56c3f2b0fe088c1fdd0bcd0a0d25355df7cf3f83de16269e7030e27baa5c8c9,installer,809591,3211,6376,6561,9772,6376
6786,d59ac86a47c9dc5a81615670e5fe58ddc5ade508708f7db9e1a48138a6020791,installer,280057,1114,2192,2141,3255,2192
6787,d5ff344c86667cc3f8a7ce18309ad36dcacc795a85c02bafe79dcae07efdf4fa,installer,870698,3378,6707,6999,10377,6707
6788,d621a75761e136bdafa4008de962b16ef507574ecb5fb6c9deb6a72e2cbcb079,installer,598941,2393,4754,4733,7126,4754
6789,d6af0f75d7dd91bf6586dcc422add9d2a6ef76384155c58d4f1a6cf1b35d3327,installer,720277,2840,5647,5588,8428,5647
6790,d6b62bbfe6bce05fefb3854259dd1a12d4bd01afe21352a364a8439ecd3ee514,installer,858656,3315,6575,6895,10210,6575
6791,d6d93aa173f4e26d35c748194bea5f5f12a5df57770843887a93f55f90ce6548,installer,272929,1043,2119,2192,3235,2119
6792,d714e17ea3916452727dbc2fe4ac130d49f142eb55cebb8e8df068674303391c,installer,722709,3004,5595,6055,9059,5595
6793,d7724d5242e8b735bbb8f00937ca2bdfb180d2c60c06ec8cabb376d937e07b4d,installer,563030,2245,4339,4456,6701,4339
6794,d78160a57e3fff43ea2f63ed4475da8c1cd438c53d5896c0b9304e2722ea486c,installer,1023380,4009,8238,8184,12193,8238
6795,d7a1098f7e8dc30c036d68e9e50377a03016fc3da87ee010b3d192149373d7b4,installer,851948,3624,6695,6629,10253,6695
6796,d7dba0ad130fed326b8bbf1b4d0a355b879d70ad0fe672251523f4a381f6148a,installer,512065,1976,3991,4053,6029,3991
6797,d81ab5fd5a165dc27c46353c92cc72e22eb55e5489aea421e8f95966f07ea8c7,installer,482975,1913,3793,3687,5600,3793
6798,d84de43064f84596ef15cbff5003dce0aa148f42fc5f0ada7d84aead79fd3b24,installer,584723,2343,4652,4691,7034,4652
6799,d875a654a52d9a59bd7a1415b3c72ecad5c34a72c88706bd26e347ec3a27e3b1,installer,562985,2293,4365,4461,6754,4365
6800,d8ada3339d87527c3284752f7fd71b792876b99fea25480cb8b02a38ac9980e6,installer,720280,2890,5523,5511,8401,5523
6801,d8b4e3d7353feb6a0f89f92acd8ad871aa41270e04fa02e6e4c4c656cd1a1edb,installer,578854,2282,4571,4663,6945,4571
6802,d8dbfef2f85cabd4582186cc774d9a22708ab48b5cbf35695a18b3c9013b8c0f,installer,2951318,10786,23943,22829,33615,23943
6803,d8e4dcd15038264a3b268e69c4f726afe778dc5a9e80ba73f04a9fa48ad5f6b2,installer,686825,2704,5316,5398,8102,5316
6804,d91474dc25455f3cc95dfe6346f62dc4c8aea0018e3aacc152dafb444d0114b1,installer,94818,385,710,778,1163,710
6805,d9a53d4d4a782fdfd1bf98d475458a3a24386981ee16385540a5e2b73e35e452,installer,870423,3460,6812,7166,10626,6812
6806,d9e66657717ac27bf31a092d22728a022a2d72f39dbcd699079bda4fa8b85b73,installer,477482,1912,3675,3671,5583,3675
6807,d9fd0762196eacecfcb9bd6df8d5a762decb3172b0c9593ee339a052a512a7b6,installer,974573,3866,7860,8128,11994,7860
6808,da3f5cc25928419986d16ee71cd0160abd15b67f9c0b2b0a7620a5a7d57bb89b,installer,109884,432,922,884,1316,922
6809,da7ae75b4818c25b3b7e326e304acae9e1e5be31651c5ee16df77a5b8e545a8d,installer,287591,1116,2179,2243,3359,2179
6810,dad5a13101574e01fa66fd6c6a745af02de819528fc736006b25497ef03f71fa,installer,312480,1172,2491,2595,3767,2491
6811,db14a716faad46326dcb75178facab5838182a5429f2ee29536564c41c9a0e23,installer,618374,2496,4765,4904,7400,4765
6812,db21b31d0310082392b50e13af690ef613f1b19b51fbdf428d90e080b7a16856,installer,3553996,13536,27764,28841,42377,27764
6813,db4426f308e79f4d7f51ac1d6d64a16ab3bd17cfa31418cd75ac26dea2aa5422,installer,331677,1306,2623,2505,3811,2623
6814,db737467e6836e1929d66c68d993a657014381488fd502678f695bc2a9282d10,installer,868794,3451,6661,7050,10501,6661
6815,dbbc60c414f9ce6f2aef9ffa6e2a6588a55e93fea3426b82383eff1202c37335,installer,682151,2605,5381,5394,7999,5381
6816,dbbf7b4ff7686681080dcd7d35efc13a39244eecc749e0f6e6de77863e9552e4,installer,578817,2204,4605,4670,6874,4605
6817,dbc377096d570b7fa86f9d4667e09de029ed7a36d488c0fcc0f06f18b0765447,installer,759135,2948,6066,6025,8973,6066
6818,dbf95a8bd60251992015b2dfc0a509439b172e828e2e42e58c37f99e37b6ce03,installer,280084,1118,2193,2179,3297,2193
6819,dc332132c496e99db7828a8daf6c2c0d97d90b52ceed0528bedcd519fe1f3e49,installer,876991,3441,6903,7025,10466,6903
6820,dc61771bc3327ef80b17dc7b616a293671a2842b43830cea67a3c6c59cbf151a,installer,1009180,4113,8026,8369,12482,8026
6821,dccd0e261ff3b63ddd7c2bb3a23c0a90e711044c52edca8cd23826523d675ca4,installer,667755,2526,5170,5428,7954,5170
6822,ddc1758ecc60d594201e6e292b7c318b746cad2e026c3c01bd0e49bc29ddc140,installer,93224,326,774,760,1086,774
6823,de0aa7402a2d48e9c8240f899cc7287c2d5989cc143a741a84c5bbb493c75353,installer,696502,2818,5632,5608,8426,5632
6824,de77ff389556ab3dcc232bfedb7a66892ecfd743d96921032e234f16632d7cc1,installer,276821,1077,2173,2127,3204,2173
6825,de9da204e04235c044c6f0d5dbc7018e8b412bc7fbc10ff524cf3ac465a0e04c,installer,1092589,4431,8683,8894,13325,8683
6826,df16df54712f06d11fedac533c951d2586319f5770f142001554cdd8a5fe6cdf,installer,870426,3478,6820,7164,10642,6820
6827,df628c2ad94d51c898f697904500105cb18c85368fd69d97397245367ebc4275,installer,283333,1130,2211,2262,3392,2211
6828,df7395ed5db84ea1857f9ea8b4e9b988bb350a625e81d17077c35231515db653,installer,569167,2248,4535,4561,6809,4535
6829,dfe9f48315376e6002a0e636c03e80c190426d0d1c959b1f49ae56f517bbd57c,installer,807152,3167,6296,6457,9624,6296
6830,dfea6251127ecd1512d9922da586d5c8adc0cc943879e89946fd281d0c81dfee,installer,563081,2247,4424,4436,6683,4424
6831,e02250eb50d2d61b2d865f5c92e15bfbf417c5aa7f2783a5c74b6d9b181affc8,installer,563989,2116,4399,4605,6721,4399
6832,e07931c46df88fdd724d585a340c9b2e9fa579bc46ecd3cd56265f1deeaf8777,installer,280066,1136,2204,2174,3310,2204
6833,e0b7d1a43e494b535c1eada240fea70d4c377099b1d4be2fb1570f9e5550fa9a,installer,439231,1849,3588,3507,5356,3588
6834,e0effb9eea2187adfc416d711db510b95a643f7ffe7c7006f5d8f69bfc20fce9,installer,675314,2633,5235,5243,7876,5235
6835,e13d0e83f3f5e4c130cecac5023c812519f9ed44e6954d13d10906ce4036f1f4,installer,523078,2048,3959,4194,6242,3959
6836,e150bc0ea2d53c38cbab0dc16701f686659f53a3a30ef3fcc6fd099f203425b3,installer,974562,3973,7733,7974,11947,7733
6837,e1937e2a7bb17669d42934f2b53cf7b7e6ef2c019fca7275fed935c3ba899922,installer,584716,2293,4636,4722,7015,4636
6838,e1b3fccc09c1154414006aa1769770c3818c760b9d3a9d35fb213ae9c03d2b71,installer,802789,3153,6324,6409,9562,6324
6839,e1c21b69bde9db1eba4e08e4787a05eafe004ba5d1d88d4b273a1ed71d913b65,installer,1023385,4001,8228,8201,12202,8228
6840,e1e6f753f34d75a071fb2744a26f89fe36e0f9f33591cbba13c674c6f58494ab,installer,563006,2160,4377,4320,6480,4377
6841,e1f2d5f3b1094bc2a7967486f0bc50e6debd6b9db47132a58803c5664499b957,installer,720272,2859,5670,5565,8424,5670
6842,e207ef7237693c5c818cbb9292e9a94a517bff25a453f2690feedade90e272e1,installer,93228,360,758,777,1137,758
6843,e22de53c1ac64ac07e374af6b29bf9a26a3e32fdd572410768661ba2d1029da2,installer,578530,2216,4347,4575,6791,4347
6844,e2343f9b1db83139a84619f9166d765721396e6a27f60a55a0e5cc48a039a445,installer,94821,333,754,780,1113,754
6845,e264187e17b5d9aa018fccf77657d98fdf5f5b34d1717933afa042232248f2c0,installer,502449,1909,3981,3946,5855,3981
6846,e2a29238b3b1fa0289df082fdba9ba38f3b77f9a87d534f8d1c07f4177064098,installer,974572,3900,7803,8015,11915,7803
6847,e2ad3b765f7f652b055209702e07225c1fc6a83fd26ccbf960587a654e015492,installer,518271,2099,4253,3999,6098,4253
6848,e2f53830af0c9dad9ab4376fead7ab14a2ba2fa0c8dabb3be466e5b25dfbdc1c,installer,503559,1954,3887,4092,6046,3887
6849,e33e2e82faf61ea6aa1faaf2196d82933973daa17772473c7f0f0c1fb02f7ce4,installer,792400,3164,6298,6254,9418,6298
6850,e35323b7502ec11cb02acc0787f89456ef198deb8c23e20c4c83ab5b40acaf8c,installer,94789,373,728,778,1151,728
6851,e37f7814632bc16fde86a91cd72a3e991ddf5250ea906363dec2b5c16de828ef,installer,974608,3926,7657,8111,12037,7657
6852,e38670449c8f92e8a6d941775123effcff03ed88f0f75abea559e5c5350e4fe8,installer,1092590,4448,8706,8895,13343,8706
6853,e3f6f364d85f54829819992cb570885edfe8d7dd327f7f09e3c31cd94b2dd9d6,installer,576047,2334,4266,4588,6922,4266
6854,e3fc94cb224ba47109426049334a84e6821a9763a899448edb3351ff08564be3,installer,487750,1975,3874,3805,5780,3874
6855,e49e0ed008049471e4b5de088485b5d4ffec87019dce4577eda53816a4ba5303,installer,578493,2287,4597,4584,6871,4597
6856,e4aa68507f4ad31edaedbb1a91a82eca911c692729010d10ae6611826793e9d7,installer,571868,2208,4662,4553,6761,4662
6857,e4f602904ce81b690c2bf7f8bed4e77450396a1f656ee9ced13965bc3d8abc84,installer,93181,362,749,774,1136,749
6858,e52ed402fc8f1890fe8e1edc90376257d0d07b9d15ae38d18d992bb83a0f9245,installer,486510,1855,3837,3842,5697,3837
6859,e568f768475b97364daab09c2646a2348e0d6523a711dfba4c1f8703728fac02,installer,4348315,17620,33865,36087,53707,33865
6860,e573752a7ca4d36a224d8744ce25e07e0985db6c6dd2036356865954eca6083b,installer,513629,2114,3966,4009,6123,3966
6861,e614cbded134c0c30f2d62f22659bb6857741b3c058e65d1d888fe5bb118934f,installer,578233,2235,4378,4411,6646,4378
6862,e673f8f9bbafd99e74b9b1161e21ea855ed341cab0217af45af86b4d129b9770,installer,1186438,4665,9548,9654,14319,9548
6863,e6944d1f89ea78fcbdd9832c46e2212cb646f93ee49fdd161d5221746972ed15,installer,809587,3235,6367,6563,9798,6367
6864,e69bfc315c723c4ba8074bc2d4317753b2c42471dbbccf9624457dd2bd63c2a7,installer,759189,3020,5951,6090,9110,5951
6865,e705a996e3b98623814381434ace4349ad389834a712c8c51e3f9b33456d82f9,installer,647543,2570,5051,5246,7816,5051
6866,e7188c1f3ad7ece8043887e527d473e3e0378762649c2ad1f8b069ae3f9ae439,installer,856676,3367,6845,6816,10183,6845
6867,e88b1a25c22bd15713d3cd40231c30af2b452ccd726672875898b29b3be047c2,installer,94828,376,732,736,1112,732
6868,e8a20a1c1e2dbe209ef89098afd3f68d68bd4e94f2ee73bfcc8c447dc7418267,installer,516191,2129,4023,3952,6081,4023
6869,e9301cf6ffb4e7109708e56c925227ab6f981636c53c87644beb29ac4aa9b3c5,installer,809876,3085,6415,6552,9637,6415
6870,e96efc6f339298a9614086a3c1b2dd8e9d3f29a3b7bb956c1a2763d7abf11e03,installer,686759,2696,5272,5320,8016,5272
6871,e9739ccbeef8de712dd053d295b4bbead648a066fba73ed06d8ac07330de79ee,installer,974790,3827,7682,7869,11696,7682
6872,e98e08700d270a23c858bc661a7967dede4485dbe83b71077fd576db7fda378b,installer,851703,3647,6705,6669,10316,6705
6873,e99cd37e95a83f14de9e8ed033295f4881490ba989a601f28af5dc747c6be630,installer,500558,1990,3886,3792,5782,3886
6874,e9f04588314ef0a22076371a05e6ac36a3c1d2116abae1e84463c763538bd3ff,installer,588137,2246,4679,4584,6830,4679
6875,ea3a0840e87282d149ee60a0e3863d6c04402474b9bb08ff4b9a931800d15aad,installer,722056,2726,5522,5625,8351,5522
6876,ea6088e89424dd00ab727656fd2625ddeb272b3bb7d3107620de3621b90384c5,installer,503560,1984,3846,4106,6090,3846
6877,ea629ef7e0b09ed9c8a58b93a6aeca84816b2d668b9628fb23ff4e17ccf8025c,installer,93174,335,728,736,1071,728
6878,ea8b8777cafe2a742717070c1d74349ec892db56591344419ac9c55c595a6263,installer,484112,1921,3904,4021,5942,3904
6879,eac2d9f6871efeef02d244f2d43667bec39b0059e85179563742cab6460b1a6d,installer,563032,2254,4385,4423,6677,4385
6880,eac5cd66e4869f67d142926083836037b65b3ba6dfcebf8b6c3f66bca50b5045,installer,476037,1904,3639,3670,5574,3639
6881,eadccc70a724522c3ff67b3082b3d23accee6bd8cad005b6114e2476a3995c51,installer,286523,1113,2241,2301,3414,2241
6882,eb51388160176c52dd515f805b649bff61aae4b7a382cbf10b2fe54e8c1a9dc1,installer,559118,2074,4313,4279,6353,4313
6883,eb56132414fdbad2e902b76ab24eca4da0ee51580b26360a466fb8f98c77dc88,installer,808543,3103,6429,6311,9414,6429
6884,eb8b167adab0ec2478adafd49c3a1d3e4a002bff0c3a22ce920a189cdf5c00bd,installer,851811,3697,6752,6682,10379,6752
6885,ebb6bbf48f59a78fdafb0ecbbfbb0b2bc61a0ba6af9f1b1dd903e44370022161,installer,93242,364,769,790,1154,769
6886,ec56ac8dfb7ab7cc6743773abb7607d68087663ea2533fdb4b5cec2d9c82895f,installer,513173,2017,3990,3946,5963,3990
6887,eced951d5973781ee688c33efae48a5c15c20d18d67948c97e9ffd9bbe2154b2,installer,376744,1445,2979,2966,4411,2979
6888,ed2cf73f15955b8702b75c48ba6e6477061f9bd379e62e26182d9c9bc1a83ac1,installer,434080,1717,3435,3448,5165,3435
6889,ed330a25f164f4d3279d2670fcb29d0015a7cd6da35cd973e9aa29a0995f552d,installer,503559,1924,3854,4062,5986,3854
6890,ed68f981412a03326fafdc8735efa7afc3590bc0626053e74f77fd469e3251b0,installer,720270,2854,5654,5582,8436,5654
6891,ed7fc5503f684f5d6358d2e63e528b0041ec6b3df87c97ebc40d00966a48a3a3,installer,3642499,13614,28615,27440,41054,28615
6892,eda9926d38eea0e8f3d85597e071377aefe366a1955714a31f4b5b534d1e7805,installer,974554,3954,7743,8061,12015,7743
6893,edc979a18920d7eecd0aef7dbe74f1995d165c9c13aca481a931725c13cdc069,installer,503559,2012,3892,4101,6113,3892
6894,ee03ea38a79c16b514b573d7723368c4ef4b47dc406bd246cb6a09ac6fac913d,installer,503558,1957,3907,4084,6041,3907
6895,ee5691d539b1858a596e984c8547f5323e69d12360b77ef981b0846b7e62ebaa,installer,488942,1846,3892,3855,5701,3892
6896,ee7e893d7c5047bb87d05ba297b302ae4433b95e269042f9782d865273c5d5a6,installer,475262,1924,3788,3719,5643,3788
6897,eea06c375da1a228b2bd3092946a5493b2359aff5cd5313d05d1746b17c8978e,installer,1119610,4440,8832,9527,13967,8832
6898,eecc71fa9b47256e529bc16c51a9fa5b1dcfb93880cd7c3505fe437b6073a13c,installer,1070799,4180,8533,8747,12927,8533
6899,eed94e7ca6e65a1649b116027866125571c28a89647079a8f8fca9dc810772ca,installer,801216,3211,6410,6271,9482,6410
6900,effdfcb5d3cf9a6601dd149ca9950aeb360581f07b0d638e810d645723b405c5,installer,1073876,4304,8579,8738,13042,8579
6901,f00f86afae426b6ee8bbc03f76ae74b38611e7f88e04843024f6b73dc6f2a31b,installer,563117,2261,4343,4437,6698,4343
6902,f04d211e92413fd6643712b5a58d41c2fe95e09a2e178fc2d43444607f400cde,installer,555259,2118,4411,4510,6628,4411
6903,f07e53db1db8b718297a59710adb75dcc80d63ad143eb3df742142e3c3c3eb0d,installer,568809,2120,4468,4544,6664,4468
6904,f0895425ec7d2e6c2098f8914605af10de9906b4d751b032b3ab74d5a61dd1c5,installer,563008,2248,4379,4433,6681,4379
6905,f1fde034ecfa6287d642effb7c24bf118ce2c6ae2722795bb61e531f1707563c,installer,3472679,13469,26959,26747,40216,26959
6906,f2005b49491d4988423f04b10f6894680bed1ad56c0210e474b49db61a4be728,installer,578824,2290,4552,4484,6774,4552
6907,f23755dbf753ea482eb00cc1c862b923136e577a27c8fd95b052c1936f67b7fd,installer,1011645,3966,8210,8328,12294,8210
6908,f2623e7090841b18612ba24675b6e3b32701e2c18c940f84fde58b23f0a7b312,installer,503559,1974,3880,4115,6089,3880
6909,f2a3612b2a180b617692bc61866342ac0bcdc5b7ca7db1e25e4297ab189c088f,installer,504855,2046,3890,3989,6035,3890
6910,f2b6f386ac071fe7384cad710aab522b1dfdf381eb264a0cfd6f654e3ed637b5,installer,803004,3110,6168,6316,9426,6168
6911,f2d178a7b389230d5d223fab9a0bffa83085286265a639b7cdb86014fc2ee6ea,installer,1001289,3908,8056,8301,12209,8056
6912,f2fa040fe49c73fc35452f583691581f75d22b495fdb70c90f8ecaea64e834c4,installer,513371,2103,4079,4220,6323,4079
6913,f32b96b7094981d1f66c6aa5ec0202e27bf1333c893c46ff63938ae1923bd74a,installer,293042,1176,2376,2333,3509,2376
6914,f3449650ac63bd5365e1a4f225593b4d844099732b461a16f4fa6af6c8699e22,installer,974614,3971,7670,8066,12037,7670
6915,f3bbf9c5866135952bb07aff7311a006c9a1857874b2883a525fbad48212dd2d,installer,1025002,4059,8327,8167,12226,8327
6916,f3dce5c5a26d4711b2cce54a3e7f2bab81bddf7bd6107526935417b2afe88784,installer,493514,1883,3876,3808,5691,3876
6917,f431ff5ce590ccd48e74264a207474a61d6f66ecfb1c283583637d94ceb76a57,installer,571814,2236,4524,4654,6890,4524
6918,f451b1d9a6f97130f2314b0cdf6e28c97b463f893ec683672eb37ec489ad0de9,installer,1184220,4741,9398,9730,14471,9398
6919,f4d422c6056fc43bcae987d9ad292c5fae0a8fc03b2195c7e9ea8bf25e86f770,installer,563116,2218,4645,4433,6651,4645
6920,f5e3f0bc7da66b950b32d8f859e8fe38ce2e2fa8e29fb2337bc614e66f133278,installer,876998,3386,7098,7107,10493,7098
6921,f63a05821e0de2e325cf35c210d5bf95d35f599348a7a296e23759c083262a1f,installer,970868,3943,7596,7867,11810,7596
6922,f67dab042bc10dcaf75e7b7a60428a74b3109259e7059741c2b8fcc72e545aa4,installer,578858,2248,4628,4678,6926,4628
6923,f6a13ee144d656497095de28968f762b3a04fd9f174469a81f46ff21307175c1,installer,286587,1188,2287,2376,3564,2287
6924,f6de7ac87774090d8f90b6ee0ca7da1e4e75c18717f04bafefd24c7f49de015c,installer,809593,3225,6385,6547,9772,6385
6925,f6e3294c5806c6745bf98022ca3097d27c4fd835cd069ebf4af516b7c27ba828,installer,571789,2272,4455,4454,6726,4455
6926,f72a7b802751cd19cea9c67241b03377aaf2e19fd17b6aed1da3351dbd9d0864,installer,212937,788,1687,1867,2655,1687
6927,f77cb8b5254af0ed9eb26b9136c0d1c2883f02d5e2ae41b68fb0383e69a5fe3b,installer,562326,2298,4357,4422,6720,4357
6928,f80ae064f497bd02e5929c7fe382d0b027ddaeb3feee5b21e87eb8359cee81fc,installer,974699,3925,7697,8012,11937,7697
6929,f82543465929c59c3e0ef3c9fe2bc5dfe09bac087ffacc464de534f0f5cad496,installer,488943,1840,3872,3837,5677,3872
6930,f8692c2eae4b46340811a4178c4b2062a69260696f4039d6856ba96540da98a6,installer,800966,3033,6375,6436,9469,6375
6931,f872d7e38891f0262c7f2002db8fbaf4fb737e646a6667116bbe7ec1dd02d1c8,installer,1011653,3900,7975,8406,12306,7975
6932,f92a983590b2b71a77885cb46caed2ed8891663be47aa20e64544007a942c42d,installer,987249,3938,7778,7887,11825,7778
6933,f95f872f2c368679482905b777630fcb530ac511c2268f6f2d953df942b0ad32,installer,493569,1912,3877,3904,5816,3877
6934,f997f92e2eaa949a0102b6f67e230da571fbddace30ec5686441c6dffefe642c,installer,670686,2647,5191,5394,8041,5191
6935,f9c6eeac9ffccdde0c5b85e8d5261086e0f8a8fb16924cfd87e154d8fb0cc5ff,installer,809168,3111,6252,6475,9586,6252
6936,fa3198173df072b97c340f6a73e1a4a5be8d32d209fd06e34b9c315d8ef27e72,installer,563026,2208,4603,4454,6662,4603
6937,fa33078906e1ac1671da1f04352eafdc2b261709490c962577c7917271d45c2f,installer,809151,3105,6302,6472,9577,6302
6938,fa68b37e571694b95df5edcaa852529a379cf765c9fca1ed072e2a338afd6a88,installer,721971,2841,5716,5612,8453,5716
6939,fa8cad13a54af371237d0c405b6573af14ccf286dffa52b525ebfffee261ed96,installer,3865991,15112,30046,30220,45332,30046
6940,fb09d8a00c0ddc3b65d4b850bc9622f52d4884f03c39f61cbc5a79d6418dc2f5,installer,720275,2853,5662,5574,8427,5662
6941,fb21bbbdb1ea0300b2feb42a561eeb42b2b54f911d9a947f75e915da9a01595b,installer,286813,1145,2240,2336,3481,2240
6942,fbe9373dfa79379325596d5ec98f40111184715bfd338104763412bf9d8172c8,installer,548363,2085,4298,4258,6343,4298
6943,fc5172ec69eac5c28eaf158649ecdc089f35e356a1c4d9ea5fa88e51a98753ec,installer,979297,3960,7774,7985,11945,7774
6944,fc5aff6a760fc3a92845c38ae2a007bb3987894c95e3a01d70b99766f702f96f,installer,486354,1862,3817,3846,5708,3817
6945,fcae80044c375d72fdbcb0ef76c97b8bb8de5dad2a7ab368ca8dcc048572006d,installer,279071,1100,2116,2198,3298,2116
6946,fcd9fc5bec81d53a0c4287ac7eea3ac61fe7e1312d3ba6ee8b1752dbc74fb7a2,installer,438670,1738,3501,3449,5187,3501
6947,fd48787a66dbeeb3f0e10346a77dd48f29216e09280413fff2d374513be86979,installer,500557,1984,3881,3787,5771,3881
6948,fd56980b85ddccef0e7c27d949ab780541fbb40a874f0bd3b99e070500ec10cc,installer,716770,2764,5538,5576,8340,5538
6949,fda15cb0daf63068ddca2eee723b84e5e59f85f3d0e04e2e1ed85113ebfdb058,installer,392345,1584,3144,3106,4690,3144
6950,fda289dce86628b2b8995073de9a4aeffc2221e44b866b71185f0a496f4276b6,installer,555291,2151,4391,4481,6632,4391
6951,fdb7e192caf677557821fd803a8c2dbbedd1deff2c283614881e9373d33e19ed,installer,850621,3579,6715,6668,10247,6715
6952,fdc0610f3c9fc55322219fff886cb6bbd806d2057549f5d23ce0efcef093345c,installer,476038,1878,3643,3681,5559,3643
6953,fdc4ccd95fa138a2148828c38d4cf136286c2c25ba63f31f88e3ee4eb6910ef9,installer,812285,3184,6466,6419,9603,6466
6954,fdfe84a92432210174b3dbb814174352d5f48b64b20d38d724f83e011b7909af,installer,802397,3089,6362,6501,9590,6362
6955,fe95532e44918119fc6be2aaccc37c129a7f18446b10275e4aa13674f823be67,installer,801633,3136,6228,6471,9607,6228
6956,ff2cf92011c791e57fc021570a1e909b8ca874310a7bb064f090275106e9fbf5,installer,286438,1099,2192,2306,3405,2192
6957,ff4973d9719a4080b42d5690c065679e102ba5ec7bdc68c0a05e8235697ab0d1,installer,563046,2261,4315,4459,6720,4315
6958,ff83356f6538725518b20533fefae6aa4b1502ee65754f0863db63ba98b20135,installer,503560,1929,3851,4062,5991,3851
6959,ff84bc804d9f26c6483c5ca42b00a6da78e4b095071794261debaf9cadafc68f,installer,488944,1846,3891,3856,5702,3891
6960,ffa1a7107b48114742eea56ac8e7edc748095e9e57b007fbff821c48ddfeb98d,installer,563077,2315,4322,4439,6754,4322
6961,0092e59622552d09e73c176cb82f20d0d21777eb5d562926804c343825728dad,packed,44223,176,352,325,501,352
6962,009d87f05e415201205a1fcaf997522bab5cc36292e84a802561ac25f5a3272c,packed,44159,181,355,338,519,355
6963,00e3751c35967d8463435449b321f356c273c9cf10415cb6138376af68cc3c3e,packed,788941,3009,6130,6154,9163,6130
6964,01337eb55ecf297458ddffd1b5cbf22efade7e0f92cdaf5fea486bc8068006de,packed,35442,132,269,288,420,269
6965,013976e93c8a535b3b6e40ed49c9d4b1b18ce5e608984b547389a7b6610590cb,packed,44049,167,326,336,503,326
6966,01d7a9fb1f85ba651551daddb88e63c56f8d05a8bbf47e25bf0574932680a6e0,packed,7786,24,64,73,97,64
6967,01e12930f32cae38786099b6aeca1a0d9727f732542c7eb95dfe980f36fede9d,packed,44151,208,338,344,552,338
6968,01e791d7e1ebcd7fa4ab7bc07084673a97320e1414bdbaf6e9d2a07049571487,packed,185843,770,1464,1488,2258,1464
6969,0255f2025bc2ada0cbf1f6fad76bc094b38587eabb6f485178073f910e8b9955,packed,43949,175,351,358,533,351
6970,02827dbafb6ede5ae0168150eef9122cb7b1369b658e8dbf4c5c4b6d2ff71865,packed,7787,27,53,79,106,53
6971,034f82fdf694013c2c6e1c5ed8ed150724da86aec4faa53a551c61e8f9fb5f9b,packed,22187,77,144,211,288,144
6972,03652e6cb503fbddb7b580de5f97197ae5f6261f593a5f31796c94db468a14b8,packed,7786,24,64,73,97,64
6973,041da6ee29e6b29341394dbf0c2701a365dfa6c056495c849bc13f1c7432431d,packed,7784,23,55,80,103,55
6974,047e31089f3807bfcebed317c56eb2378038431ca41283f259c48fc6aca7205f,packed,293200,1166,2312,2273,3439,2312
6975,04d44a2357eaeddff8660fa9312a18cd5e9977fdb81394c4799b1bc00aa3c1b2,packed,44300,165,347,360,525,347
6976,04fbf33100b49cf386fdf300efcc1d1d7baf98a0c68f3b8f4dc6ec56f93c6673,packed,7787,23,56,67,90,56
6977,050dbb0997dd223155c8b85244d32902174b25398fc097017adc97e273f63438,packed,44132,177,373,357,534,373
6978,057322f99f2947dedfbfc5774e176cd1041ef97fee3632a2a6ce7658d4d8a389,packed,49380,194,415,441,635,415
6979,0590eaf4bf1a7aef11ca27f9788dfd25c960f26ea725043124904b31c4e47d7f,packed,44332,186,354,386,572,354
6980,05bfc44e6e1c147ce3a8da25f5aabc51c77408aa461f5c184d3dd291a55f51ca,packed,250296,868,1841,2050,2918,1841
6981,063b7693025c1b46a400499c65243571d0e89d20e0a26caf5fc86f0aa9177be2,packed,7786,28,75,60,88,75
6982,063e567cacd40b3dc2b650e8839aaec46a6f16c236a5da8814b45e6e9cf31101,packed,56511,256,441,478,734,441
6983,064424c8723bfe8b11c90d14125bf53989c71861268de323326098048bc181a5,packed,7786,20,62,67,87,62
6984,06a64d516b29870040940b26eda2b58bb91d6b9fa95c9b873efac73576b3b99b,packed,44123,187,366,370,557,366
6985,06a7da81ef0aa28f385ed304a96eddc64b4ef646bc490b3f2dc3717f0f0f3e0b,packed,43901,166,304,356,522,304
6986,070faec8039daa7793033866e2f325020724ef97c0fadb4b9e6018b2e2befb6d,packed,293108,1137,2239,2410,3547,2239
6987,07f3320111e92f843179b8224094daece6755f37cf1b95819d24bb533a93b2e6,packed,7788,19,68,66,85,68
6988,0827633fdfd5a58dabcac9da626211488a15ebeff5569b836933a58a9e2de855,packed,7786,33,58,62,95,58
6989,0897248c3fa81ef8b49f123e75e0518bd4d1eb4059275b0f1f210bf33cb94848,packed,7786,24,64,73,97,64
6990,089e8ddf707de5b50671a4a251411b1f5e231d7cbd3b27f52af3af8e4053b243,packed,44051,171,326,350,521,326
6991,094c792e63b21440a9a9d2fd359b60dcdc77c5251353a674adf9d0b39533ca15,packed,44348,184,343,342,526,343
6992,0984aa4a8fb5574d531d493dd082363c40d424b0deef110f7326d8b86aab1be3,packed,44408,171,383,324,495,383
6993,09a68350a6063792dd47ccd0bf46389021b39ee9edf3eccab30b002816579aaa,packed,44067,162,296,344,506,296
6994,09fc8a264e40298ff5c3bb50521dd3084f45a342556d6efa6b001a27761aa9b7,packed,7788,34,66,57,91,66
6995,0a3d1f1006b5720a5e638e50920e8e3f7ad6ccb88884ff26db4ccf26715a573f,packed,44062,194,361,379,573,361
6996,0a513038acde0e5a9fb7b4f54f1877973b917992aa41197d3a6dda2575432e3d,packed,193626,775,1571,1565,2340,1571
6997,0a519c8afdecf92158a893a0cede9d67494b06edefef61f9b6ef34326eed3602,packed,44279,173,348,348,521,348
6998,0a7be1fbb393c390ab67eebd1ec419071b5450d9713341de25cbd7a6fc149dca,packed,44279,178,344,364,542,344
6999,0af4cbb44b920faab45bdaece86abea0c38869a804a4ec86d5d3ee8d1c699108,packed,7787,26,72,72,98,72
7000,0b5c24c099d4a03896cc419f5120bf023d89f468d6b0a422a877e6bb2f8d5891,packed,7786,26,64,63,89,64
7001,0bb0da359d1fa469d0b18a4b1bd8bf89da75881c6e00f16b3f72212f86d90ffa,packed,44253,186,356,344,530,356
7002,0c9c8663ca96215a1b9644aa1248da58592a7e83223e18a23a68eb8b1c7e2dbb,packed,7787,26,72,71,97,72
7003,0cb38520a30e365048de2144d660704475980904a1174bc9d4d98b4ab7fcf295,packed,1001191,4000,7708,8016,12016,7708
7004,0d3652e2856a10cdd75684f61c1316a9e9fb8303f2bff962cb72ba71eb546ddb,packed,90208,352,706,708,1060,706
7005,0d37618efd3c8ad9c7c40c3c3c2df4018c2f6a06616ed3e5b24ce4400cc2afba,packed,44254,179,340,370,549,340
7006,0d77942d247f6af4f01c2c63ef5fd9ec2a45f0955d959dfe9b6e3e6ddbefac8e,packed,624613,2400,4918,4960,7360,4918
7007,0dc522cabef58d22274bf144dce5965ddf4898c4e3ffe01b9f10478927a2e456,packed,44158,196,335,376,572,335
7008,0e27f5d179d9f5b0d21db743f20668914d2ec60e05f7937abd36f5b96923a45a,packed,7786,24,64,73,97,64
7009,0e93f21c0f6eff45e9fe90a4c7e5aab26986c1148a4ae9e5450d5b89eab04de6,packed,620974,2400,5003,4885,7285,5003
7010,0f283dd3aa242b24d592504c4b4d52bfb3cba01e9aa0a519fa60f8f400209262,packed,44390,169,356,344,513,356
7011,0f285240e4f208b527eff31dc7ad740896fa9122d33d58cbf44060a764003278,packed,7777,32,60,70,102,60
7012,0fa2df14c7b32fbb2c7b35a3ff2c1d10e0671e38c9ef346a444adb56186f2004,packed,44237,181,374,361,542,374
7013,100e9571ed4a0564b293bf7c7593c8135e1b011d8db538199d059784f4c104f5,packed,7787,35,62,58,93,62
7014,1014f9f5d7843b752043dc85dc3de7c42cdf15d3f8cc43a3cd6611c50575ec04,packed,7787,26,72,71,97,72
7015,10971ddcc004469bc9d19174b796c338e94a8370d60e2cf59b4d88815872194e,packed,44330,170,366,359,529,366
7016,110c30084fa16f049b96c0b0334f7116fb3225f34b99a74f597e9aad2110fb2d,packed,7786,20,62,67,87,62
7017,1171f195dd6c4649be7a16dc5013bbc3cc9b3c41df76058ddcd2f2426ccc785a,packed,186124,784,1450,1517,2301,1450
7018,119f543e72c82bda0faa8683a99b62c27909a3ec6cdc229f1f5a3ee783508308,packed,7787,23,56,67,90,56
7019,11bb9c58535e0ceb5b5174f60d70ab8dece02b542fe9c03087894c247ed87278,packed,7786,24,64,73,97,64
7020,11bbe1c0bee04808814604845868977482135c2b6f22efd6cd96e8218a0c888f,packed,1011688,3910,7935,8185,12095,7935
7021,11bc67c78bacc7ef097eec938b96e43eec10b5e2a850c5ade2641c5c419f29d8,packed,146301,553,1178,1151,1704,1178
7022,12046fb575c50a00eea4483429b2dfd4663dd69f565d9ee373535dff1399501b,packed,44316,146,357,376,522,357
7023,12608f9d3e6135938541636968c2b57c4514e62a4f7c646d825cd5f3ca8966db,packed,1011686,3919,7917,8189,12108,7917
7024,1269dff76bf48a05cda784cae9f26ef0b6627bbe6295d17e51351d9556c1b047,packed,289332,1102,2264,2397,3499,2264
7025,127f2d5ab8ab04bb4a15bc949bf3b3ee865fd550ba9795748b6a8b3592b506e1,packed,45162,175,369,367,542,369
7026,12988aebe48c324901130e9fa05482d52931db5fa8a5002e8f1311e6b8c9285c,packed,7787,26,72,71,97,72
7027,13671b4492ad5787f91ac736f2bba024d5e4bf686c2810fecad53dd771670c6b,packed,481969,1947,3751,3761,5708,3751
7028,137ed44643f8f104b462069357e36bc49b7d976221226b4ad76794609c2b6485,packed,1013376,3955,7883,8546,12501,7883
7029,13ba5cfec18ad60f92ab901eca48304318e38480c2e4ca2e3d3906b6c656d353,packed,103558,444,832,828,1272,832
7030,13d177d5a04d54449c070bbfd83384de51a3f652dbc34bdb723459c18f713f97,packed,352161,1374,2837,2931,4305,2837
7031,13fa6dd689a4014a8888c858777ff8fc1b0f691a10c09e172a36979d2b12521e,packed,7787,20,74,71,91,74
7032,143102143616f6ae6cca15100f1ec279a7d7162ba7316c9de334d626cc76c2c2,packed,44189,175,324,366,541,324
7033,146189ae12dc0de6ef62107973f53e823334099152070715b0ed11c0a0a6dbae,packed,44193,180,364,375,555,364
7034,14658132d93457586ef47c9ea60bc2add5cd172495fa27657307f8ba80c14fce,packed,7786,20,62,67,87,62
7035,14a4bdb0af31ceabcaafa7d41e7659331e2615af42baa74f7e61f722fe2d9c13,packed,44157,192,363,380,572,363
7036,14a8d25fe6a25c2cc39ce286c4ee9f780cc841e3e2207c1803f88c63392e4ccb,packed,44136,185,337,303,488,337
7037,14e261e1512059e4ba8078d24c5c9eac9d0a478bd15d77797cc520fa49a4ad37,packed,7786,20,62,67,87,62
7038,14ef6d597e97fc3789c5b264a618fb2885780326af54cf6b12062d77b1cb21ce,packed,360872,1504,2834,3179,4683,2834
7039,14f650bf6bff930dcabd3654045ceaf5ef1a217547136e3a5a327bb4680a4894,packed,7786,24,64,73,97,64
7040,15686cd3de21ffcefb43211381cf700c4444ba16a748569c0ef861eb8155e295,packed,7788,33,60,75,108,60
7041,157f6bcc58cbe654740727a6d636de040fb70df1a35256661d1a41f82a78fbda,packed,7787,23,56,67,90,56
7042,15e06d2b1a9416c424922badc3d86bd8ec664a3ef847952dbde2e634c66f7990,packed,102367,430,764,791,1221,764
7043,162003b584bec797554a4f314b58dea167b9a177b224504dc19a2bed6964f63a,packed,7787,26,72,71,97,72
7044,1621256555fcfcd9a4b8cd246f1cd33df8e1dde64c0604ad1b5e0880c7f9e1ac,packed,44194,177,349,373,550,349
7045,16e3bc885810b4df70263330c59d38fb768bc0d73f491827cdbd1442ab0ae860,packed,286653,1079,2281,2280,3359,2281
7046,16ea5f569fee463655ff0977356b1947fe84e3088c90fc6846cb5d6a478c849b,packed,1025584,4031,8081,8285,12316,8081
7047,177a1bd4862637d7316ad6cb5fef0620e42152c179b535c33b35da03e7d2cb07,packed,44157,205,340,385,590,340
7048,17e064ca9489555fe25a9c4d1c40f8ea90a17018b6c49af8aa4ecca532b92abd,packed,625041,2409,4856,4808,7217,4856
7049,17ec757272cd8c4e4eb0c7accbc2e4a1ac629f6b2ed909b319f026dcffc6e0db,packed,44706,203,340,343,546,340
7050,184161b7431f65db33a00df9511834cae3daf59b985eea1a8231c23ec98632d9,packed,44037,169,328,332,501,328
7051,185ac948a99dccd89d0e5c5f3de9fc37fc55e8d4bc89232528cd4aea1c31f697,packed,7786,33,58,62,95,58
7052,18fd2ce1e5a913bacfb7cd6c83776240011444ec5e7dbc2d576b4f5c0480bbe3,packed,44153,181,348,333,514,348
7053,1950d9a3f05b2a6144240582c52302e11297ef404039773d202770b6477162c0,packed,7787,26,72,71,97,72
7054,19b3057236a008f31e0970ec411e80e797330e883426cf54789d8fa82d1aaa15,packed,1025585,4053,8094,8250,12303,8094
7055,19bea776635c31fbe0d919e140447c816216cb16ac8df37b4be2f23118937f1e,packed,44042,192,341,329,521,341
7056,19ea5753a34b520bee5454ee22d24aef60193be5dd7090b15c73796261621339,packed,44062,176,355,365,541,355
7057,1a022e7249a26ec147cfec1a9151f5e59a5faea6031d9ccfdbbe6448a402281c,packed,216274,829,1717,1687,2516,1717
7058,1a2d0c29b41738658105a271508d3cc3f75a62953cb73620d1b15f6feb66d1da,packed,146069,568,1184,1155,1723,1184
7059,1a6421e7c11aa7c87d475751820d8ac9bae4dcd9b10f3ad4545daf08045c7ba2,packed,3694233,15274,28885,29428,44702,28885
7060,1a69992e521119105537cc8a9cc5a35f271a0374c9e1226ae427f9c759b6ae20,packed,286640,1093,2274,2283,3376,2274
7061,1a7c054f8313fdb0c809a067769da57911ebb36e28c2d0b515261f75cd63c385,packed,1028757,4002,8090,8222,12224,8090
7062,1a8d5b84d25e0029927b0232ea5206e4bce142dd037f356f9d3767c201d8c488,packed,7787,32,64,70,102,64
7063,1ab9b566d9fc76dd14ce7484ae2a804c3e867da9bb8e9601f2d710ffa499f9a7,packed,7787,32,63,72,104,63
7064,1af30526c80b0445b82e9a2d04c6f4144ddc48862ecbfca623a5c80fc2133c16,packed,44016,194,315,344,538,315
7065,1b02cf5055fa65af70e2b2ac2f1354191d1085557ec1dde4c1c0879c6e66400b,packed,44180,179,347,338,517,347
7066,1b09f4f2e84a15fcec65989365c2cde20eee8dc232cacd04d3a8c2ec4bad9eea,packed,44210,176,347,336,512,347
7067,1b92bd19d1866b8272b2cb4f7767e1c6f202074c6f8d520ac3a1989cdb545966,packed,43990,160,340,356,516,340
7068,1c140ae7d568bafd1230add7d9ebaddb666ca4cab202d854151ee1a8fffc148d,packed,176571,692,1350,1459,2151,1350
7069,1c492547d1f4d49df0b6890001c48bb5a7959eb14124c0b0b5f72425166faacd,packed,44225,191,390,380,571,390
7070,1c8835638276f16f2387a19a53283d2382db450a65862979fb00314bda0f76d9,packed,7786,20,62,67,87,62
7071,1ce816f3ad5bd454dea8c583238366db62058d461b1ae35d080073b606d55b50,packed,44113,212,358,357,569,358
7072,1cfccc55b46e7e5c6a26637f96b020367588e8275071a0cc8207037dfdf27957,packed,44252,173,364,334,507,364
7073,1d0406e716b8a5aa2fcd5fda738cb189cd835135808afb9ace62092133d70eff,packed,51462,200,416,426,626,416
7074,1d5e9716380489e6e9efda06d423fa41ba2b2b6a935410fbf763e72c829bde58,packed,2367176,7554,14959,14923,22477,14959
7075,1d67d83b8edbadfd930756e08bfaf2dea0374b771c3bdf17a1359d4085a03b76,packed,1001190,3996,7705,8013,12009,7705
7076,1da935bcea9043a7e384bd09827b3e70479b1c64c38f19b67e5811d1230d37aa,packed,44133,168,318,390,558,318
7077,1db4947cff87017a8e328e2a53c103b6d84e041a8d7492e56cf7bef616df26da,packed,44135,177,349,352,529,349
7078,1dce35fb1a83985efb349be60035de7f1b3f9a6d7b7420168886b5eb28da9cd3,packed,7787,26,72,71,97,72
7079,1ee195e910041c02b1f7bd760ca1ae5dd57b94d40f74303d4504a6b92b097cd7,packed,44188,164,370,352,516,370
7080,1eee9562f6eadbeeb821e7a7789ec5fbee2ed8c388fd36b555f434c672a204b3,packed,44525,177,354,380,557,354
7081,1f2a10b5e721961f1acefff5d69f91f422015942737aa61bf17c4ec7789f47d7,packed,9996,50,83,65,115,83
7082,1fc80c189c80d41728b8dffd0d2bb624a4c3ff15885d4edc97e4f03b5a1ccbc3,packed,44116,172,393,375,547,393
7083,1fde0a21933289ff0f0751f62a44279df673c0cb0896d961975fbd09def07cd8,packed,7786,18,70,64,82,70
7084,203ae902c008338a5febe30717ce7c3605b0f7f6ef850a2df0bc0f0eb9f2d51b,packed,7786,20,62,67,87,62
7085,20462219a8c2486251ce653d66a1a9c1907b71f173e7d464d4479803f42d5982,packed,3578889,14788,27957,28457,43245,27957
7086,20a41ae522a8526b27813738c20f3def580ecc8d7bd139ed138b187efe9a491a,packed,623739,2371,4886,4747,7118,4886
7087,20d3f849b14a76637eebddb2175f23d80ed577909245d050ca5c6157d6226b32,packed,7787,23,56,68,91,56
7088,212be126a7818a17f6d937d2bf6ed3db945d820107b39b2fc2c19921e9279374,packed,44364,179,338,373,552,338
7089,212f0ae5ffdb989af54d4ed7f7abb3b831506c3f6132658d952bb534fdf9e058,packed,7786,20,62,67,87,62
7090,22a1597bc55927e42efb5c6b488e234ce3ac417af9c0dbc664c067620e2aa402,packed,44046,211,328,349,560,328
7091,22ba9e2c3e96856bebb852148276749f1aec6c2443ff06fbb21e6d9ae13d4fc2,packed,44099,168,329,322,490,329
7092,230d0a3cc840f0fb847fcc1d6ae8c20056edc48138ced7d1a1bbca90dd7a1727,packed,7787,21,57,72,93,57
7093,2331525f14b71c463432fd707ac7740afc75ac1a36ead3ad276b0affbe551636,packed,46353,194,345,363,557,345
7094,23a06b87ce68963bd1c23f9b05dfba000e954bd289a062988e61576435f7aaea,packed,624133,2335,4958,4886,7221,4958
7095,23ef989348ce3cff1e656683de5317b47266968d04445cfd9646d178bcf0711a,packed,626251,2333,5024,4993,7326,5024
7096,2426e7937cd9a3f78ddf2a6755a77a5196080f511333c32d2a7ae6d3e12cf220,packed,101972,429,797,819,1248,797
7097,2441be8c3ed49fcd13bcf43b8b8c0dfbe9fb4635ce7f55d6d77f1d6cfcd50d75,packed,7787,26,72,71,97,72
7098,247b9c0dabce5c58331a0c87262e43290638824a5b9d67dc4f77fd372fb7b2e9,packed,1011687,3909,7922,8168,12077,7922
7099,2592e17b1b70aa57a4b3d639562e5a520185fe2b1a044d74bb097a5158c875e5,packed,1001194,3996,7703,8011,12007,7703
7100,25d64e9c3d324069bdf28314aa81a54372abd2ab2c69e2903a295ceba1428b7e,packed,7786,20,62,67,87,62
7101,2658388285f4a32322a8903869e03ede591b33eb79b26de60b29b7e56814ba65,packed,7787,27,53,78,105,53
7102,26e65584dbb01bf40c620d90bd123e955f5dcdfc02c1120c6e2ecdf43d3fa0a7,packed,146153,561,1181,1157,1718,1181
7103,27188b8c2dd8120092d5d6faad608cb85020930822f960cee98ca6e5697b11f2,packed,1011684,3924,7892,8180,12104,7892
7104,273b50553883d51789e1d22b871c699b728dae50b898cb765f12f7dec3193c86,packed,182743,760,1476,1477,2237,1476
7105,27522b637c7058b18c72325317feaeed97a8d8e163650b0ec34092f9ab6d753a,packed,7786,33,58,62,95,58
7106,2752a6856c26e6782ba6f23793ad45de913f7507b9d99507f27e2e81f8799b69,packed,7786,33,58,62,95,58
7107,283abe8b9d4f6867820e58c72b39cde2b659c32ce821500cb9fd3be9798a7b14,packed,44150,165,404,350,515,404
7108,285e5cd49b46fa6f675ded1b4b0687e71acc068e19ff46473363f4c3472ef48d,packed,146127,559,1190,1145,1704,1190
7109,287cdd6ecb69fddd4f1256d53d89a251d4cd4a923f60ff4602f5fcc28ca33fa4,packed,176839,688,1371,1404,2092,1371
7110,2959cfcead33a4bab308170db6886f02a177e26a542730dd7cd9849a780d6af1,packed,44246,172,314,382,554,314
7111,2982f3586923c2003a4391616968841c39ce418bd99e632fdec7710335ddf5b1,packed,44148,198,346,347,545,346
7112,29889e575306ec332e76c774c6c56a9c2a917aefbd9c3fc3d6f22d51d59777a8,packed,213756,843,1736,1746,2589,1736
7113,29cf870c342e917923b2818205ae4468fd8f4853b48a73e31372e35e37baa31b,packed,44041,171,333,307,478,333
7114,29d8f478ea7e210dc2be734fe90ef62032f1d0fbc8b3407fe503c5a8c0a94a00,packed,44139,190,347,356,546,347
7115,2a4bb8049128872e6b6647831a5041c1f73b0437e8a2597bbc5174f5e879c699,packed,290824,1103,2297,2262,3365,2297
7116,2a51fc839d94d0f8131bf9f1194f1032f8dfdc2ef217ae612fae7aec3ea71b59,packed,186091,772,1461,1521,2293,1461
7117,2ac01c7ec9e05c92cc3fb7f1365d550039f1ed7b4fc15bf74ba8157dfea771f8,packed,7777,22,70,71,93,70
7118,2b54055f5d470d244e103d81750d957303fbe8a02a1c077c6b52f106737c7d43,packed,44118,210,329,344,554,329
7119,2b680aef1c73272420ef93a18e971d6a1e100653cc6351018d9ce0f834e66960,packed,293119,1131,2214,2280,3411,2214
7120,2bd36524cb611d00534ee7f00489f87a2fa45b2e0e72da97c4535a99bccece7a,packed,184893,749,1441,1476,2225,1441
7121,2bfa5ef9fdd1615415fd7870df3804df4d6b6e24a83b360660e2cf363d210b08,packed,108403,462,808,832,1294,808
7122,2c2845627ca75916596e6ba48be6b4292e423544bb29def1bd144647956963ee,packed,44234,180,355,348,528,355
7123,2c38520b09ef00e77bbdf8e7a3f266a5e072e0d1f07239dd7fb2bc1c2bac2e59,packed,7788,24,55,72,96,55
7124,2c53ffaf1fe2755e0bc048eeca5011b679ba9c1a22792668c8766ccbb4f59635,packed,44122,160,341,353,513,341
7125,2c80436ca468cb991523233e4f6273c2856840d2aa445540d3c85cd6d0334295,packed,44089,192,353,361,553,353
7126,2d8036d9efc6496ace4e42796a5abbe988a316b2e823d4b87f76339337353b4e,packed,44247,185,353,346,531,353
7127,2d83e4d3106d712e684c4487897311d264c1242dab59f4f040004bc6f9dd1b26,packed,237432,955,1832,1939,2894,1832
7128,2e3ad8783243c13f2777c3b1920425eeada79d317b56ee5adc3483a2eb1ef35c,packed,44167,207,351,362,569,351
7129,2e58b7d6b14730487bbd9aa7686f89d84f2a1fe5159bbd308a723facb9f85cdd,packed,44270,167,366,394,561,366
7130,2e90bce7d9aa7539e6d1d581c9e765b9514973c5807ee45d4a5bcb5c4d6d485f,packed,910696,3679,7228,7348,11027,7228
7131,2e9f082fd53c77415c0230cd4eac27fc1c084402fafa86c61ff4bcaa628afdd9,packed,1013845,3966,7928,8548,12514,7928
7132,2eba40fec6d19323e440bd90da0c73453af76aa416a014a379ac2ada1daf247e,packed,186065,772,1459,1513,2285,1459
7133,2ec3236ef7c19068004cef15a7587867fb29507b93955b5c8b6d167e5c2a0d74,packed,7786,28,54,59,87,54
7134,2ed2751db289381b6b5b4db81dd9a02f368de8922f7f44ed6a07d43657e1d1cd,packed,44162,199,374,354,553,374
7135,2f1256edac40c952c29467800fd10b0316b0453b5a85797177e00e3e5d974474,packed,44180,194,344,349,543,344
7136,2f88de8fd767115938f82764cd35ed3fdc475fdca1927c43a3785b29e19e7067,packed,7786,35,57,69,104,57
7137,2fa8508a1689370baf165cc7c10225bcffad8fb48f01afe3debd68ea6e5e137d,packed,103868,409,825,828,1237,825
7138,3039482876fc02b698cc14e85ea715da7e730df3b9c36fd446027d0a7e52bf00,packed,44027,177,346,330,507,346
7139,304477964f5343d6210c08b5e02a0b84865a0a028e75378be2e239dc9cb43c16,packed,7786,24,64,73,97,64
7140,30596e4375a258ea04fbbdf1c67756c0d45c781314a1cb291ece29be5b1e1c39,packed,7788,28,58,78,106,58
7141,30ec480461a21b318467e19490f1f1533c97118849faab1e22ebcebeec5f4649,packed,88034,385,677,739,1124,677
7142,30f11caba9cdf098b236843988e86d7870671980d008fbe23333d5ff8b88e147,packed,1028566,3993,8141,8487,12480,8141
7143,315ee59fa09919d9897fa8b98c4e99862900fb773f8e1662d83dc3f51d14967e,packed,44257,193,355,357,550,355
7144,3224108d7271c9268ba21b452ba73094b65ea641afafa67d6ff42964f2ebdfde,packed,44261,180,328,348,528,328
7145,323536c6506efbfae1a8d6cb1e7e90eb5d956555f50878e0e7bfd3d2a833933e,packed,44053,167,329,330,497,329
7146,32497520e18444625d7913b8339f1aed961f507a78904a0d819b7d4352d3fe4e,packed,7786,25,77,56,81,77
7147,325b74896f0f8207ce44fc82943a507c94bddb499e62e3af1253f394aeb87ecd,packed,2405895,9389,18695,18888,28277,18695
7148,32c999a63bf28b78f15941b11ca0f91ac39867345c89a4d7ebf02adadcc9e6fc,packed,7787,26,48,69,95,48
7149,32cbb426dd4a9f59e00ece3577443e2bd5d34a5ee73c2d68da9475e64bbdb537,packed,44110,185,374,333,518,374
7150,32d60cffae543a2f19f717a7fd0b3ccd5bd3ebfea1801ddf824b25ec8600556d,packed,1011683,3921,7886,8192,12113,7886
7151,342765fc61b440f6e47ccced74ecb981a31043cfc1dbf3a04646e2c774a9342e,packed,7787,32,62,72,104,62
7152,34a2c108f91930c26b4be97318f11e97c772ec51c31cad9169aeb89f0c26bee0,packed,7786,27,60,78,105,60
7153,34dd94e8c3118d1fb0c97369bf87eab6403bc891ef25bc42baf1a9d73ae873ab,packed,7786,27,54,78,105,54
7154,34e94772f701654ea800bfa4b3d4b9e3f774f03ded73c5fc61173e4182d7b887,packed,7786,27,53,78,105,53
7155,357a712b14c015aeb620adeeaed87976421f43ab243cb1d76f73f97de9d62145,packed,44225,202,373,347,549,373
7156,357c053fd4976b1e7e60903af283f195900e5361166e19486c52262f5b19e8f5,packed,145963,560,1193,1153,1713,1193
7157,35921601a5cc96f90e181c024f2b1cd740d9cb5fb79f5185da2dfed5c39c4950,packed,236377,914,1777,1929,2843,1777
7158,35d13b5899b0f0e8087032caed7d97c91f6192a2768a6c438b122c9f36b15412,packed,296167,1115,2327,2289,3404,2327
7159,360a9afccb241ca5df232eb4265e2dde82502b7f65ed44f4be0b25a1672b524b,packed,44221,193,358,357,550,358
7160,3669a80cfd99630859cd26f5d1068cde0cb63d7f3213838e9a096c8ca6628024,packed,44266,192,368,347,539,368
7161,36caeb4b64036e62f30a594f22296fa7de13eff57220e3c9b8859da7c7b84c2d,packed,44114,174,364,358,532,364
7162,372bbc0e5db625e00a029f7707b32a190ebfcbc1f5c37bd3734bead4a69d7c31,packed,101980,429,797,819,1248,797
7163,3752289b0b81eb4b534b5ffc5c2d479ac9d7fdb70ba263d169b57dc22f6c38a4,packed,146643,564,1202,1150,1714,1202
7164,375bef1f2d320d8b20b11292d054e583fdd047e6d8123f43da43033fb0b9b773,packed,44160,180,373,352,532,373
7165,37dada66f77009e5554cdb3fe4d387f7cb8f637366cde8b240d0d9f311e84039,packed,146051,553,1192,1147,1700,1192
7166,386fe07ca9596ee6ab5c343db2620328585aa0daf2b72891f51ccb7b9ffdf0e8,packed,146059,568,1185,1151,1719,1185
7167,38e149587267a89ba19386ad06975591a459be7cc385bc410f32195d2e3e8dae,packed,7787,25,55,79,104,55
7168,390329551197869b52e70b765cab2325beac9b0dc26ae94bcee1dea2e031455f,packed,55915,243,396,435,678,396
7169,392322c066bd04ffdac11386f9e824f444eb67e3c70f15b66bd7ded1b113eab3,packed,44149,182,366,381,563,366
7170,39d5ef50cfd113176f9fd8e3ea64e54e368957f5461270506c87a287bb2f4336,packed,298726,1229,2340,2410,3639,2340
7171,39deb10239b334d76524e421213ecada733b8b718890e25a7ebde321d708981f,packed,7786,24,70,62,86,70
7172,39faa7cd479a326383dc80cfeb057837f7fb9e0508f8b073cd64357e7b320d00,packed,44039,191,318,329,520,318
7173,3aa357593d7e28ca04b2e1e660e29af0e356e9c5b67fa4144b9abd750bf230ec,packed,152090,604,1165,1192,1796,1165
7174,3ad49fe57800417aefaed513567d147d212b851bcdeeda77a918bfb85630577a,packed,44151,171,358,380,551,358
7175,3af73b1bf70a689971b0af20e9157be77a5a77f0bc3070890a6481597380c358,packed,1012995,3957,8066,8175,12132,8066
7176,3b23f26b806b0d437c36f0c743219c728138b8a8f55189e670e3fc8681cf61f2,packed,44258,184,340,375,559,340
7177,3b358cdeaff063923395f3a5025fa066a03878d242205abb4e6b52722d9683e2,packed,7785,20,62,67,87,62
7178,3b37c2100a468b04b3647c04cfc4b812b89f8fd979d2652aba257c010a3813a4,packed,44094,163,368,344,507,368
7179,3b6370f2792421a75308ba6f2573413240cbb22308bb99821f4902ab6a51136e,packed,105857,447,866,806,1253,866
7180,3b726caaa9e0ee5ce58cd7bdd50c9295c1d9911e9e712d88e90128859b43c4dd,packed,693641,2681,5602,5413,8094,5602
7181,3be185b4b5c33cb4738572f539aebb15c4abb235f61e11710460cb4915300ed4,packed,102137,432,778,810,1242,778
7182,3befd5717cdcb88c6590b9cd736cd261131a3784f5ec5a1caa33d59f6e20c057,packed,7787,26,72,71,97,72
7183,3c593cef6c7f734975f40026b7578ba1f5413ba0f3984e3dbf0b7300db6fc04e,packed,579376,2236,4619,4654,6890,4619
7184,3cbe1728404eb862d0543315a4c8ede37141e5596b6594c755f4df88c9b10b56,packed,1026521,4012,8148,8341,12353,8148
7185,3cc40d4a219574e8f373615f77aecc30261cade81c9f0b9390dfef6c3917f2e8,packed,44154,191,345,342,533,345
7186,3ce302a9252a673daadce1605fd5ac4d9e9e43d9ec3f5f637bbbdf4ce4db6e09,packed,1012997,3970,8049,8162,12132,8049
7187,3d48a1f689961b8a871972124ee2a6704570f498cc1f8715d7047305eec01e2e,packed,7786,24,64,73,97,64
7188,3d547117ac3e470b2bb6caa7e80ec0d2923c2f897619e2f7450af9da5ed9f58b,packed,55921,216,427,446,662,427
7189,3dd93886d149335480d81610b3408b0c9813c28d200aec2ef704aca481a44141,packed,44062,180,321,337,517,321
7190,3ddba594f44c2ada2718cbe62f0d686e59a4137d364c492fa5ae8c763b6e8c8b,packed,214297,782,1732,1723,2505,1732
7191,3decbfe6a45e2600f1064e7b231c763e5d4ce8da03c7e6736cdfdd85000054d8,packed,44301,177,355,362,539,355
7192,3df88b6c0a97c135329f2894b279010d29ee477ce9fc661c45cf57d244bddd88,packed,44015,196,360,346,542,360
7193,3e0bb2217ae1708dbfdb5a7e88ea7e05a772a0cc9c3d129cffa05239b6ce3aa6,packed,81035,313,685,650,963,685
7194,3e622542d52fcabd5bc1901e6e8668bd554603510fd7f6a38a3260bb7e1933b7,packed,44039,187,346,384,571,346
7195,3ef944109f80191b79b5fd87aa75535ed0b2280b90f9a69828e4c0b24a0b6cf1,packed,44412,213,343,359,572,343
7196,3efaa64cd7436505eb080db7ed58647bcb72c27ce81b24b7ddcbc998e771f433,packed,7786,33,58,63,96,58
7197,3f25494f0f507de2c7c58d9c10a0ff9f329d96e2dc813e69456f97156ed3d47d,packed,44245,179,355,390,569,355
7198,3f69cbea1d43bd373a7d98c9809805a28540a38f6d26ff2390e80563c34dbe78,packed,579720,2306,4577,4537,6843,4577
7199,3fb4fad6b625c0be4e48021347cf2f691650f306ab13763136422fc281004ece,packed,626917,2396,4915,4992,7388,4915
7200,3fd4c8e9e8cad36813ff6fc86edc7091a62a6e9e4999091205251cd9d817d155,packed,7786,33,58,63,96,58
7201,3ff655531e86423482c6133b427ed8d879a683368518289e224017b0953a2864,packed,44247,198,347,352,550,347
7202,4055a7f2b29a50a0fc40dbf89df74adb300de14ce815bca734af6fe57d1b2bc6,packed,7786,32,55,60,92,55
7203,40e0329bce7dd047ccd4e48b7b239b6048ef878d695259fbbaf6af162d435812,packed,97097,397,821,763,1160,821
7204,40ea7e991096fb1a8fd9888cc5ed714d3790eea01c3cb05c5a6b33eaf292d839,packed,220229,851,1610,1642,2493,1610
7205,41471dc421f7e1cd210292924dcbb8aa9d7569898025ae5d5ccb25ff7794b3f7,packed,44127,156,347,353,509,347
7206,415584d6c277757c1faa4fce3cb8cea5f302852e198d04415fcc0d687cafa213,packed,7786,33,58,62,95,58
7207,41aca95a6345a989d30e34ab7f2e637462eedd632daff49b471df8a54a14f7fb,packed,44341,183,337,331,514,337
7208,41e3b89b425ea1de896221b8089733da50d64bd5be564545e827ed21c8147a7c,packed,625455,2347,4854,4919,7266,4854
7209,42d04f2396ee92c82795a1e3e1f33854fab84d68f790f3bbb77de3f47ba85752,packed,44181,177,328,342,519,328
7210,433516556da1975c35d3ab49d4c8e5043a8e4777a9430fcc4814be712c6a3f60,packed,102276,421,792,793,1214,792
7211,436209021d110e98ddc46eb03dc8d27a2b7d56ad04aa0154f3d23a65ab1993fa,packed,7789,23,61,69,92,61
7212,43b41c08519d46dd49309568d2df33d2516cd4b6b0a4283c9a4da6b668157d75,packed,7786,23,62,69,92,62
7213,4421f463dbf5beb29d98e36ab3b620e2155d84d0edad96837576723ed86ab39a,packed,44115,176,369,336,512,369
7214,445011d5fae56b2aa4b1c85c704cf5be87f8ca85daed010ac705726f4f8ef176,packed,44652,161,362,340,501,362
7215,44585a6dd44252f8082851f678266248d7d19f985b56e770b8bcdebcd5a610d5,packed,7786,26,74,57,83,74
7216,4484b6281f98206cb927b3220a0c951edea4ac2a0f3cb925f6f7c29802a49297,packed,44120,201,344,354,555,344
7217,4496eb8d9421df94a5e7f2fb5de9ca71869cec768f42b4beb708b878f40d988f,packed,44184,175,368,379,554,368
7218,44c2ae94ebde4f93c019ede30302c6dc82b3952db4773ba97f2bf0a91d8aa162,packed,92446,401,685,727,1128,685
7219,44fa5ef1e4183a4d0b6722419592befe19cf1e201d63650efac5731b52cb1954,packed,44052,154,356,358,512,356
7220,453c93b2efd90fd99fb6153191b8f179654cdb944f2f02811b16cd9ecb215e36,packed,7787,26,63,66,92,63
7221,45641e9a17f2a9e924066981b7eaa610b186519536cfb2bf5d18184ca2597324,packed,44475,181,381,411,592,381
7222,45b6a11fbf0d6efbc62c04eed9fd8f399f91de1b9f4ecc5a7fb36089f9a36503,packed,44149,178,352,344,522,352
7223,45c47468bb84c470ba950954658e40aa5b2f1098a3023ceb98ff7196236fd635,packed,7788,25,45,72,97,45
7224,465830db2aae51abebd51a7894c1788842d3099a2075dd6482a9d8bea1e2dd24,packed,7786,24,64,73,97,64
7225,46a9eabb26e05cda043bbaf733e4919643ca8f25d96520f054a0e54f62bf5a80,packed,44101,196,329,316,512,329
7226,46c69ef9c16955dda50c8249f7c0cf9bc6c83c72e7fa5ca987a494529437fcbd,packed,220563,903,1645,1752,2655,1645
7227,46df0fd8ccbb7e6d254c5a55ece411fd5038d07a9577d7aec6a93bf89d62b9cc,packed,24151,93,187,191,284,187
7228,46e39d2b656e8d13a8bab448a626ccc60a15e73211469aad3f0409481f31b928,packed,44201,187,420,392,579,420
7229,47170281a0aeec6a8a8e599ea1e11473cf85b6c4fd2e7b88d9a26ef6090c9c08,packed,7787,24,55,66,90,55
7230,473b203a34a8f261eea117a514dc00146ca3c8e6cbc89358ed7510bfff584002,packed,44142,189,350,359,548,350
7231,473c84c01401fc5b8fc6f39a56263a17214a1a2b8e768e3d044bdb44784412b4,packed,44131,162,346,366,528,346
7232,47944bf482379f7222e8574fe6604fb10e0b91e164c1b60b1fd290ed322031fa,packed,146583,561,1188,1147,1708,1188
7233,47b354f1b6009d5fd03344d36adf04054a0cd64a421e7d222e2775b7eeb41b01,packed,1028304,4185,8224,8201,12386,8224
7234,47bc83d4b76bdc0b80026d7ac7760c5a59f3eef3da97d0814079c6d7030c35a6,packed,955855,3644,8136,7527,11171,8136
7235,481eee98b5e9c4357b787976104142889e00574a1ef35642a9fa7aba2bdd93b0,packed,7786,24,64,73,97,64
7236,4869fd750b032978648ce157f82c02043d2f8dd9bb7d645c0fcb8be72bede82a,packed,44358,160,353,361,521,353
7237,486d0df2abd83b2c74ed70615a6956acaaa5e2d5a67e285620951e9951c401e0,packed,44183,175,406,360,535,406
7238,489a4e1c2d5def934428946a89321b37af84fd47cd1036a056a15a9884071c18,packed,7786,20,62,67,87,62
7239,489b83036776457599aebd074a42d010b955d96d098dc412c91cd14b98ff36a4,packed,99785,384,784,796,1180,784
7240,48f23e9998c31be8f4d307531cac9fa86c772e494bf4af8667e0d95473e8fd58,packed,1013855,3954,7915,8548,12502,7915
7241,495b866a3d6e536caf20f53a1731f009dc8deb757b4d2ed18cfb45a9741176e3,packed,44289,193,341,321,514,341
7242,49ba6a87c0065f05d74746484d2aab800a6cb888c8f2f3fe8045afe2a527cc11,packed,622272,2301,4935,4970,7271,4935
7243,49bc42a1dcd23baa614a6cf5ac9604ab56c4437b9e4bf4a79435f8e92f559c58,packed,146176,558,1178,1157,1715,1178
7244,4a0e70bc0241990d20854dee6bb675850120af3c1fbfe755e1b14bacddc18e65,packed,579229,2209,4477,4611,6820,4477
7245,4a10f01d9058b26da7020588110107cb44de9551622cbad7666d93f5bfafc894,packed,44063,188,361,353,541,361
7246,4a6409d02ba3eb1235aac8a20f3290811a01f9246517a9274923f71d86b5f8cb,packed,44116,165,346,345,510,346
7247,4ab7336e0c2c9dddcb15068721a3496475a158e85f1b78e8be5889e6752aa09d,packed,7787,23,56,67,90,56
7248,4ab7b727fafc0cf9fb27d03cbf7c388f7c2bd4f99f376a8ca75a42ebf83fb632,packed,44248,192,329,345,537,329
7249,4b4531447e5b304dd7f754ce0ec80f10fd6ff22a6fdaef716673ab51a66e81f9,packed,44130,213,360,372,585,360
7250,4b66bd705fdd9d757236fdae7a8c20ccf62bf5044ac5d488838d65f113043be0,packed,142357,541,1183,1106,1647,1183
7251,4b6cd9ed188b663181f3cb1d9a871d800b89b58f7e9873865428b01a2689f186,packed,44028,157,342,374,531,342
7252,4baac9389e149e256f28d4367b04141796227928b179f3e88c743057db5c566d,packed,841197,3256,6729,6712,9968,6729
7253,4bb08bcf91ac1528f228bab04c3e98e5424e8883ceb9da66908d3376216f8c0f,packed,7787,30,73,61,91,73
7254,4c6736e4f3729199f6d9a7745cc43755a1140cacd8ba4dd483ab3c7c4a5df1a1,packed,1028302,4206,8240,8221,12427,8240
7255,4c9f8ce81a386c117c369889bcab7c3f314d60e015c9d5ce7075ff73e6882d3b,packed,788941,3152,6071,5985,9137,6071
7256,4d1581b20f3ba516385ec6cb6dda137fb676fea7d7809385e4b4630abd33371b,packed,44098,184,345,363,547,345
7257,4d9945d79fda8fc5d9f8aaafced7c4e7043f79105139bc60f0d702a67fe15bf5,packed,7785,33,70,76,109,70
7258,4d9a5b64a489f24c7df034758c7a22e7b27291beb754fa73b3fa2029db26ec57,packed,7787,32,70,62,94,70
7259,4da1440ab34842e8dd60b411cbaf579ff3d05381edcb49acf5c5ed14289355b1,packed,44227,167,356,347,514,356
7260,4e96f1a70a0dd7fbb5a848125bde3a17fbab8a7c58a74cb9d5cc564d904cb379,packed,7787,17,71,68,85,71
7261,4eac5b60a33068e6d95fc7e79484035e18d9accab346d3c0225cb2b164d4b518,packed,624669,2473,4962,4932,7405,4962
7262,4f909ad8d709cfa0eff21ca261baf3396e214171372984cc089782af4edff91b,packed,286672,1138,2233,2242,3380,2233
7263,4faa91edf286b3d643b1f91abcc5cbab8cf853800f0195032c4addedebf4a2eb,packed,146095,554,1194,1156,1710,1194
7264,4faacd459e5a373ba51a4bb7ef05c22d3269db95352604797745c80b9bc164e5,packed,44184,166,347,328,494,347
7265,4fc5ee1b66eed1d027ead685e9fcd440cb0e696e44d8280c8c7e3f78b498baad,packed,7786,20,62,68,88,62
7266,501b7a2db483a4c5a121c4b24aee473df46e94656f69e736783a88c58323c6f5,packed,7786,27,64,63,90,64
7267,503dfbe98c9a94f34d469524b2dad3260602e27c61b48184a9871f4f3a732f67,packed,44090,170,349,356,526,349
7268,506eae32df4e18150218e53fba658a772cb5aa2f44c27977f7f36c14a4bd65e3,packed,7787,27,53,78,105,53
7269,509b697ff2426c8cc6cd4d8b2a197071745580ad26db5c1ed4b408cfcc10e9c9,packed,7785,24,64,73,97,64
7270,50bc415daa5d92151747b62c30b7d94c09bfb6194f4dc4162a52af7ef1db6039,packed,572974,2273,4530,4619,6892,4530
7271,5112eab5391b8b4f6ecf0949d77eeb67eca57a16452149a67f6c3f7494a67ad9,packed,44113,187,320,341,528,320
7272,5194f57d4c4e2c53409f5600776eaba9d8cc50e64b6c837c2583a5b9927b5558,packed,626376,2285,5003,4828,7113,5003
7273,51a3f9951b6479939516bfa1f694d9e8d42cb80ad7cbd948dc34d52d71cb55a6,packed,626161,2437,5019,4887,7324,5019
7274,51dc2bbe6bc2ba2812a4077999f66e95e80e7bd99c1717c831ae919e9e324adf,packed,44050,184,346,344,528,346
7275,522c5444f799b5bfc5c31a4395a2be4d3dcde9460a9bf0797f51af0b069bd76c,packed,91531,404,679,691,1095,679
7276,5275f369a2c6699de2262d3159f1c1fd86e5335126169b2e5f8c813a973af3d0,packed,1025586,4030,8083,8265,12295,8083
7277,52fa10765820e27023cc44649774de02828dcdb9c150f74dd1470cfd03fb0e0f,packed,7786,20,62,67,87,62
7278,53214574e7765b01c8763edec41b0d5d81c47b0777e2b93fc37dee1cdfc24dd7,packed,44145,183,368,341,524,368
7279,53e7a409de0647bc1870c278705311fb56ee17bbece7624dcaa8d0e180735f75,packed,272931,1136,2050,2171,3307,2050
7280,5420e8374fe664efa07fef924bab8b4b51a141c662f649e4733b39b66445f6d3,packed,44390,167,352,356,523,352
7281,5465a7a12435f73ecbf68824a2ba2492616c80835ee07232e748b72e538effc1,packed,44228,175,359,331,506,359
7282,5489c61be65024c8f1fb6e2b626c47a440de5b3071ff331a73ec64f41e74d669,packed,185851,769,1465,1501,2270,1465
7283,54b98abec1cee54a0f7b1204ed05ef51e799426424a03494d4f33f585a344064,packed,7786,24,64,73,97,64
7284,553464833d572a2596aad4764c918f82617be6d67d5b681d409bb17ca8e25282,packed,7786,27,63,63,90,63
7285,5543bd3f075ebafecc438ea330a14bfe72741a0b6ade171bd10ae1d598723692,packed,44194,178,346,363,541,346
7286,554c0fe4fc82f6c8e663efc5da88928d96a49f31727590e55cc87ec6cedb339b,packed,7787,19,59,58,77,59
7287,55a005ea968d469bdc746db0d0d61a14440f6cb5cad8e3d5b6357a5a9c161ded,packed,44219,191,364,362,553,364
7288,55ff858f4bd1e8eed11e1a8f1216045c700800a7fe248b79276cf78ec046beaf,packed,44180,208,358,385,593,358
7289,56420c625514000c232ed3ea8f2071cdb58f3d0aaba69f456a3b372e9e071666,packed,82461,297,620,682,979,620
7290,565b1165ae6840436d574abdc9109fdceeed3d9f5eb0941506a208d878360235,packed,7786,28,54,59,87,54
7291,567206ac2ddb573abe53817a73229c77bdd1582fd4dcc6e0a3d5fcb398ce2f6e,packed,44131,173,369,352,525,369
7292,56ee71b22d1bec7045e5652821c32ed729375df4b2362a4b2e0e28a033510af0,packed,7786,31,57,56,87,57
7293,574c2a3c107d224351c4bf98a8fdd96e5f79c2e8bd3e383457ac1670138e422b,packed,44200,153,322,388,541,322
7294,577fb88bfefc53d7c144c5e9d8536e222859c519d3d68aab50c22d0c270ebf79,packed,101278,400,768,799,1199,768
7295,57a8aa2b7c939d5398ab2416e58239bd6b78cc4ff73bdd4a8c7a3a75f01b4aa9,packed,910696,3679,7228,7348,11027,7228
7296,57b017589fc50ab71ac5aca76ee922bb17898c39626308675ec4c1898d6b8ed0,packed,7786,26,72,71,97,72
7297,57caa289958b1b8d18e683d5e7985e35452e2b41b3b5ceceb01488eb462cbffa,packed,44190,166,348,372,538,348
7298,57d9b86f5a0cb82bacd967f309a7ed588181ce13d24d49051636bf25e4e065c0,packed,44129,161,379,378,539,379
7299,58681d54326de478dbbb5b9e56a054d5444602d44ec1c9247528c56b41a2ce24,packed,113767,464,880,883,1347,880
7300,586aaadbe778ed6e330a17b9ff469f5cc7537e29b107547f4e20a3383712eb0c,packed,44374,193,382,352,545,382
7301,58ba68f037bce63fde0c8e839fb5b095e009e30aa705466123aad450e5c5e6f8,packed,44355,204,365,378,582,365
7302,592ae320812a4429dab2c91a94e62add6c62920ebc5fee6b21524bbf2415aece,packed,44358,170,374,347,517,374
7303,59a378247666ef66d8df2dfb056f670dafdbd640bd6021049c0b5a01f5370323,packed,196859,824,1484,1635,2459,1484
7304,5a2a8e7880b5c3f034e37c9dace8c1892f14ceb095a4945312d1c33303884de7,packed,7786,32,64,70,102,64
7305,5a72d8d990a0f95bb10410561fc6f60851e0875a1d682d4799f30cd77f989090,packed,44927,196,341,359,555,341
7306,5aa86db372139be2941b1bdfec24d987e100ad099531b0887eb2550679079a62,packed,7788,27,69,82,109,69
7307,5c29401ae2d7e397c5586a12046e5e1f73ac39340650f6ac02a29e5a80577ee3,packed,44269,181,345,352,533,345
7308,5c88b81d5c5b82321ea7139000d7e4c6617d88a72a8c10088b3fc46d4baa01f0,packed,44255,192,363,352,544,363
7309,5ca70d99b69f469b009355bb25aff35644c27e1c1d4b879ed9882415cc5de3c7,packed,7787,26,72,71,97,72
7310,5cd04063f97d57cdeba5584539a590dec38283a0ed869185a7f2d3831c4c18ac,packed,1028301,4213,8227,8197,12410,8227
7311,5ce8222994856a38493ff568051c1dbc206d299dfdd79841faa84ff8a82a52c7,packed,44243,215,307,341,556,307
7312,5da98957dbc12563227035e7f7882ba8b187e6b787331219e751271e4e569dc3,packed,7786,24,64,73,97,64
7313,5df7d9ec8d4cf09b2aad3d19438fb4aac7f9912a6293068f0575a8002663f4a2,packed,45222,158,365,345,503,365
7314,5e01eb8c2eadbd9ae8ddf9d16fdd074516c67e85ea113170e46e260be6dc95cb,packed,44487,178,352,336,514,352
7315,5e070cde3455baa1ca4408e2865a8f4732172d1baf8bfa13b9ab70e0ece97571,packed,44026,150,314,346,496,314
7316,5e078c2e058c61b8f2440302d95d1949303bc796a2e27aca86552aaa820cfae9,packed,44211,205,359,351,556,359
7317,5e35acef2263aedf04ef7892ad4c87daedb2741ac8c7ac67aa8ad431d5e41e80,packed,44288,191,336,314,505,336
7318,5e3edb9f88bb59adac1cfcb7353ff1824d0264bbaa7020b8e7a19408112c2eee,packed,146098,557,1189,1147,1704,1189
7319,5e43dc61511d1466512211d1a8b4ee8566d8877fa6cda8a956b2ee8c8c56c611,packed,44065,190,358,341,531,358
7320,5e7648eebb1200215e6fbc4917071dcb6167b9cf60dc477ba536b0f40f775bb5,packed,579009,2242,4467,4508,6750,4467
7321,5efa1fa4d0e3151618e74734366a725d6f6b6287ba468a5a8cff71ee5c776b14,packed,290872,1156,2150,2316,3472,2150
7322,5f291887e5ed412e2af0a0b54ebd1c771ea28edc6e751cc6c9796e392e5ee059,packed,7786,24,64,73,97,64
7323,5f527916fde6b732b002959f98bbba6526531a58ac94c129a196600eb3171685,packed,44069,179,347,354,533,347
7324,5f7bfd95228c3cd6242ca020641076c7683706248098c59e5b8bb5fe8367c2eb,packed,44238,188,387,346,534,387
7325,5fc6f5d6099609ee565473f7c49a7c2409b1e075cbd8c46d8f4145d23a416444,packed,7786,20,62,67,87,62
7326,5febb0d78853177dbf42dc93d041f64afc9ef01bbac42c133263cfae0504ad25,packed,624783,2380,4934,4954,7334,4934
7327,60332ece64f35d04c16c6b11c7390ff0b6c74237042cd6ce401ed40af918658e,packed,44144,165,357,345,510,357
7328,60b76c816222c35c5d1f6baf341a5d3283259a3f91d98e00c36af19f13a8d70f,packed,301633,1239,2306,2375,3614,2306
7329,60f1ad7ab77a52b8476ce70cb889d03e8cd3ce28acc5de054f04deb8ca463c42,packed,290226,1145,2180,2237,3382,2180
7330,60f4da29ff89f10369947ae4169a0b7faa0fd786b5d4f56945dceaa8715a0234,packed,414386,1685,3235,3328,5013,3235
7331,610b2465ae5155d2de0d8c24f34c3557cf63878ac26b7a232df0581bad940c00,packed,224734,838,1856,1970,2808,1856
7332,6140ae805a68bde8e03145ce3b8a8428128e3fd920a981f91756913b1142a575,packed,194129,865,1469,1521,2386,1469
7333,61420c4ea808ac2a634b2137f009e07b225e5f00c20cf04b5172a3d48bdf3412,packed,7777,28,68,51,79,68
7334,6149a1ce6ff350ad31a42e6f7f8e505663a222694d61ace97688701649012d88,packed,44042,160,323,350,510,323
7335,61d85e7a2d58363f95427521f38d17ce2deac95864acc860270d40e6f685f5fe,packed,152198,607,1147,1204,1811,1147
7336,627445e3d2796660806a6ee8d377fd8d000576ad8b39d83ca0b35ff6de9441cb,packed,7787,26,72,71,97,72
7337,62f05ef38f19d0aa5695653813abdc99922046d24943a50e7d3eb84dddfe27cf,packed,44188,220,301,364,584,301
7338,633ba4f749f8132b1431f3f6ade28e731e7e27995416e2d2561cc368855fc702,packed,240105,916,1842,1974,2890,1842
7339,63605525d62793b50ef90359c878c9cfdfc31300f753fb088f4a0b81a8324969,packed,626885,2385,4947,4977,7362,4947
7340,638ed102d6b6e88879dd8558de24138ae7caaf0fad8035278b36fa036104b223,packed,44697,181,368,378,559,368
7341,641a94ffa7df8fa4edbbe77b066f7d889ba40b883b8d08a5a5d4b48063ea5957,packed,7787,27,78,81,108,78
7342,643c93aa8348d496118c0e50a0034e4aa80b46a6281abf5f40c394a9640c5073,packed,212321,795,1675,1677,2472,1675
7343,6443c469db06ead5d79142390bbaf95aeae37c09aabb560c1a90795aae45f8eb,packed,285071,1030,2290,2283,3313,2290
7344,64464ae0ce7f47e0bde76ec8c3b74523177960fb735256322c8080727d7559dd,packed,177510,720,1409,1491,2211,1409
7345,64910ac3e8fe4b3ae4628b486512138be58c3e54f18eb704fd5ab7cc5b3f30d0,packed,44153,166,359,330,496,359
7346,64d4c8c2861c1aaec3dde34dc4300598d4c7ba04e73cf59e1cecd792753915df,packed,44225,192,371,329,521,371
7347,64effb84cff5f14940bb2455bb0bf6ab266af5f1b09b9d2c9858036e25b3aa51,packed,7787,26,72,71,97,72
7348,64fc79f19fae42af13ee2ee6c518ca34fa2ae107c2a6da541ef87d8e312f0691,packed,7787,26,72,71,97,72
7349,65c69327dc1e83bfa587dcef24305b0b34a83c3e697fb8065b09f8bf8269b14d,packed,44341,173,368,385,558,368
7350,65d66df55ec7348511abc76e1d9f928f01aba58799f68c327c7a13d519c6937d,packed,7786,32,60,51,83,60
7351,65e99e2b5ddf0a9b370997f0ef067e57ec7922d3aabc0accf4261ccef2be61b0,packed,7787,26,72,71,97,72
7352,66126f5c78adc63889807e2b4414d87122a5add8b9cdddbe390786fd20b31b33,packed,506449,1973,3986,3847,5820,3986
7353,6626b909adb5ae4b63c495bcacf5ee975f56b86bb4a8ae7374d4c31cb0991161,packed,44234,191,336,343,534,336
7354,662f3828653254c4ad687152316e781ea4eb2bc940e297a5c91965a6e0e8d47a,packed,1013845,3968,7887,8560,12528,7887
7355,6649fbfa4f627dd2a44be6d1d829e8e1c095103227ba5190231fd0a7405f9dfc,packed,304754,1268,2407,2479,3747,2407
7356,66633e69ef65ed45fa4b7b5ee374a60c4ce0f141af640e43b860e381d405b285,packed,146257,559,1193,1162,1721,1193
7357,66cbad2d7007fb968e53405adba0e58634bf744f541682fe4c25a2b920bafedc,packed,249102,1007,2078,2072,3079,2078
7358,66dfa02ca7f738ac98d3d173177065dc54fb04e5b918759e0a8f6cc06fe51a77,packed,44342,198,313,346,544,313
7359,67433bd77e10a67480381a2567b2226d8580b71dc8ec7466b29a21db0177f6bd,packed,7786,23,61,59,82,61
7360,6746dff8a1a2c5a0db1053a8d45e5b74ccfe28a729cff98c1e6d15d8cc95d7c2,packed,7786,30,56,70,100,56
7361,679cc848006065046a5660cdd378355554f74101446c245ed39c93b65582da5b,packed,110554,448,822,874,1322,822
7362,67ec3b7cd1ee4b5fa8c2f9f7b36b33f89599102179a221b2adf41a4551f611e5,packed,132149,553,1020,1097,1650,1020
7363,6829d163ea208c1b8ba86f2e19bb0d5ac86299937d74d0df067776521cae02ec,packed,7786,16,70,71,87,70
7364,686878688f49abef2a10125ffedae9ae29bb0de682a977d2e9c6af0bdbece866,packed,7786,33,58,62,95,58
7365,687bfc7fc6380be200150c9ff290549e243b5d09fc97a39c87744c938506cef6,packed,44144,164,347,367,531,347
7366,687d05da5a05bfaac0bb8e2dd6903f983ac5cd3e798472a11c152f74d5dd8f06,packed,148956,651,1116,1329,1980,1116
7367,68a09221efa2c499d1413784f8ddd9240786ccbfc2601c3f62b8d7c1145b43c4,packed,213755,852,1695,1705,2557,1695
7368,68b5fa482bb2ef54f1f6550b628f6e1e71c940255bbe6c22385cc7ae178a6bf8,packed,213755,829,1696,1717,2546,1696
7369,68f7780b7ae137de96787abcc975780605b017c949919be5ad1edcf01370e40a,packed,44337,207,364,359,566,364
7370,694ede84431bba8ac53236a49ca1045ef14b8debffaf786742bc7f56bb1c7708,packed,7786,27,64,63,90,64
7371,69d8116e17e52762e174595d8781004652de47eb7f5aaf98238619b45dda0650,packed,44601,171,368,336,507,368
7372,6a491e55fcf1696e24d5801b480006e95b3ddf5584a7ed9df65b86191005e698,packed,146042,561,1183,1151,1712,1183
7373,6a843fe15e545f55d7dbf30c3cbeb248d44c03c8fdc913f10db3de5a728f596a,packed,44391,188,338,403,591,338
7374,6b0203a0f3ec78d0e259839ed2c493d5c2cf85b9e6e290ba4ad897ad3c594b04,packed,183939,696,1441,1419,2115,1441
7375,6b2b65bca6cc6b8b6f3c75ef5477738e4fa48a189a921b779c552e64a7c756b0,packed,44157,156,344,356,512,344
7376,6b7bba82b9308da3c3dfe1579f138ab8f8b863d54e9140a8418e4775d2eff851,packed,44050,187,349,381,568,349
7377,6b9326d3567547764ecafc4d3172d5a33bc2abf6d4c4dc661ed6ae01d6978e26,packed,1011684,3919,7907,8194,12113,7907
7378,6c7dfe383b073db0683a14072fe8e94f2dadfdcf56bb80f0c312a5c4da20f385,packed,7787,26,72,71,97,72
7379,6c87b069f5cecaecc7d027c63c40a20b83fb8eb6f667d92e317b1b5991e2b79e,packed,44278,167,361,363,530,361
7380,6ca7bfd38100bdd3ea9befd5488fe420a15931fa8ff1e2ffcb76020753b80284,packed,7786,35,63,79,114,63
7381,6ce8ba38612d7ce436829206e0bc88f00382e0739d4dc62e3c4d53b4cddcdb16,packed,2387619,9343,18612,18686,28029,18612
7382,6d09bd9c84903901e777e336f3fc65172e1fd2ba1873ad2880ff8c1236a687dc,packed,7788,27,69,81,108,69
7383,6d7627ad3a868cd32b64ab3afb9492af31d948f525f480b12d207079bb8e3926,packed,7786,21,73,63,84,73
7384,6d809de6baca784caafd5a5dec1ece00c5ab83750552aeea032aa7e5ce50b61f,packed,44160,181,333,368,549,333
7385,6db7273af97435fc064d1ea508a45174d2fecfd2175ad1ce8a346e54f4b05209,packed,44147,166,357,347,513,357
7386,6e00c55750260b98ed27772efa75cf6a6357052b72f2fe51122a2eba99ffee3d,packed,213488,826,1627,1720,2546,1627
7387,6e2f21983338fe00c206525e36cfb9a29d83af373a8febec8fc19435ce957ac8,packed,43974,183,334,368,551,334
7388,6e30a6e81be46a3991c236dfd9a8b2ff7f7ab99a20fbe93aad644c91a0d6bbcf,packed,7786,23,56,67,90,56
7389,6e371ceae5b79c0d8b658e38cedf41970628e30362425dd82f9cc9e890c48daa,packed,7786,20,62,67,87,62
7390,6e8f54f8b4b55b157ccd2416b6eea7b2baa042e77ed52310b880ac6ef3429400,packed,7787,24,66,60,84,66
7391,6eff7037300016c0d1192d81f1c5aa90a6793164ffdacded4f6e86d11cb3621f,packed,7787,26,72,71,97,72
7392,6f15f7bd1e5da904790f5db93bfb25f2749a147421e2169b6e22e380f0f30054,packed,44126,189,345,365,554,345
7393,6ff8188be6bcc80379f9e24a244e5987bab4d02197dbe73a30bf6a4ad8bbf80a,packed,626045,2363,4951,4954,7317,4951
7394,701a6b86eafc7c7af43de862f32dca1de3dc0edb03f97a71cb53687e7f75fe04,packed,346030,1375,2806,2902,4277,2806
7395,704a31f7210d8af625a0087f108a39e93b3b6d4120b4ca98038969d1805e90b2,packed,7776,19,63,64,83,63
7396,70d2664f919b12c448e6a386a812e09973e0b4004b905b21dc83d2a542df31ab,packed,234859,875,1863,1931,2806,1863
7397,70efcef63315fa9bed3823a40b6a213f72d7333bc5da211da68c8764b3ec6c12,packed,46983,203,388,382,585,388
7398,715caf1c99f8b4cbdcbdf39bbf80525f423a099642298846c47af9bc8b552e4b,packed,158192,635,1240,1323,1958,1240
7399,7188c70703fdc19fa571356475cd64516dbfd4bed68514e2a75a32b44087a761,packed,1025587,4039,8091,8261,12300,8091
7400,71c20da993d40df7dc9aefbfd42b4dd34d46fa6baba91a48713ca3f265332360,packed,7787,26,73,71,97,73
7401,72217cb358acef139361abe55770d1d29024a75ab2d54f72606df97aaaee6102,packed,44217,151,361,367,518,361
7402,7226e8938ad4ebc05b08b87e99e7ffcc926055740cf78c843d2418715d3e59dd,packed,7786,27,53,78,105,53
7403,73162234dab20a40b71c3fae4cfda3f29f11dc299b7b97aa65953142c180a73e,packed,182814,704,1448,1424,2128,1448
7404,735ada378f00a45e0e558397580b4fdb2ce336b542ceac666b4983706fa5c41c,packed,44080,180,346,356,536,346
7405,73973ce54aec63d3eb97b23146e2b4c0abd8c6bb73ada6188e45878e59bf701c,packed,308384,1174,2366,2415,3589,2366
7406,74206da51a4360b48a44ce967444208ad227e47852e5ada777f90eb8143827fc,packed,145943,556,1189,1155,1711,1189
7407,7422c40fad44ae756d137efabd7ac466fad51b9613ade393bd387fa3e5011eb8,packed,43983,195,326,353,548,326
7408,745fbe68fd0f5194ba459998de52d248473d18b01a999e2ed3ab677ae2db7efd,packed,45711,178,338,385,563,338
7409,7467524ccea8aeaa0f5a94e56b0ed618d16302b3834e14565278d7cfdd29f364,packed,7786,20,62,67,87,62
7410,747ce97678ea8e8ee69afab2bc4f6173a4f78dab86f1b3be707b8343f9f8870e,packed,44359,165,333,390,555,333
7411,749a4e7d04e779659c468426e9382096539fa4d101750c1fa6a5f545eda4f710,packed,44035,168,328,364,532,328
7412,7532c855f5263f4b7d0c188150a71656984c9fb80da17197a47a41bb3bc4712c,packed,44169,169,316,379,548,316
7413,753b855604288e37e17fcd2187b299b17ef432bd1bf9235b99e0ae4f3f71bfdc,packed,50396,192,406,416,608,406
7414,7572e54d8850d24a9ca1e92747535859647f007647b5d17aa7f31c7d06c58556,packed,44237,200,337,385,585,337
7415,75edebed1f161b1204e4cd53c1cd15c180089e1bc4fe71002827e8872ab1a060,packed,44100,187,357,356,543,357
7416,75f9be2f63a25bbfb3377502d1a62653c089debf93209865dd8c5e50c3763931,packed,7777,21,64,69,90,64
7417,763a262c637f9b4fcef413c2aafc24fee2edefac987060e9c17ae5e62c8c9a0a,packed,44042,172,367,361,533,367
7418,76b23c6e45961fb38ccbed61d77432491349870c9ef5158bcc27a9a6f159abdd,packed,74687,255,583,596,851,583
7419,77aec2b3933c9f761a0e6df49904543c0114f967f179a0c8820b0a64b1265916,packed,191934,717,1576,1534,2251,1576
7420,77db4d2901730fdce94ba71e37c6a6cf5d2336ba9468ba40bf5184bd728d15e7,packed,7791,34,55,66,100,55
7421,77e957a5e2d972aa712e9b7af6f137e489e4999d3ef3b5c6ffcc1229a9d36df0,packed,146601,564,1195,1155,1719,1195
7422,7870ea287875f61bd8d026993cf2d39ec020973ff4946d3974bed8462d4e2e39,packed,910697,3681,7211,7354,11035,7211
7423,78a6d252b0f92033be8eaf0d85aec70a3b3dabdee65ba571d65eb8b00a8a3b56,packed,44121,181,330,341,522,330
7424,78bebb0e25d2342fdb4d60f64e6a4d91665f684d048647d1ac95e44b97a3c84a,packed,44082,176,353,340,516,353
7425,79ce11e18490ff836a9880a7a63bb73e7bd1571b9b1a8041e50c4aa3cd7ea874,packed,44019,160,379,359,519,379
7426,79de13c76bfa5e7c6be93b4cea27d7002b2ca6d8c4c61e4c5888f4ce13e8c3eb,packed,7786,33,59,62,95,59
7427,7a3dec8a51e2a47c9ce520c852039c97d00d2949448c35b3f0767358b0190212,packed,348606,1449,2676,3145,4594,2676
7428,7ab6fde11aa810c08f1efad1f3272c2d9f03e21fbabcd69d7032ff331a7e3576,packed,7786,24,64,73,97,64
7429,7b1d5fe8ed8ede478aefbd990682eb349b1b563bb68c4915ed50537eb077a561,packed,131958,516,1020,1039,1555,1020
7430,7b4d1942b7518ff89a75d3de274ca8600b67ba7b11c352cc77411fc10e53b9e4,packed,504951,1892,3985,3849,5741,3985
7431,7c1f3d3536e462add0355af58a6f90cac756c51fd1f4998b9e55aa5db644a757,packed,44130,178,360,339,517,360
7432,7c4551e2004915a3f4907df93a8c1cd400f80705b51f211228d575bd4dcb68d2,packed,44089,169,351,388,557,351
7433,7c681ee61370b133200de661068afeb834ce9c9918ba9202313f368eed7ebfa7,packed,7786,24,64,73,97,64
7434,7ceb5a670107ca2cd906bcd66506ed100426c377b7f8d3d5219a4af703c0d627,packed,7786,24,64,73,97,64
7435,7cf35149dcbf00c1ea75f19536d82d00ac383a733c024c65400a64a68b2cb24c,packed,44096,186,381,359,545,381
7436,7d3c95cea0b21b7cdef7182b9bf94f6ee9953b46424d99215e5d92b317bad9a8,packed,1169870,4592,9142,9202,13794,9142
7437,7d5bcb84547bfd3fb8c27bfad264c0d12cf3c8da9a5d3bba0646f654910077d9,packed,2144266,8394,16625,16687,25081,16625
7438,7d808611959334f2ec092e2dcd206b77a9d05a9229482d98eb0a04e9b9a0653c,packed,145973,552,1180,1150,1702,1180
7439,7da5993659ccbcbd8ac077feea228a4d270b52bc6c92e970c05d4142177f70c7,packed,176572,698,1377,1542,2240,1377
7440,7da91906d74408ef7a86eb698e1d49430d842c863bd783c1c4dce436f768b1bb,packed,7786,24,64,73,97,64
7441,7dfacb4a4797b140dea22957905899d5ada99c2849e57666bb05312528c6062b,packed,44159,193,312,337,530,312
7442,7e114e459a68815a009662a0fe10f3a3fbb3009ea76edc74dc3eeae1d67b678d,packed,44158,175,356,340,515,356
7443,7e5041bfe78fc23526d88b8c140fd4c0ef30be8f907d7fabd3edf2bc4814d8f4,packed,7786,23,67,61,84,67
7444,7e9fc363360b7264c041f080da350ea123235364a9e1f173040fbe46b722ebf5,packed,7786,27,63,63,90,63
7445,7ebb16e312843314de4cea51507b2246c38e25849b2a503ba05e147d79715970,packed,7786,27,53,78,105,53
7446,7f02611862324a23e489f4e84ea221a34de2dd4447f619650db73876897742dc,packed,44154,191,322,345,536,322
7447,7f2f8e3ffdcc7134e2c627516e7ed15821e966e7b7a0c526393c1fd8f6ec2f9a,packed,627262,2425,4987,4935,7360,4987
7448,7f32733ecc9b31f1c6180901d338e446c181208ee7adf2247fc4680b632ed390,packed,2777815,11275,22133,22680,33955,22133
7449,7f4522a709b4c8757ca602e5f3626b265eb053a250cd4fd4b753537d9dca1042,packed,44197,167,354,386,553,354
7450,7f8910165db0bd672533a1409b6c3ffc643c184fbba53b9158f4061db0f6c499,packed,1012997,3963,8072,8174,12137,8072
7451,7fcc29980d752187110ff6eb1d3f8c2055f584a981ff8d87fa1761e69ddf57c8,packed,7777,25,70,67,92,70
7452,7fcebee3a996c0ba1e7693656ecdc6af87c5dfa2ebe032878135a4d09829545b,packed,623971,2408,4967,4874,7282,4967
7453,8034439209810c4ca9dc32dfea3cb606f712a82a11418ac589ce4217cb85fbcb,packed,101413,399,784,795,1194,784
7454,805e7f6b623c5860840839571d021f0abcdab05920eab1ce8600fe18c0bc8ddf,packed,186044,785,1468,1521,2306,1468
7455,80829f3c1b1715f4b7ab0da8a95476f8049352bec5b181ab5e75f79cb4ccb24f,packed,102548,378,806,800,1178,806
7456,808aa1962e86dd85be3aa764a9cb946a3cfd1e4c603b312250d835bc552d55a5,packed,44355,184,358,370,554,358
7457,80990694fff03daea020adacd3948b666faa3a5761ad827c6d56f730287d73b1,packed,185992,780,1461,1505,2285,1461
7458,80d663da7db329fc962be7cbaca4695e1703e3c3b2d14b405dccad6ac8a80d12,packed,221047,861,1658,1682,2543,1658
7459,81e6168d2054e94ebaa880a4079b5efbc4e50fde3081c43336240209de0db220,packed,3686667,15244,28841,29355,44599,28841
7460,8210bac91cef1c6980b6f9b78fef7591822dd61844b6934c30bdf49175f08b2e,packed,44049,200,355,357,557,355
7461,822981820a7d9942f8b4e50bc7df0be8c5d928d045fa730b375d998bb09a9ebc,packed,176571,705,1392,1478,2183,1392
7462,822a61196cff793e6cb27c8671b98f04425be7b65d4b250d5a5c2edadf396f96,packed,146145,559,1191,1144,1703,1191
7463,823303f2657e61663cd56e542fb7d1693631dc92016540dec2846f3541b61cd1,packed,44157,181,347,321,502,347
7464,823e742fc917dd53b5d327078f30140a5be002a137eb989d88748f92e2d7afae,packed,44113,188,316,335,523,316
7465,82407195c3715479706f62ab4a2091c3d8d9727ca4227f7231ddbdded3c1224c,packed,7786,31,52,69,100,52
7466,82e2d6dc3f39c279103321e568733c40ee00884728ca0787590e6639b831ee9d,packed,44784,188,328,353,541,328
7467,836430afdbcb1c78dd82fd2532dee69896458767499e92c7bfd7d3821ec521d7,packed,145926,563,1195,1144,1707,1195
7468,83c3a723fafe5a685bd521d8ba9bf1c2fb6df5a8b502ce1b8c5c3549b36d6dd4,packed,293159,1137,2281,2298,3435,2281
7469,843bf3e95a58f4acda280e9a923a5f6a01077327f5c580328dd5980ac40421eb,packed,44254,177,330,370,547,330
7470,85022d2fdc06f1d3d8cb3f8ead61240ddab9a5fc0184d8af4d66d9ecedabadaa,packed,7777,19,64,64,83,64
7471,86178b26ccee42b2795b861a67d742f7884c7d515471118e220ec1c226dbf3e6,packed,44801,214,364,346,560,364
7472,8623d0f58cab0b58fb266140e5cab02159c8a69eacc0b17fc76f53fa6f62a808,packed,44129,186,331,346,532,331
7473,86713e3376f301fb3d732bf17e8c139bad52c33927e174080d9998ebe7e55d47,packed,146312,562,1179,1154,1716,1179
7474,869fd7382e619c3a709f7c26efe0fac3a78a18fb31916fd803d0ddcbec10c0a9,packed,7786,31,48,63,94,48
7475,86c739890ec00f2092a831d9f579163ce4ee081f05e8dd612955faf378fef228,packed,101852,405,808,873,1278,808
7476,86c952bc87774f3bd203766a4e5828987aeee966774131354bc4e3afb73af104,packed,44536,186,373,384,570,373
7477,87300ba55e7259b27cd71c66608db3b5efcfbc99c75a164c339c7d4712d4b32f,packed,44174,193,355,399,592,355
7478,875fcc4b4d916bbd17942b0bb9f3f44d8d261b5fa49f897b87c2cf7652af9dbb,packed,146065,561,1183,1160,1721,1183
7479,877cbe4b33a9126bb876b7ec47475e476050bde091ed227a0cc2d137970c5ac6,packed,44092,158,373,350,508,373
7480,877f7a064f6d9f0a3f6646f76099abe20c052089170bce42a618555a2fb7aeac,packed,44245,176,352,367,543,352
7481,879a9c819a1be72464b525c81dca5d2031da389dc95b190de47a58d6e3164d90,packed,10891,41,76,69,110,76
7482,87abb360cc4c720682b4c5032bccf62e8de57d7ed93dc9ac72f3bfb66077d8b2,packed,146022,555,1191,1146,1701,1191
7483,87c23f575a8c36eb7d83884eb9e5ef3d5a80e56e22cdf8f4eda6af245ee8223e,packed,44251,156,365,389,545,365
7484,87f4d4af07af7b1a3fa7661047bc6f9774e7e24bfe2d2bd055211c0747970a81,packed,1803223,6980,14275,13995,20975,14275
7485,883348539f57307f06ecb66170e2ccaec25aa32624a4c2e8e566c40785077eb8,packed,108692,444,836,842,1286,836
7486,883980a6cd525bf13029f10736f37be6c6140c75467a33a97e45b44be585d214,packed,45555,161,342,345,506,342
7487,887bd68b1d25b111caac3dbbd7380011d0eb73d0ddda23322bb2d58f3ef1584c,packed,44051,168,314,368,536,314
7488,88c545828cf39fbdbc998c8921f3d479174d153099bc1f8df6503d4898273776,packed,627320,2400,4899,4869,7269,4899
7489,88c8921452ca4361803f73fe31090ca1172116b78a9a50ce4c80a2126fdd9cac,packed,7787,26,46,73,99,46
7490,89052cca472e966b87bc3b8ad4e089d7514c61803a2a0636b06dbce175ac88ca,packed,44179,158,353,345,503,353
7491,8940defc8ceede8b37e186e1d3670ef3f6e42278a73ad0354b96590623835abb,packed,7786,33,59,62,95,59
7492,89f6d3c60ea8deda55f245f752eb0c1c8180d57794d09f2a0cba50f88086aacb,packed,74530,294,599,591,885,599
7493,8af15aec968994fe051284aa41060a54885df8aa936bb72529e1dbf1e54f5183,packed,146051,561,1190,1150,1711,1190
7494,8b8991db04fd4dc3bd6e9038d0ed3c8d3647970113221bc2f8294bacba074b1a,packed,44172,191,360,376,567,360
7495,8bf0c79d24cff80cc71b10fad40019087c1ee2dbd79335cd232b0591fa788787,packed,7787,23,56,67,90,56
7496,8c3a3c2886906e9865910c639d6e6f82277d03a16e617f31058dad19893925ef,packed,7787,26,72,71,97,72
7497,8c426e6900f455df03c11f505fb18e5aae58831c6c87208aa87518db7cee718c,packed,152214,601,1171,1215,1816,1171
7498,8ccf3683c2c243073b81cd81ae88d4b6ab8a2eea48c8a0441161573202bea68f,packed,244725,948,1982,1970,2918,1982
7499,8da8340542862ec95cb14a8c5194788da2881daec2455043f87abff716fa619d,packed,44174,152,349,367,519,349
7500,8dacde84de3b727959e3b19a8cd33cbfea492d964fe2f7eb0e47b429181128ba,packed,7786,33,72,60,93,72
7501,8e7148842df7dccbdcb371185cb87f8f4c6b4afc53f88fcd5a1ed0703211c3d5,packed,7787,26,72,71,97,72
7502,8f59af32934538f8d14698142994759da6825cd8741a3c815012ff3d8a19e328,packed,7786,20,62,67,87,62
7503,903934defd1fd24e1ef28872c7e8a9405385269d13cc508b5ed4ecc88b1dec5e,packed,624018,2362,4845,4906,7268,4845
7504,904f16e8b0fe9e781570cd05f7f534956f51a3bdc8c7ad007b480062c7963ce7,packed,7786,35,61,50,85,61
7505,90695f7dac7e0ef3f95cceacf73188476566855c7007c23bf22be8e3c7935f9a,packed,626339,2364,4863,5003,7367,4863
7506,90e9859ae5a9a6e8fc16c6f1c4f9aec5aa10ef96886fda387a8d694ee9323d83,packed,44172,183,367,343,526,367
7507,9108079f9348e5d5bb53f4e9cabe69d99d2c56102563eb7ee258cabc8c10010d,packed,910696,3679,7228,7348,11027,7228
7508,9158ee7d13b14a3d87b1732299527fbe0cda2aa22809c299168a58ea2500da00,packed,44140,184,364,372,556,364
7509,92bc8d37cea8e7bb542b0197555f2748a80ab5da5cdf739ea54f73ff3ef464eb,packed,186141,784,1450,1517,2301,1450
7510,9337a0c1c41ac53e3fcfd1f96712956b8e4f8a71baafcad13fc4f6b10bdc28b1,packed,7786,33,58,62,95,58
7511,935ed66f87eeca3ba81a33cd4deaa6e2c17ceed41d1d53000e14ebe72958aecf,packed,44088,159,365,330,489,365
7512,93ecdf2c20a41357db669b155f27b54e895ff9e04f981675e3b648eb6c042f14,packed,402547,1621,3158,3247,4868,3158
7513,9416a9d2089f7f945ec034a28d8298b6317fbd04ed6b58ea4c64f3422c4591e0,packed,7786,33,58,63,96,58
7514,94327b792767785bfef9e6c896be6dc3ffa81d4d7bedcbd5beb87d661ab253c1,packed,7787,26,49,57,83,49
7515,944f6a2debeae1a6f83b828a72b473499a7793a88d4b15cf878c96e392bdf7ee,packed,7787,23,56,67,90,56
7516,9458996e600e85ad860a85e15c72f98714144a9eee359807e4aff3e8d9f33868,packed,7787,27,53,78,105,53
7517,94b3da50e805517562c55dd5bfdee51896df823b4464e24f9e5936390e5ec74a,packed,44031,164,340,330,494,340
7518,94d5abebfa61bfd8b6d87359381191c5288fb347ed0952afb0b8ba0166960624,packed,44207,162,360,347,509,360
7519,94ee215a021e998aed4154aa3d19d8f7a2db4cb5f87bb52f95ad954f9ebd9109,packed,182652,709,1485,1436,2145,1485
7520,953c03080bd3bf6236f1576f07100f0d35d8a6a2d6e3709739d19675be229927,packed,7788,19,58,75,94,58
7521,9543221ecacebd967452f236fa226821cf9bad55fae87c664138354f762c2fb2,packed,44067,167,318,359,526,318
7522,95654850f55519e9832fdc1f44cc1ad80a89aa442561ccffb1f8403060404303,packed,7786,22,53,69,91,53
7523,9623fbddc1e5755b90db7a1d48a37eba3b6e98929fada368aaed332ddf56882e,packed,7776,21,65,69,90,65
7524,964b65cd9df27d601af6ff40d0a4da8b0266f0217b7898732e9f66ed862c1ff7,packed,214001,812,1658,1659,2471,1658
7525,966aed5c56ec88b6b5480d240244c492145e4fddf341a6d2902d5d34806ae353,packed,182790,770,1480,1481,2251,1480
7526,966cd98a6ef9ce5a344c701d9e9fb4c58fb003e25aa15350aa76e2281fd45973,packed,183619,698,1458,1465,2163,1458
7527,967a467d897917b7d7a7545ca24b373d937d2a57d2e3b54b4c620e8f3cf6bb48,packed,7788,26,56,71,97,56
7528,96c35b19c1dde163635a4360c70e2fa45aeb42ac19b11bf39964dbad2d9b86d3,packed,44343,166,346,378,544,346
7529,97417fc69a2680fc4923c0d13cafb28da75f5424a79b0caf890d5e95dfc5e682,packed,7786,41,52,61,102,52
7530,97654a5150ccf3e438470708836b3d35dfd252791d815e83a758a8bab70c8349,packed,44184,164,380,316,480,380
7531,97a7b8081abdf9af0842fa2c2f40cf60dfa124452727f35cfb216360a409d1d8,packed,44065,179,350,372,551,350
7532,9810b8b446a22382d0d28549c0cef3034d0f7237796db5b68f3141e37322f086,packed,53800,226,439,446,672,439
7533,98483f5709a061e8055d618d1f8af2e2b85239ca87827e8e3b123ef8e03d4cf3,packed,44270,191,362,335,526,362
7534,98967a6f7ab0ee18b9d8f5f316f3f1521d931e5b2ecd51d2fae7a79fc30edd6b,packed,93319,367,709,708,1075,709
7535,98a557056954ef2fcb1270f4fe7eb7d511199a2a156e53bf53a1adf8531c6aa9,packed,44028,173,359,315,488,359
7536,98a8aeb65d5017be3ed373e843855bcdab54b392580045a2afd99351dfad214b,packed,44157,180,369,389,569,369
7537,98e8f8703f6f4d4379708be201884dd9478a5293aafec4e2794a1755af36e7cd,packed,44157,185,306,346,531,306
7538,98f66b6ab04d4988c421e4f7990200f2360a0ef50d0a6c53970b5122a4722210,packed,7786,20,62,67,87,62
7539,9907e581ea3fb96af373a972e7e2a5b3b937ceec182f9ca3ed7bbc35657c1125,packed,86356,325,674,678,1003,674
7540,99646911e87ac1e3a489af6abab541076dd589f9dbf241a6226fd8aeff0f5287,packed,108405,461,789,827,1288,789
7541,9999d659107dcd66b1ea11c09e9261942f1e1de2bff92b683c36acad0981b8ea,packed,7786,26,60,69,95,60
7542,99beede1e0066f21a3205e86abdc7ca1148a1dcab910052328eb62115cffbdc5,packed,368682,1522,2833,2956,4478,2833
7543,9a1df671dfb87ea05f9ead1c4c6f0b82d2948efbaec1c7bacafa92f491ec2dce,packed,7786,19,57,59,78,57
7544,9a2b9e4e6a74a33ba641c52ddd1388de4721b63d89f5a91fd08229efc57e59fc,packed,91408,377,707,691,1068,707
7545,9a8fb4ddfa1a835d9f95970462328b02e7c09573c21f08f9315ea7809765e598,packed,44149,198,353,375,573,353
7546,9ab6470a8123c8256473ad170a1f6d86b4ad59c72360ad1d39cf2926851d05f4,packed,7786,19,57,59,78,57
7547,9ac473c4152ed1a53e6184150c79ccfc4c0c577d6bbf06ab104fbe6d7bce777d,packed,626351,2365,4850,4825,7190,4850
7548,9b3c81d7d10304125027100e663e83d0cbd4f501fabd4281f155d9b0695d8c5f,packed,581041,2241,4556,4671,6912,4556
7549,9c9cd7c208ba16e53e84de91350acfabc7e71edb71c9583cffb491753c2d65af,packed,44175,174,351,361,535,351
7550,9cae7f34ac015f0a2a0a671fea0a43546a2f3125f74c9733465a27f0d3c7aedb,packed,7786,23,73,65,88,73
7551,9ccbce22ac3527c4bdc2b43e78e0cf39f93f1ff7de63aa5124beb5f61067e06d,packed,49426,230,384,422,652,384
7552,9d08eed7a18cf079cc30172fdefd477bc06301e65a500b5faacbe0d209217829,packed,81845,315,646,729,1044,646
7553,9d24ba49ec8f669df7bd277e445aa313e2f896dfb5fc62fff206ce90d189db2b,packed,7786,33,58,62,95,58
7554,9d508820be5b7d400a6c54d3bc0dbde54817a8f917eaa21df000b3b16a49aa4a,packed,44135,177,336,349,526,336
7555,9d9c8cc52c53d71d8e84a92317fd06848c57140d2e6b959409ec5ec70355559f,packed,49507,184,363,421,605,363
7556,9dd5b5e309ac588dfa3a30220fe996d0487c35d70c97b10f9268cfeafe69f14a,packed,44008,196,342,384,580,342
7557,9e8dae8e42e00196c4df6e023b1fefa4c4e899876efcb5dadee7636cd3ec0525,packed,626230,2392,4947,4913,7305,4947
7558,9ead95244cafb016b998daf13729db308da9fc38b312b40a0f6f80001781b3bb,packed,7786,29,69,74,103,69
7559,9ec15fa5763eb0c2c881afe7c1698c4e071be1a6ff85f5b347132b9a9f431733,packed,7787,27,52,66,93,52
7560,9ed00980a29a683bbe68159ce54714bbdc6aef92f4878fdbfd45ca0f63e396cc,packed,477572,1848,3604,3731,5579,3604
7561,9f2ffae821f637bee6b7401183e64fb93355be6e4548b00f85f554fdec7df685,packed,1013854,3974,7929,8556,12530,7929
7562,9fa8b568b6ce9b4c6a9a7d0f1f40a307b687fd656844a664455403513771b926,packed,44452,198,323,366,564,323
7563,9fe1a3f550f1e348c994bf19bc219ec286aceeb17cb9f2f11999e491adf79ee7,packed,147213,621,1173,1242,1863,1173
7564,a08f0049bd5fcbe4e6746addefd98dfa867f10656f0fcd24d0bae033596a56b2,packed,43994,198,344,343,541,344
7565,a09a6bb41b5fc838ec66de6d8ef4e9d76d2de6163de2385c667e71ea56b0e6b7,packed,44054,217,324,341,558,324
7566,a09fc86bab18c1d124c51402cbc931c5875bfae4fdb00595226c10ff95ba0cb7,packed,152551,607,1177,1215,1822,1177
7567,a0ff526d343bc284ddbb90f360475e80aacf1349f059f44f064ff67497906f1a,packed,7785,39,62,65,104,62
7568,a11f1ca0320f2b56ba2b7146799fe139300a6c130a814015d33a75f9e30cf9b3,packed,124575,553,1057,948,1501,1057
7569,a17c08d8ed5b11f8268d286816f57534c2f5a7afd366ec863eef83ca873be8fd,packed,265439,1073,2081,2073,3146,2081
7570,a22e46d5dbbc1f79f49940a9a91902bd5906c3f98b3a451658600b29337bb63b,packed,44256,164,378,399,563,378
7571,a2349f225d9f17735aafded14822a61fe88219350086a67e5e3bfa9da9ffbee4,packed,44361,185,351,384,569,351
7572,a2f178303e1c305518991808064db0dd45498a418a5fe26c43b8dae39e7c8eab,packed,7785,25,66,73,98,66
7573,a3184a744a159911e00e2627c49dbf81c31f5ade837b111b08ece4c7bc5f862c,packed,7787,32,65,70,102,65
7574,a34dc6fb8b9d889e9f70e5d1959d4bd04c09461ccf83599db4e2f5ad7e985a45,packed,7786,33,64,70,103,64
7575,a3b6586fd7fa3385076f7a720a0baf154f0c60706dfc45a8a75cea2167f04785,packed,44208,171,358,339,510,358
7576,a41caea9118c363c383cb39d5575ed1f8d8e9815fc0994c68bddeeeb91e46830,packed,7786,20,54,70,90,54
7577,a43fafa30fab1550aecf0d28475425085325fd0ec8efde16f1f1b0d8167c6b38,packed,44202,190,380,367,557,380
7578,a46ba55e02c0ffc9d388ca7ef239af08a796b67ff7ded5b33a702972e3342009,packed,7785,28,69,66,94,69
7579,a4a892a0fc864bfdf8203be8b2de5787ebecf82a1ca589786185d6a6643addbf,packed,7786,24,64,73,97,64
7580,a4bf66550bab59cd40342a8d5c1add51b777d415a173837ee148cc2a9388b516,packed,44012,200,365,339,539,365
7581,a54fe174d169b9c3a531d3d23ececf903ab4a68a0e67abec8c3a686a4b5118c3,packed,7786,36,51,72,108,51
7582,a57e1c1abe476fa9bd7fa444c0493cba28fd4da7dc6685dc8de77616df7d2238,packed,7786,20,62,67,87,62
7583,a59baef0f5ba2d50f86f585ce8ba7dfc3a78f0f6e8219a8179211330a4d720e4,packed,308407,1180,2348,2401,3581,2348
7584,a5ac1ff6b327b658f5df51acc7b2823e1dee29c95cfeb85ecec55d26438a27dc,packed,44186,187,340,373,560,340
7585,a5c49e957aa8e46d84d3fbbc26e3733ab8b1bf292deb0b07a7e3cff3adea658c,packed,44440,154,346,342,496,346
7586,a5d932b4b34e384fbf14840ab3528055a924ae253af4a7a657a6bbb6ce27a44d,packed,999925,4044,7889,8124,12168,7889
7587,a5e39145b85d641c2288c970a4cc86a99360dac950d21c75b9fdf522de560e18,packed,105250,447,839,829,1276,839
7588,a669e90e33d6df1de201c684f3bb31f40ae9d4c07fb30337eb457d8199f2c301,packed,1011683,3932,7906,8156,12088,7906
7589,a6d18dfb5e9cd78e578215cac1e39a28761029fb363facf7889ea7cb8f0f8f4f,packed,7787,23,55,67,90,55
7590,a76acbaf635fff682c2941f96789bb4655e88e9637f29b835ddb0af49269c42f,packed,7787,35,57,63,98,57
7591,a7ba23b7dab38812c9797d9fb8cf43c7907236cd3a047c08fc78609a05f5c1f8,packed,44050,170,355,344,514,355
7592,a7f63afc4ee3db8e4aa78fca2f9c2addeb97c1ce59add1139d1bb3849f5d9d51,packed,182898,707,1456,1429,2136,1456
7593,a8152a3e108d4cb092f4db0d77a0a947afb45670be87dd150c814799a7e2f623,packed,44131,172,380,359,531,380
7594,a85cc863b40cc704aa98ea5646ced08316062aa98dd73e7088403d5ca1d1f562,packed,43992,181,340,303,484,340
7595,a8624694f544686cba181933eb03988e47c6d9b35518271c11841c4d8578f055,packed,44256,161,329,368,529,329
7596,a881d413809505532b9ec2b0ac7df65381d387c4351797c8fa8d66ab40f06d81,packed,44073,199,300,329,528,300
7597,a8af8da5324ede5db3ca0b12b8e013a68f441619d0afdb4686f8cb1937af6f3f,packed,44296,176,381,383,559,381
7598,a96ae424879238a0c503423a2cc18152f2d862c9e4af5d901b18011e69646449,packed,7786,24,64,73,97,64
7599,a97648da76dbe7a4bca512a80f914abdcaf88ce38f95f72638dcc6dfa74eea9c,packed,7786,33,58,62,95,58
7600,a99a503f80b12eb280c2631e37e2bd697ccde3eba176316dfed2a90665ab6066,packed,342038,1401,2775,2737,4138,2775
7601,aa130ba78fe7f700523f52bb0c243c3a7ea5d41624b453b69116559e6b12857a,packed,19118560,74504,149864,148801,223305,149864
7602,aa37b0c8229c1ea0e6c3146784e7c39ea05c9481fd1396fbcdaa1a6795fbabff,packed,44109,184,350,318,502,350
7603,aa6aeaf66ffdd98d7d9b13c56acfe2bc8c0abe43cd58324a9af3d2ca70035dc7,packed,7787,29,65,64,93,65
7604,aa7fb0c55d2744ec2cdd6de646817167fe5349285245ae43b4e8f8094fdf3dfc,packed,627708,2409,4911,4942,7351,4911
7605,aa873f8bbb2f02803db12d378e5d3562ff162599a18be889c0ccaaa87be78c85,packed,7787,26,72,72,98,72
7606,aa8e17324a07dcc491d44b93b4f2dd615191acbdaa492a72384ba09de7a6e97c,packed,44289,174,375,350,524,375
7607,aab7ee43942f4f37ce2317ee1472459e819f55f1c37b8eef59f78456ab0608a9,packed,7787,26,72,71,97,72
7608,aaf7d4fff145622b6199ce71a3da3fb2e474011c042c7cc4c70933fe8ce17656,packed,44163,204,338,370,574,338
7609,ab119dfe79513bf80d541046c036f861c26d3b6d1e3b74e08bd441c44daecb02,packed,1001194,4004,7705,8008,12012,7705
7610,ab12d19c6f7c95a3501d4c8918f82e935b8c8a82fa24aa10ffcce07542d6e433,packed,7786,25,58,68,93,58
7611,abe3b7644bd8197ec51af84647d5d91441b9bbc13490208a4935a7a8776b9fb3,packed,7786,29,61,65,94,61
7612,abf6176bde70fafd4782d426ecfb3ac4e409d91e807b5b69af6f6b0481605682,packed,1025584,4038,8098,8254,12292,8098
7613,ac719c007b4faab18acd00c0e05a219bf7e14f550941d3d6d7156cf6d6f39028,packed,7786,31,49,73,104,49
7614,ac77e9fe03163cf0d4fbb959ab399c58d6d169cf2bf8e879396c6d28f0bbd950,packed,244170,995,1921,1959,2954,1921
7615,ac78c88f2b617b972ff707640058058b39580952f028ecbd26a3a30111f6c9a6,packed,1013855,3969,7922,8564,12533,7922
7616,acc28c12ff55938a21b35799e4bb28cf997a6655182dfbf990b42dc3666e0971,packed,185994,785,1440,1527,2312,1440
7617,ad99a3dd80969cb89885fb1fe015b0e719cd773f65b1f712282f000b09642d81,packed,44124,197,353,347,544,353
7618,adae26fd9577b131fd8d0c08649deb4ab0622192b5c232b012a564b27b6b64fb,packed,44379,171,338,326,497,338
7619,ade87e5204ca789864c2fc72599d8a519e220b2060f91d82ce4ecf5c84dc1985,packed,44101,185,327,335,520,327
7620,ae2e046afaf0dd69ef9dbe679008c34300b40dc27097201459c8daee2b1db923,packed,44152,175,339,343,518,339
7621,ae7a0b1df94d3e3196513ee128efd7fe81965a6b24f8f41d54ed6b43008eacbf,packed,44131,185,359,380,565,359
7622,ae99892d075054bedd5096d3cbcf25356232d05bcdd93cb9f742291a86368f70,packed,44252,181,349,347,528,349
7623,aed520b1e3903cf67c3581fc81f0c284e2746ca4ad3bafb34bf4a4747a6ea416,packed,7787,26,72,71,97,72
7624,aed58adc244cf3038864bea715f1ecaa75c9780de8edd8af93989e2a0d4521ca,packed,7786,28,59,66,94,59
7625,af2e0e5257bae1e3e8f3be39b60a640fb25a9def6ddd65b4eb9e6af537055b8f,packed,44324,189,288,356,545,288
7626,af7a84f532cfd5854e4929dfcf685852f37fb286fbbcfb5daa004845d250fd18,packed,44233,172,372,373,545,372
7627,afc12af5a87f1d44978cc6bb0fa1238fbb87ede95d1a7f0c93cddd8474aefeb9,packed,443798,1679,3456,3520,5199,3456
7628,b01dacbab8006a7a66f89c0beb7523fe7ae905037518f25887c565ad104de609,packed,44134,152,344,377,529,344
7629,b02ff376cc1925d5290c00c062bd1f4d458f98178e13a7a09a30ca2d38d1c8d5,packed,185796,787,1455,1501,2288,1455
7630,b03955cf200fd936f6388927162b0f77dd0764a655c91e9d60580c8d353a2340,packed,44481,208,359,346,554,359
7631,b04651c351550aa4a49bccea2b8e2faeba5e10cfca5d14c58bf69c805ae51dd9,packed,7787,30,73,61,91,73
7632,b052f7524817119da991c8fc2d65a4037c341c3ecde6075df2a2a5796b10cce0,packed,44493,200,342,372,572,342
7633,b07674d3fb0a424de6deac5d048325864fb45af45b89e0595d56482502f071bb,packed,44104,164,380,366,530,380
7634,b127d6df4a27e1c560a3e1107a6868054a7c65fd0a0367f167cbf844ba5ebeb2,packed,7787,26,72,71,97,72
7635,b19927fc34f8a611d50bbee71a80c79f736d03be32b43cdca4ea23e63a81b2f6,packed,45142,182,369,351,533,369
7636,b1ba43e0858082719d39f52af64b4d80a48a7e4351aebdce185527951f29592c,packed,7786,20,62,67,87,62
7637,b1fee03c1fe06ee9e56d0d8281b956a3805833e7eea0f4e4b3b73c42c7f177ce,packed,44190,188,355,387,575,355
7638,b2293c313f8402fa610523fe20923eda960516a881f81c680075b8e5eab4b321,packed,186034,768,1474,1517,2285,1474
7639,b25bb7e5fc067fd865a7ada704227ba5edfda0869f764d365cdcc3af77c9348d,packed,7786,24,64,73,97,64
7640,b282bb6bb8bc8c61a3fd2e7213c151667cb79dc4f32bb20c9c42b3a9f5ea580b,packed,146056,555,1193,1145,1700,1193
7641,b292b64c22788040cf2ebbf6d0500359274c6f70594f1e0f2ae4ca9be5c26ad0,packed,185983,783,1464,1486,2269,1464
7642,b2c3449cf7449d539f8802dc5d1a5db37c6d92a9d40e735bfd85f2fd9fe1a5d7,packed,1007031,3869,7918,8275,12144,7918
7643,b30d30acc512d5783b33e2718e04365db56831f59ff2c3b04e0fe87812fab396,packed,44120,156,351,370,526,351
7644,b3987328175193648d4e1fb7f0cfd9447c4ad17163705d481bcacf9eb4af451b,packed,44103,172,336,349,521,336
7645,b42473449902d42bf0e022a7019a39288c47046cc123b930a5bc77ab8e0e1ad4,packed,7787,30,53,75,105,53
7646,b42f3934c38caa345b49e7091c4538c53691b09cb6f6a88442f293428f1cfaf4,packed,7786,35,57,69,104,57
7647,b43a2eee5f0fcf645a7014eec29b84c98b09690b7bc7d97943e3c866fe1eacf3,packed,44038,180,316,359,539,316
7648,b4454897c87dbda6522be3e1bd858b382d7d4a7e134e83a76e0f2fa961404deb,packed,44143,168,319,330,498,319
7649,b54cee6d214397d1d646a4e40b19d349737fd3c65719036d1fa4ccdf84a75693,packed,185911,767,1468,1502,2269,1468
7650,b5775979e47a5446a409eeb50a3f78d0a7687d0734ada9c782d8a6900356d062,packed,7787,26,73,71,97,73
7651,b5d9d5d6b82f91eb631f6d56550996a44dc03e6b0b5424d93b81d445b10e79e8,packed,7786,34,58,62,96,58
7652,b6981e9cccb43d122f9ad6d5439b215d84525a581a216cb17916f1559dbf6219,packed,7788,27,69,82,109,69
7653,b6f615264d87cc074c37c57e212bcafde2aa20e39b2198b4d6fb450763ea02ab,packed,44203,211,335,378,589,335
7654,b73fa75e8586cb45b9b6958d90c9499772dca4c85b44f11c867dc5de3c546f7c,packed,289331,1083,2361,2314,3397,2361
7655,b73ff0eadcfbf1232a449998fcf39fc074705cf900f7a5526eeec80400e4d64b,packed,625906,2338,4854,4950,7288,4854
7656,b76cab9c513702bade5c7f66501580a4da47a40c31575089f9b9fbcd56e30826,packed,101573,409,800,878,1287,800
7657,b78bc0b586e614d2031892265e9d922124ef3b72414017208feeb19f3160e7c7,packed,50525,204,415,394,598,415
7658,b7c2b8d7ac975810fe7271f0edc6b7095f68a461a3ad97fc5e008032f9dcf560,packed,44266,166,358,351,517,358
7659,b81d6ab45d17add915fc758adc6f4429cc1469b70722c0948f5856777c469326,packed,102137,439,790,817,1256,790
7660,b92d0e07d8d9a734f4cd5f06b1c0e96e698208a1a9615a41da2283729e428bfe,packed,44431,192,351,347,539,351
7661,b963f59f2a057f1b3c2a84411ba705421817af26b5d36302941b2de93d8c86a4,packed,72266,272,575,616,888,575
7662,b9b63e3d28426147e5aaecb7955b8329913bcdb7678203dee2bba1bfd4614938,packed,7786,24,64,75,99,64
7663,ba3df0e0f39dc0c4e4a6552b3b0163d76ae318dec3aacd620ab7b530a4b35fbd,packed,44090,155,339,345,500,339
7664,bb016ed5721ae7d8e262e649d50e1867982e1315e3399c0ae279eaca6f4d12c3,packed,44237,192,345,377,569,345
7665,bb183bf00f04cfd0f39dc169d4c79b393fec15466c52e2c26303ac7f13fccb7d,packed,94133,368,812,743,1111,812
7666,bb418692ca2207cedf9ea598153c9ae7879a2b0840f7002ec93345dd2cfec66f,packed,44172,173,348,360,533,348
7667,bb72c1db3ef191268ac999d191df311db55ed882b09a8f0ab52b09e1bfb105db,packed,44380,177,340,356,533,340
7668,bb95234d0e0aeda092da1c65a702e6ba508b22b298f2b8adb4ae03fc388d0567,packed,44392,195,340,389,584,340
7669,bb952f322258fab2aca6e2436db5a7c82ab2d906a6651367717ddaa54bb62989,packed,44048,179,370,338,517,370
7670,bb98d63c4c1debd45dd0ab3674ad503dd274dd0f28948c5c489c97a420876449,packed,44228,153,367,363,516,367
7671,bbde438a5906b1e1647414b6aaa8d500d15651c07d1bea38cfd3ba802255055a,packed,44117,198,360,323,521,360
7672,bbeb3dd8d2438f80e7f2584ee29b8178661f33114df68e24954140c35ff41dcf,packed,1978725,7723,15294,15616,23339,15294
7673,bbf909a7513f52a9a6213e3740065c864e836bbf924062e957004dc45c06c7cb,packed,7786,32,64,70,102,64
7674,bc5670a4cfbf834156987bf796413f629535ec02cce9ce00f7eb44ff37e76d71,packed,44315,194,324,375,569,324
7675,bc6b2c40f4e7d8898f95f60668ca409da531aaae53ad4923d6eb4616e11af120,packed,627526,2429,4942,4883,7312,4942
7676,bc7acd2734f1dbf12cc8413a3a9c9a51a7bdfbc333acf4458298793c0e265c92,packed,7786,18,65,66,84,65
7677,bc94b2df30debabc02244bd49a273643aa7ef074b508b82ec74c9b3b560723f4,packed,44435,191,349,360,551,349
7678,bc9fa0ffdc8ff3c6212b108e526036a6419bc539f8671f33f1d3e6811c3e6bd9,packed,146086,563,1175,1149,1712,1175
7679,bca288fb576ba16b516c855db87c40c1e899842fd4aa4f1e682aa3a7360a472f,packed,44185,186,351,319,505,351
7680,bcf3b0b5d57515934017289c6bf5b6d8ff637bb53acba57a8ca898fcc6435eb5,packed,144393,586,1123,1099,1685,1123
7681,bd579450ceaffedb28ba692d3466625ec445d4946bc456f8580f75e50059b3a0,packed,7787,32,63,72,104,63
7682,bd579e89283138c8631ebe75ae24eee128bac458e725951bfd469980331824b4,packed,7786,24,64,73,97,64
7683,bd95fcfc23ff6a4c51c8dbeac92a7cf2faa0b448fa5e8978c26f653348cbfe1c,packed,547149,2102,4169,4398,6500,4169
7684,bde69d01f0bae78c36a1408c4f9ddf851c40b4f862ae831dc51a87b677eb5669,packed,104411,431,796,870,1301,796
7685,be0b074f486aecb62a1ec4b2ccd099b4682afbd44bda6f220e9d7d856edb10e7,packed,7788,27,69,81,108,69
7686,be1af210e2fa833a82dbaf31d367da10d53c7bafcfd3fbdbb5b993afeac3d421,packed,44131,175,330,366,541,330
7687,be23780104532dd418fdd8b43c28f63a02608aadee1101e4d77530a5cd3dde60,packed,7786,28,75,60,88,75
7688,be51c56bcc6492623cc43c544545512efcaa68ab2cdf1d9c576086a57525e499,packed,7786,26,64,63,89,64
7689,be64d4d9200a392f5b87a2030be08110239eb7e4655464bd7f13d9f035c48de2,packed,44522,165,317,345,510,317
7690,be92b039ba4f9bec0f087647d8e06094401086763caead12cda54361c958ba87,packed,7786,20,62,67,87,62
7691,be98ef8aabbda5bfd0a9a6264ac96969b4611966aa48e5b0a4ed4c37a1a631d9,packed,44185,201,337,350,551,337
7692,bef77207d114b99d272d63116459722f6d5eaee4f9c3c654bfc2092d2b0e8e01,packed,44033,154,317,354,508,317
7693,bf38cf243c01884588083f90c370b5e2fcf56b7cbe2f04ad4077292e33926163,packed,44118,159,366,337,496,366
7694,bf733b760dc91b3b994841814420d20c73fe08e2cdfaabde912e7535953ccb27,packed,186000,774,1446,1499,2273,1446
7695,bfc5ef006ca8e482c59c377efff57137d878627901a6712215f359c12cc269a9,packed,146091,562,1181,1151,1713,1181
7696,bfcaa760d061224920e25223ec5566dc430dd0e1f1203062c9e5ae70df93e65a,packed,289815,1193,2254,2283,3476,2254
7697,c0122f2460edd37d29bfe76ba2a3fd27d3fd19b52215ef9ea16e1154e8a392a1,packed,7776,24,63,66,90,63
7698,c0229472c5b2c30a08bb43b981122dca2894b52cb698e226c70eea3b53e64c85,packed,7785,27,59,66,93,59
7699,c049a5f5f3161d6f648b57371cf8c3a3370b1f00ef0ecf8f04eb0f7870cd7ddc,packed,44033,179,380,392,571,380
7700,c0ead8ccf2d810e10eb4775acf27ac7322d20c1b74d844fd423e103445fead8a,packed,7787,19,64,65,84,64
7701,c108b1a0f9ffad33ef0a719ab363a898f21911126443afc89f193db6332d919d,packed,125257,454,1016,1122,1576,1016
7702,c1148e5b4fa09496315f9ff651ee32c3f7ef5a694319402e8d13fc84969183c0,packed,216899,856,1717,1717,2573,1717
7703,c1b563b4cb7a9074011fe4e2371762850c3d25d5def6e01ed6748ff502d7c876,packed,44175,177,317,353,530,317
7704,c1c6ad632f1bdc1c0114d37d248263017a77602a4bbfcc140789fe61c2e3e53d,packed,44101,190,365,365,555,365
7705,c1e2584c1a5510df388be432eef896eb161efd731bef0cdb4b6f54e744d816c8,packed,44143,181,332,342,523,332
7706,c1ffb384eecca85ff3555793f1292c84f0a28419551a2f900a4f44f6638cc17c,packed,44219,173,362,412,585,362
7707,c205de87a7c3b7580579966bd0fc1e9d9b8eb6e11d680d8f701f15e91dad3157,packed,7787,26,72,71,97,72
7708,c2463f08d50cfcbf1f21fc64a46d6ab4485bd3a5f4df642bb9b6c5aa3c268efd,packed,146039,560,1187,1156,1716,1187
7709,c29af2b7b7c4b6856db0d30ce645bc51f19e3ab4dea78929f0d92037e1aca599,packed,44386,188,344,354,542,344
7710,c2bbe2d4c6dde6cd47d07a6d6dd56298f9b1befbac508b5a797111158cd3ab62,packed,44379,179,347,389,568,347
7711,c2cfcd4a840685a8514f3e175d432ca062108ff64d6fb7e050012ea4e62f7cdc,packed,7787,23,56,67,90,56
7712,c2d3e50956cc19c292a77f2a52aa14ba0395be7770dc51a941d25d6df93abe18,packed,7786,32,64,70,102,64
7713,c2dd134496562a83583c55628ccd9d0238a67e4565ac25dea28acdb343b3b2f2,packed,7786,31,49,73,104,49
7714,c37d63178e6327c34081f3013be5751f65df693b5fcef7db27ce8e0d82f2408c,packed,7788,26,57,71,97,57
7715,c37dde948c5a0b514eb296ba558683ba24b26670a2dfec505fc66c42494f96f5,packed,44339,168,340,344,512,340
7716,c38755f576217df7bcc2f43cc5a1ee900cbac023553373b75f5572de5a2123e2,packed,7786,33,59,62,95,59
7717,c40747987d4a7da205e721f5c5b89aec5fb1d8c1014074cab23e3262b6363353,packed,623769,2400,4887,4824,7224,4887
7718,c408294093c7a020e492d1cde99bc797d0b11c1e36891e9aaf70322a40dffdda,packed,117635,503,954,923,1426,954
7719,c48ee7b027575839b8d70c57ce93a1b1b1c3e6ac72f2a292a9dae810f6cc31ba,packed,7787,30,69,69,99,69
7720,c495c115449b4e1f9cacdeac7228198fbb156cef82b9aa3fad6e09bae851c36d,packed,7788,26,56,70,96,56
7721,c540ef6fa38ca90a9cb50847fb29e40e5716a4720bad2b29be8e9720ec2daccc,packed,7785,32,58,63,95,58
7722,c55cde19711f6c6c63f74cd2608b2e25e9abb6dd8142df8888b05e729c5ed962,packed,146045,564,1188,1148,1712,1188
7723,c5e0ffc5598a49c707845a1109dd5db84048b4c0de01bcc63389ac14c5d97f8c,packed,44319,176,323,343,519,323
7724,c604953f8eaf41511c4e4ebdf249cf6a5b5d691a3a49e53f4d84817b1aa61be7,packed,7788,34,66,57,91,66
7725,c61eb185f4978ca05cc41ee88ec8ffcfb01bd5c1fa5f671e3e823d451a028b5d,packed,44162,173,344,364,537,344
7726,c687bc031e73d79aa40980641ae2bdd9bb1b37b62ceccc0dcb5913df16792ed4,packed,7787,19,59,70,89,59
7727,c6a0d4054f49d055e014c95133b141498688685bf3e384ea1feefe1af288db12,packed,7787,22,53,63,85,53
7728,c6c15cb34c9b3c973b698a95968456a8bd27cc5c5f438475e754b6b79734a5c0,packed,623513,2338,4978,4948,7286,4978
7729,c708f210adef970a4359c868f86d8a7a5c3ea668faebdab7f080bd7e008fef7e,packed,7786,24,64,73,97,64
7730,c7836f8f2060900076cce2b99a76f8e4baf599227e9bfce7c11056012c1e7a67,packed,7787,25,62,69,94,62
7731,c78a9848beb094ac3d7f003d4a16de25b84ceefd1b5463c839437cabbb2f7095,packed,44142,181,297,329,510,297
7732,c7ae7be150c8b4583deff1c7271cde4aa9910ae82341d42a204cadcf2bcba6a0,packed,7786,20,62,67,87,62
7733,c84d930e8f24b48770b20e2a6ae812c31e7960f68d33bcf2e41f410c233f0c27,packed,1013856,3972,7900,8555,12527,7900
7734,c904b1205b98564030e9f5c21c29de54e397e15029685464ac8279b6fbde80e0,packed,7786,26,60,70,96,60
7735,c92fa6938edd00839f70f4232a46066d7bb5202b1aed7278c063210179ca20b9,packed,93556,389,674,708,1097,674
7736,c96e29c495af9524645a91e649fe3c72d56293460b39f71d6b1ce946766c9fb3,packed,44215,177,335,341,518,335
7737,c999c0b91d60b700fa415a1f546bbe4e7649eb0c03faf3f058e2731bababafda,packed,7786,20,62,67,87,62
7738,c9a0208d025542af29fa4a03980dc099d203ceed26a796e95e63d97eae9493d0,packed,101269,406,795,789,1195,795
7739,c9b33ad5ccb3f7eb78f4f4551f81d17daeab34b032bb052afc0efe793eb986c7,packed,7787,28,53,79,107,53
7740,ca437b70836ce19ed280f10b85175dbbd931688d164b536d5792aac4cdbd0fa8,packed,146614,554,1194,1152,1706,1194
7741,cac4bd814f34346c39ff0bdea90c1ae3b5ac851e5eead877a7a572ab7ba8dc98,packed,7787,26,72,71,97,72
7742,cb18cc5c36ac35550adaa79841a70c28568ca729f289c27a36432962450095cf,packed,44088,193,341,347,540,341
7743,cb4950caddc433a17ad293b08d8a6e1907e6980e4e288bba4096554775b0f251,packed,7787,20,59,58,78,59
7744,cc934fc3606f19002fef0d84f4860796b105b1c4a7931446187c7e476efef9a0,packed,7786,14,71,71,85,71
7745,ccb12ffe653964cef3f8c51f40c36528b874c9f9d149eb8612031802f60a8641,packed,7787,33,67,71,104,67
7746,cd061e32d9b34db5b82132e11d290492f83d45af533e5f246373a112f2d12df7,packed,44125,179,343,348,527,343
7747,cd1b6d062e1487c97e6372f602ee8f3dc4fe9d8313da9bc127ae6ab4017072af,packed,7786,29,68,74,103,68
7748,cd21397fedc85a78bcaa1c5773117f6ad6516e2a1e0135bf6c3222cbacf704a1,packed,43980,164,337,330,494,337
7749,cd22ce9f8eefe385c300003010c7ff0f8bd80c334378783fa6e85fe02605e281,packed,44286,183,341,359,542,341
7750,cd59f9f91e355b860fdd35f0a04e49219b077117cf2c317382baff7733ac57d5,packed,44064,162,330,346,508,330
7751,cdd72402e9775610ee227396fefcc5df1624bd756c274805c481f67ab9e1798a,packed,1013849,3966,7900,8584,12550,7900
7752,ce67f741de0c6e4280160a298c839d1748133a4c5c74a9dfabbdd61c0f720826,packed,7786,24,64,73,97,64
7753,ce7ecb34381ffa7f0f53803bc84f05a2aff2a604d5fada45d72332d4e69542cd,packed,44059,177,331,374,551,331
7754,cea320878ea5a959f95887dcec6495a7c9ca529c34566a15e3ed38415315d200,packed,72769,321,576,552,873,576
7755,cea43395c3ee6d3d207139b7d6719fd9a57dbf18d3fe8c1d5b099e16b99ef9bf,packed,44186,182,347,338,520,347
7756,cefba47fd15a6d31fd0e2ae46dc785f38fad5cbf555a66588f17a4c2787559b1,packed,44115,171,324,353,524,324
7757,cf0d6f202428c62cfc42de4277e891fef8e1cdee1403d776226c33d79028a5b9,packed,44221,183,326,346,529,326
7758,cf58ed7f80f7b8f94e90ed763e808be3e044e308aeacaed8f3e5c93cd292361e,packed,44134,169,388,345,514,388
7759,cf7290ae25e92b670eb5954f51a5c1f44996274f82a61f54af1f628838a4cebe,packed,44364,186,371,374,560,371
7760,cfa2bf08d2d3e05bba40dd5c7ab808cb259b6440d0ef89ecc67c83b7f3b3d94a,packed,86439,364,703,647,1011,703
7761,cfa84f6f7a15462660d41f69a9985d29cb709012107bdcb04f0e36c30fce5916,packed,353937,1644,2848,3123,4767,2848
7762,d016977a3fbed267e1a1577a775df346ed7deff5838f47dd589f79ab47ccca17,packed,44249,183,390,302,485,390
7763,d0399b706515f0eb69ab6af1c2c6861da13dfe606af925378982171a24fce38b,packed,39098,168,325,279,447,325
7764,d0c2859c793dfd0afbbc6a8dd7d7cbe8f80067a907f41142f535e25195d85bc1,packed,44280,201,334,353,554,334
7765,d0d92d5255fd7f2390629fff65a2840cbb8ab84604a81ec46d802fe3eaefe144,packed,44131,170,313,359,529,313
7766,d14180ddc86594ab4d86135c39a42d213ae7a99d178a6a3b3ca264598df9ea76,packed,7786,25,62,75,100,62
7767,d174d3bfe785c636c8fc75237f75851b1d92c6af266928fcb981cac6148deb44,packed,152676,610,1150,1216,1826,1150
7768,d185c06d27144840ad62fc665e08d837263399b60a7029b4c99df9f4bac658a5,packed,7777,30,68,64,94,68
7769,d18d4416ba78fd08f4ef6759ea7c10e8ef8024f4c7efc28aecfd93b1a796ec3f,packed,44354,202,315,337,539,315
7770,d1ace9de7d9c2e98ddbb53c993a3166fb9c501f302d3f96ab6f8ce8b89a1f96e,packed,7786,22,64,69,91,64
7771,d1fcbaa7750e80265a8403e5a908cea17f963ab22f708986e937fdc6c7ddd1f6,packed,7787,21,57,72,93,57
7772,d2549bca5fd9491d798b7b0323470b1abfc0d5112d2be0a974d34d9acaafb7e7,packed,44749,173,364,347,520,364
7773,d2bd6e5bb8c28e4d3cbe42016f9ea8cd0cfe7306d3d0e60596717cfe22666351,packed,44125,185,350,362,547,350
7774,d2efb0e6aab68294364a65df82fe89159618b19a213c0e2c994c69f41396e784,packed,246954,1040,1925,1995,3035,1925
7775,d313abf981643aedf9a0c054bbe8258a817afd0c7a383272fecd54f1a2ba4943,packed,7786,28,54,59,87,54
7776,d31d6b57680ef9b931519d3bd46cddda8daca5d831e8f2004ee92acc2f2641da,packed,44369,207,316,345,552,316
7777,d3716bd56a9408cecdcae255bed6705987a40062816364915203a4f43f820926,packed,44185,206,346,396,602,346
7778,d3c65d213df845435ef0030d2f1ae2dc28753d8244e426d682b1506a1e79068b,packed,48853,163,369,390,553,369
7779,d3c8e2fcfaf73ef6036ae65c954369cf1c1002a8a8eb8644051f4f3020a89a03,packed,7787,22,52,64,86,52
7780,d4feec5189d0c8d70a7ead3959966b386b739071cb14ad413848cac0f9314213,packed,44320,172,325,352,524,325
7781,d52483877bce39b3fb01565f6330461702fa5ea25d5ce687e84c007f91843f54,packed,1001196,3999,7712,8011,12010,7712
7782,d5550ea4cbb27e23f35d1dda397a18497dd31fc1c4b371b217f94512102ed222,packed,146041,559,1183,1147,1706,1183
7783,d5e943e8f45a1a9e4b20bf834b612852ba8d003a59edc7d0a77151fdeb3486b9,packed,7787,23,56,67,90,56
7784,d604c3d2372f40d62b7767962d6c38fd66b59ff7ded5970d043df544b0bbcde3,packed,624130,2417,4896,4944,7361,4896
7785,d60571edeaa9cfa6dc3f8c7a5afbda04e5336ee5645fa0dbb5af00471ab56d37,packed,44016,176,348,336,512,348
7786,d6119f1f67a9aa97fc991b8eb3e486c5120acae14da9dfe788b7387ee62f70cf,packed,7787,26,72,71,97,72
7787,d663855de7a89ea93448d2e069ee3d4c1265b0708ceefaaa2abfb7466e61a4a5,packed,176571,689,1445,1511,2200,1445
7788,d66a6d4e96d2d9b092868eb51bed8d64e99e736c4615f7986c298e2b70ecc2b2,packed,7787,26,72,71,97,72
7789,d69085024b139207b4e9b9acb0b168fcf63529671ad50c6e3bf3b6ff34b9a781,packed,44106,194,352,346,540,352
7790,d6c10d303f3e713b40f2a5a3f22755eb4ad96dba68b3fe8b8743bfbcfd448314,packed,186075,776,1460,1512,2288,1460
7791,d6e197ef98307e64527e4639b01ca696c7a9613ee7c6c94537ee393288452969,packed,132208,548,1010,1066,1614,1010
7792,d76a104dc0bca8e406942c2b784e43127e906ce4b1090d969b344dec4709498d,packed,45864,178,352,355,533,352
7793,d77a261ef0a188d608c1f1dc2a583bff3aab459c141b1e3d2e7159448c4fa671,packed,44150,195,340,354,549,340
7794,d7b029dcc7081e7bdea0acbc2b93e3b23afd2c5104104ab88e89f51eb579031b,packed,145903,602,1121,1218,1820,1121
7795,d7ee829aad2c8bacefbaf65febea5253df255e453bcc9531acab6b0c85199f20,packed,7787,32,64,71,103,64
7796,d81539b5f09bcd88ae8b1eca403cd7c966731b80405dd0beb8a4d9ae6355d379,packed,627444,2334,4980,4837,7171,4980
7797,d8287ea0a621162f05b6942b51896590cc3c4adeba9daf514acde48625c0f9c8,packed,44180,166,371,361,527,371
7798,d889d9dbc671fcdaffdfb9e2b5fcdb0a5bb15f3218f3f3f7600dd34c6b2dec70,packed,334800,1292,2531,2546,3838,2531
7799,d947d2357a6200d4b47c5823ee1df1e758a8df90607c67798742bb2ae1b12f57,packed,7786,31,49,73,104,49
7800,d94db7960beca59e33b0d58e781c9505dea0ad001f04f65ea21b122699b0126e,packed,572848,2283,4437,4532,6815,4437
7801,d96be4a13c76775cb0a930c323cc84461c8cec16917eb524469e697ff02b4f50,packed,1011685,3890,7878,8163,12053,7878
7802,d9ab3575d3042157240ca5650bd6bc8d8b0581e3f50061ebc7cb6d99a6817336,packed,44248,177,377,364,541,377
7803,d9b7d2640eb6fae3f27ea809ee1b0ffe9737a25348b04e142eb7fdf947b8ceee,packed,102487,422,786,781,1203,786
7804,d9cc986d8240b64cb4bffbf6c368f5e79028e77945253822c95afa4b933511e0,packed,7786,28,54,59,87,54
7805,da0c57bb68714cfb9d0d42284ae7dff5dddd39e202a67789cad4636d279751f4,packed,7786,24,64,73,97,64
7806,da3c511b46e33db066cc53d527624b0cce19f87e33294ff80953be5d12795d1b,packed,7787,26,72,71,97,72
7807,da7ba82e385a22ee81ae2ea5dc0f0c0f5eb8adad3aa6aebba519b96d1e55b193,packed,293202,1147,2295,2330,3477,2295
7808,dafd02d6aa75ac454a941c950b89fc31d8c6c259761e454bf11ea5573e9c2348,packed,44411,199,389,332,531,389
7809,db575b8004ef4963c56befb42339451b9f166a31954414a547e796793e7adae0,packed,7786,32,64,66,98,64
7810,db60c570ec8a51c0e3a3549b022d1934fa3b666f4e7af4524443ebed4f7e4824,packed,83496,326,656,683,1009,656
7811,db95974b4d3489ce475e8475de8109e7d7468cce9eeac6494bd1618312539f93,packed,44166,179,329,327,506,329
7812,dbe600b317f05c6b898deebfb9ef3d155f63fa2355b5af421cb70ec706aa34a6,packed,7786,20,62,67,87,62
7813,dc8cc6e85ce63ec8e22b5039755ae121cea6cca8b4f1b830628ba3b802090a4f,packed,44121,173,323,378,551,323
7814,dce0480e3efc55ddecc3dfbf5e9166055eb0a8177e91edcb55e005534c6b10b6,packed,44366,180,341,375,555,341
7815,dd33cd5d438560c02d35eb1f6b5e585c98d609c9db127605e4efc97ae5494243,packed,7786,25,63,73,98,63
7816,dd373f9778f3a6f12bff91fee7b734c0e6d4bd05331d927ed38a876c52a16183,packed,44396,154,369,349,503,369
7817,ddac646670d6174f7570374eab64142d67f9d4c9e8fb3fd7eaf51baeef785164,packed,141506,497,1105,1162,1659,1105
7818,dea071a155ebf68b7fcdbcaab870ebcbcb6f708e5c67ea7571c9033e394c977a,packed,7785,31,49,73,104,49
7819,df3339a91945dce13c04d1290ecd98836f9152373d5a25279b9734d8b576131f,packed,44234,183,365,363,546,365
7820,df8b8b4725f62f7dba6b3f48bb50d82b2480a3c29a49758bffa5b00eac6196c2,packed,24358,93,171,192,285,171
7821,dfa1a8a0404c0775912f1af665e878ccdb907b332f33a8b830a251b78ffa4e9d,packed,44189,183,362,346,529,362
7822,dfb1ec1bf50a2a567ec248f19afba72b42c30d6ba61b62c6eea9760bdfa1d8a0,packed,44220,189,332,351,540,332
7823,dff734fad6dba49573d9eae97c88dddd383619dae2edc1fe1409c308ce94a228,packed,44131,183,379,301,484,379
7824,e0481d1dc98b6607eebd4a1cec7ae5f7ce51a43cc9f75cbc51aab9bf78533b93,packed,7788,28,59,78,106,59
7825,e102ee6ceb8654dd4babc2654d854a265eb821cd7ac6ee875bfc332a768260b8,packed,44344,196,406,390,586,406
7826,e166d681255ec37ad411d77b1ef03638fa2bc018c4da69bd1bfb2f3186b95c39,packed,7778,30,48,64,94,48
7827,e17784210595d72a8a8f47414803a8ea33e2fc1dc4893692d8b4115661540f95,packed,7787,25,46,73,98,46
7828,e1b0a76bd53705065cf1a975f8f29493068628264096dbc5088d2b4c59b20405,packed,7786,23,61,57,80,61
7829,e1cdd1aab99615547c6d8f7c767bc4f4a06596205ff97e3d81333f933fd10356,packed,7786,20,62,67,87,62
7830,e2065357a4581412bc0d2185b3b497c5339c81437db339dc0273d0382ef2f848,packed,44181,161,345,369,530,345
7831,e233230e930aecbb481e482e9ad2bc1ac284573598ae7bad622e0c11a4a99488,packed,220866,884,1733,1851,2735,1733
7832,e25268a6199d9e39afd60c7b6494c61d3011bfa23f00c32872ec644c5b7fe9e1,packed,7788,21,79,72,93,79
7833,e28547a6b735b8bd8d0d2451231977fe075ef11b85109e8f29c1b70521567064,packed,44261,159,355,362,521,355
7834,e2acb9f2afa1f7f71df854e235a12a4422d4048115896f3cc7e5f81cc1f5140e,packed,43943,203,332,326,529,332
7835,e2c984b09b50dba99b4fc4d2e4355e0360373b7921612c9bfed6d9779fc18259,packed,152543,599,1162,1225,1824,1162
7836,e30f2daf6c54d88b74469ac9696af8757ea61befa0ecf8afdf8a98e56fba19f6,packed,107579,443,823,817,1260,823
7837,e341615a42ae9cddc8b01b6a81af06e61c7a69ea720a0c9f2e49d965c21b9ef3,packed,44246,175,345,347,522,345
7838,e370f1b535171593751099b2cbda67c9f54d189b3b93c73d9b01aca8de3257bb,packed,1012993,3958,8070,8166,12124,8070
7839,e399d96faffc256cca26de64f12c899121f0cb9824fe202813106bb66db2f6f3,packed,579164,2270,4564,4634,6904,4564
7840,e4427166f99cb8eabe8ff91db61696fbfcdefd3f158cdc2f4cd43dbe19b22810,packed,44093,170,346,347,517,346
7841,e4c03e2f4573b5a9235e49ed1c1aeefb5f94af28f6b95b149b3f84f98d43e8c9,packed,102031,442,779,814,1256,779
7842,e556e4757d802a80f337c6519d273d875ac1a4a4b2378a579921d87259ea56be,packed,146163,554,1190,1159,1713,1190
7843,e5a30b9fda96e3fb762a0a2d517eee274e237da9ca2cc0c184b202fcce398eb2,packed,110620,451,853,845,1296,853
7844,e5ea1e1647558ddde95a2b3b1e0cdda3903894f12b9028fc10c5a6894ba72faa,packed,7787,33,57,76,109,57
7845,e60b1c079529037812f7fe472df2b52a9547db22e551d225469f11997643f856,packed,623787,2395,4842,4866,7261,4842
7846,e627dc4fd042111c561218c0526af0ea42357381055c04deab6e25d0aea91d2f,packed,347569,1335,2740,2707,4042,2740
7847,e6417fd74e557d0651e1db942db6363b4b3fec2c17a485f317adef05956e925e,packed,1011684,3916,7899,8163,12079,7899
7848,e6454aae133b8f5e6407360864e2b4f2ee7cc9ecc144493800892030ef9ea993,packed,44145,173,355,349,522,355
7849,e657e4d50c0118f7553b9e55e66becd275e741df0f29d23e3d1df49e6f41680a,packed,256427,1050,2066,2035,3085,2066
7850,e68bd62fb08b232431dbd1fa63c448084fb8721d869083c072b9dfcd6e14f3cc,packed,637613,2455,4987,5058,7513,4987
7851,e69b64b309aa266e023cd915a9f7510972727efab54492be944dfa26085162fa,packed,44184,161,347,338,499,347
7852,e6dbd61c6494f6fa8465c2f6a4d2ee1dd6d81d63f1aec3c8ecea6e54198dceea,packed,7786,24,64,73,97,64
7853,e6f1b45ec2d5a61d0f5ce83bfd57ed6dcb024b93c15bddc126c98401d3107f27,packed,44068,177,333,331,508,333
7854,e6f268f883a92875c340bc9f4aebcfc5e41bec9ed15d881e89b80ceb10941eae,packed,7787,27,53,78,105,53
7855,e70cee4730b4dbc7ebf2e2842494473312324c5b56e9148e1646895408e21387,packed,44163,166,366,332,498,366
7856,e7c66a018cdc3e3a42140d54de5846307e1ec642c5444f04a33acb4368fbc3a9,packed,7786,32,51,70,102,51
7857,e7d9b06edb8dd72eeed5c5606314794bf05b05069a4f821db4d938594a98ab05,packed,7787,26,72,71,97,72
7858,e7e8f4b5cb2255e1043e944781c984d5e214e0e86264599f552400bb472d59b6,packed,7787,15,63,76,91,63
7859,e89dbe3fc059c6292713f7d7ce810c6e6a6cc61ad1170be83f61245ed7d1ac1b,packed,118770,496,964,1007,1503,964
7860,e905d7dd0f9cc8ca2f4aec009372e11c617b1ca7342460eedcb5116cffbac59f,packed,7786,24,64,73,97,64
7861,e9887e627341f358aefa1a5dd19b9fa4a82ab6cc847a9781f4dfde894e85da5f,packed,44275,200,359,349,549,359
7862,ea0fcf1f6b5bf431988c85fae71a3adad5d32a86bd2f9ad96d45051903d0ae50,packed,44082,167,365,345,512,365
7863,ea384fbc5432e50b0fe6203b69573a56bef21bc299a9e4c8d9cb41b795964189,packed,7792,35,58,69,104,58
7864,ea44db19536219c478b877f7f5b26702d52f4fd33d803e89c65f565457129f5b,packed,44226,162,360,351,513,360
7865,ea61569cc59ef86976e1c1ce17ae0c52836150f09b392cc4d3097ce62b0bcdac,packed,1690683,6553,13171,13353,19906,13171
7866,eaae096aafa60fb721bd8c46e691ada69f1f7b93f898b20dcf097dd71e10baf6,packed,44334,183,342,366,549,342
7867,eb2a7daa4b65ddc8ab7a01a56b67d162b7064c309c9df90bfb04789e78f9bdd6,packed,2410555,9390,18764,18833,28223,18764
7868,eb74cb1a8fa8857e7ab19022010365daec3ea0f3129c7f74bc49a3512a4014f4,packed,44131,161,343,330,491,343
7869,eb7e8f753c3ad92600e12835bdd1e562e163c0c3b23df300012d6ad4b088bdfb,packed,44150,161,332,345,506,332
7870,eb86aaebfe8dc3de9fc996ae2cae27c6cf834b561fff7f2a04845765748afcc1,packed,7785,26,53,79,105,53
7871,ebf3c7bd4f340e247c855b76e43f9c9ce93bb95a67574572be8aed036054fc93,packed,7787,34,56,63,97,56
7872,ec86e2b369efed2c26388823735f54cb99d1925c1f2ec3512ded56b0820bfec3,packed,7777,28,67,51,79,67
7873,ec9c665ef716c8e6da66f764424c73330f76807ee6e1509b56d1c05fc0616f75,packed,52625,222,396,417,639,396
7874,ed3a5e143d04cf93027e09aa6f7db15f49832945ecc9d088776f7669ec3f91c6,packed,44121,176,343,336,512,343
7875,ed551c027c9fffa66f678385fe564535584afd0e2f3a8adb4ba87c6b1565714b,packed,44070,197,378,349,546,378
7876,ed8320cf2523a8fc808dd4ff9c007912212b443aaaa08544f4b6aa3baf97ce85,packed,44075,196,323,351,547,323
7877,ed94b562124859bfad87cfcc787ca3ffa14009df027cf8a347967d17675b43c8,packed,44205,185,353,376,561,353
7878,edc94461b70e0282f667f16d01f0e6e4e3e4a2722d53ed6ccffb9241c17249a0,packed,44325,178,328,350,528,328
7879,ede286e478bb77400716db3e6c71b7d6cbdb1d93533a53c76a0301cc3cd50bb2,packed,7787,24,56,68,92,56
7880,ee173967f06b6864031fe1d5b20b964e074d2cd31e9e0639f723ba94bd4a2ab9,packed,502172,1959,3779,3748,5707,3779
7881,ee5ed657ee15c1f2fc28cd2a65190843bb1d157ef5099b755908651884ec9190,packed,7787,32,66,67,99,66
7882,eed73b054df21a557e374d8ea0db2541be75733761dc97e4d1f1607ff89a1ac2,packed,625118,2371,4858,4786,7157,4858
7883,eef7a69ea2c4c26e01c925b61f3fe4fb7f5d404cc6f6f9725bc31243f2e66534,packed,146403,564,1182,1161,1725,1182
7884,ef1cdb88e4749abe53056c0592a07f2a747f84be556283b2b356d6e54bec0610,packed,44071,151,348,371,522,348
7885,ef445dbb94c098606e1250f1ab2bf11b80232018dd0c6d059221cd14fd6537ff,packed,146218,587,1185,1156,1743,1185
7886,ef60d113f9b5aa8b2beaeae4bc8b090d5224be298498b9aaeae8898d5aa131d1,packed,44224,184,365,340,524,365
7887,efb13ab321328450c3abf2074626bcbbbc76bb66b52b2369843ac9f563d2922f,packed,7787,26,72,71,97,72
7888,efb9282944c59563f874a7e65325c8a113800d73d3b526da545a0d05a32c0886,packed,44283,177,328,385,562,328
7889,f00b583a24a103eb5e614ee194d319a62384203340e8b7d95418396f78f0ccb6,packed,1061264,4126,8497,8445,12571,8497
7890,f055d59b3ed50bf64d345c4931c699d04f1c31c6b47e2acf4b13832f836b7be7,packed,7787,27,53,78,105,53
7891,f05dc973c991d5b7e926abf63c2c22b9bd668f26d294513bc541fdeb5076c280,packed,38267,140,336,311,451,336
7892,f0d113482615061dfa27bf601fbb5bc9a4de270558854b7549d7f2af1059ddc9,packed,7787,24,65,59,83,65
7893,f105cc915b9b25f17d13121a7fe1a1b262e8397155841fc573ea69523eac5f76,packed,44166,202,361,398,600,361
7894,f1329dfc312ade8ae434105a9d59ba7dd8cfc139a1fc83404bd7aff7c2e81151,packed,36262,153,267,294,447,267
7895,f14ca59b35e31f7fd48810efddb13b0e00c3a6baf567143ab93693a1d105ffbf,packed,735207,2923,5752,5798,8721,5752
7896,f18637079006fcb51666232bc70bf556838968e35b1b7108af609b3466eeb322,packed,272531,1063,2125,2263,3326,2125
7897,f1e3a72e514128abc1eb1676829ab9a001c838ba160bfeda0be43d06f08ecbd7,packed,43967,190,311,379,569,311
7898,f1fc7bb5a22ff6b5d94aae2254b69718c6e69d9893347779db895e888016c6ff,packed,7787,23,56,67,90,56
7899,f20fe143c0acb3029e89acb07b9080285ac20bad1484d6a3a20af635397ee74b,packed,95902,417,754,713,1130,754
7900,f24a4d33939486daa0e15d27ef415cceb0d240413b62a3ead31f4f3771213656,packed,308406,1185,2339,2413,3598,2339
7901,f2bdf46abeca11022051ff5a02706051b0d12d9a66f29bad64dcbd58561ff514,packed,7786,33,58,62,95,58
7902,f2d20479ab43e927d01715ee95d6f8ba8c2c8ba22de151449ba4b9cf69e02aee,packed,44253,179,370,372,551,370
7903,f31b33217b86d3b98397ae3ecc8551e87dddb23cd525e7f4c55be79fcdeb1094,packed,99389,417,801,750,1167,801
7904,f355ceb1c9cb8c68e6f711a274a9a28806064190bc61d8687493f1b3bd3e4356,packed,7786,27,63,63,90,63
7905,f36248ea7a789d72cc25f86a9453b0aa3c9f1ac97f36cefc7411e6c9a49dbc39,packed,1025588,4039,8090,8284,12323,8090
7906,f36c956625cd90322730f141da0fb045de6a162e7ef19fe3513ec3c5b83a50c7,packed,1013854,3970,7896,8573,12543,7896
7907,f386342c1aaea67c26b3b8a6b30cc128f524f4256067bbf3c7e91d2b6184033a,packed,7785,23,67,66,89,67
7908,f41c66a1134fc98275355211c712fcb58aad9c33a935a351341a955203c50ccc,packed,1006743,3984,8130,8061,12045,8130
7909,f46caa41b5a0f6da7ea6de83af77e07cb6182620870b802de370c573772f80e6,packed,44273,204,356,350,554,356
7910,f4d6febae995a3b255f9648504757b7cd5c3908b8dae6c81d6c8c249b0640b33,packed,7788,28,58,78,106,58
7911,f51a7790eec7a19eebb9a84ae551a02b63dfc546e99f9bbcd2bc0a4a7eb634af,packed,44381,161,330,339,500,330
7912,f5d2ede844b37e4e33207c9d29e25e775483d00cb3f2ce8c5e36552476c82750,packed,7788,28,58,78,106,58
7913,f5d61f8c077112c2037fc02ef252814f31e48f3a12925a831a0629aac780a121,packed,44258,192,357,390,582,357
7914,f602ec0b5b160b24a455715a80039532e1fdfff3ceedbeb4413c231c4a3ee5db,packed,7786,20,62,67,87,62
7915,f677c5aa5dfa2a7126fe31e5b034c75c851af2cc9071a052e63f1297710cdf0c,packed,7787,25,62,69,94,62
7916,f69f26b78808ad6576bf15090b152431a9015e2e004e8c3d5e9c3396b401885f,packed,146210,572,1185,1152,1724,1185
7917,f6b136d04667c274b50857fb2c449aae58fd06a7cf4616021769d232c0f72509,packed,44075,183,303,372,555,303
7918,f6d99559d375d03e7ba81b6f321fb438c6c2b0a6b3ed34a348f9540b3e4cc79c,packed,44231,159,322,366,525,322
7919,f6f11fdf2baf1a72389ad752872bba8ff5c9c180460071e793ecdcb9226a75c2,packed,7787,26,72,71,97,72
7920,f7007dab4e239b29a0881dc26f98cd6559ae709ec8c9bc07448235af0d289b9d,packed,44144,172,344,336,508,344
7921,f72f52c1056e54e2ff53aa33206925f9c9b366b08cfea2374e00f6b601ded0fc,packed,44076,182,365,374,556,365
7922,f77be22163d280906597cd6916771d6b15c553b8c0f23ed9a03f543e9521afe1,packed,627894,2377,4960,4839,7216,4960
7923,f7c48b7b543f6ed9bb7527ff79ed5413798b01a6b8cf5455feef902ecc46d371,packed,7787,25,62,69,94,62
7924,f7c99efade56096c24a973f36b19206cb7f53dc0fc48e1f45aca68f414e804dc,packed,183493,682,1460,1464,2146,1460
7925,f7dc5843142e2aa865fe32ca1c778241d35d4c5ce7bf2cb3a13904caee91cf62,packed,44050,187,358,351,538,358
7926,f808000fbe8f2ae1199bd4b23a7e9a8af953cdee21bd024decc9d08d1dd65f89,packed,7787,26,72,72,98,72
7927,f873a10e3a97057646eadd891d6ca2e8bf881fa281b28f2300df2419c2f65916,packed,43978,197,377,326,523,377
7928,f956a6b83e7af77fa89d1d36a971a65315b109093e2f65f89fbc6fa6fb456d50,packed,7785,23,71,67,90,71
7929,f9645c5d3d7c178adfff436b649e251de4c392dd32d2480451de81bfab68add8,packed,44207,149,353,368,517,353
7930,f985cecc3047ae329003271a3455ebfee4bf14143c484dcc7eba41f206fb394d,packed,7786,20,62,67,87,62
7931,f999562e2471317450058131e155f124075d8d60d64540f18712a70018e95d94,packed,7786,24,64,73,97,64
7932,f9b69d6436c4ffaae2522ee3d47532bb227044d203166b0a41225205705047bf,packed,7787,26,72,71,97,72
7933,f9dc51e75ed5a575376e9d3b442e0860e0b7743589168f0d8aa4570daa000335,packed,45379,204,348,386,590,348
7934,f9ff824979824686915a908ce2d68eae503704421f1c14e020cb2478eacc1eec,packed,44170,184,349,343,527,349
7935,fa1575e9205bc22a6a67170f289981908f0b22a06d066d04efdbbaee131a2560,packed,7787,26,72,71,97,72
7936,fa2fc0fe66d2fcaff8ac2c3c54efa51d47bb9c040e50098b1d438ed57c46f6b6,packed,44563,161,306,327,488,306
7937,faee02a0358c0d0ada4948fd7141588652c258eb5c40ea0f33867bdae0744d83,packed,7787,28,59,63,91,59
7938,fb4ac3ea55a666886c0d316b135204d867d41c3de633abadb0245397d84a3c51,packed,44036,187,303,374,561,303
7939,fbbb8f629bb8907455ea0039f43c8f94818afe59921e0278eea3651ae638cdd3,packed,44172,190,356,360,550,356
7940,fc43c667a32ab9404ce646f18f7eef706ab88055c0323e305e294e7501f6e04c,packed,7787,26,72,71,97,72
7941,fc82b05f90981a9bfd91965f10b472801fa1e2961e394c46b8fd8f036d37e3a3,packed,44345,140,346,362,502,346
7942,fca9b355694e168ff68d0505224e3fc3cd9c6f5b6ad825445c76ba67c64c2ff2,packed,44172,174,352,343,517,352
7943,fcbf01b890d3e423aa22f26681c6440ecb342acc593e8804416efb5037d3ee63,packed,44187,191,381,346,537,381
7944,fd3f0704ab9e842a62382c4e0f680187fb14f1e4f0af19997aa7a0223e63187c,packed,7786,27,53,78,105,53
7945,fd74b6026766a4db7e5f7e40dfcbe194b9c5722016539e9f8395a257525e1faa,packed,7787,26,72,71,97,72
7946,fd83efa4fae3d64a0832aebd74addab8fe81314e659eecfe2c6a0245b51df05a,packed,44123,173,320,353,526,320
7947,fd83fd20f56950333495d202a7c90248c2d4bbdcd68c0588bf33687c781bf42b,packed,369388,1563,2950,2881,4444,2950
7948,fdb462f159973b17806ae3c0e94d9b0577dee7493db3a75d372c50080356856a,packed,1025588,4040,8094,8289,12329,8094
7949,fdcd31e9032aef9868a07d022218613b8d5d11f85ec9f8cd960b8d64868eace7,packed,7787,32,61,75,107,61
7950,fddfa8e616e0442757214f6dde39e4155debc851adaf0ea702c54fff0ad8770e,packed,7786,26,64,64,90,64
7951,fe93446cd7601230c58fce214ea871b17487b5168603b408b491a9011b2e1b98,packed,44394,188,358,359,547,358
7952,feb282d84bc247a3fe18c9ac0c5f4b03f8a0fbfb0cfeea47bd9c39767273b22e,packed,579367,2244,4423,4608,6852,4423
7953,fed0c6f0e180746f344354e581a69009bbe1164bcf0e85e7c76542941cdd0aaf,packed,581043,2193,4494,4726,6919,4494
7954,ff15e5db0748a1ff62de71d8a36630122838bdd432978e14f1f3966c4cf8e55b,packed,43983,175,319,331,506,319
7955,ff76119cc12f48de52f75b67ef82855e9c22202b943072fa5e8ac04763b0ea4d,packed,44137,190,332,387,577,332
7956,ffb36b201250d1a243e33b9f6a1a3ef3c203ded884451f63befd14a3fda3721d,packed,44439,186,341,360,546,341
7957,ffd81a9679872a2766a74999829c564491fb35a8b2870dc16cd47c22a8052540,packed,294746,1139,2221,2292,3431,2221
7958,fff9f8ae7aa8cb05b1a198cedfd52c504035922b5f722a288c085a4c137c1a59,packed,44093,188,355,347,535,355
7959,0051f0a35f7c75eaca95f915d0915523dfd3999295ee83b782939520842cf207,ransomware,2948807,11401,23013,22878,34279,23013
7960,00c6e549f03cdeaac06a43a7ee541710c0820f457b8a83f94682ae1c90b9e1c8,ransomware,1688308,6320,13220,13586,19906,13220
7961,01541daa8c2bde09d6c82dfeec4e739d4f37652b970a6ed6a0bfde5677d53691,ransomware,85281,277,657,756,1033,657
7962,01f0d0ddf109ce43e2c5663e1d6719bbe6869589cdbc92cec9ed32849d476954,ransomware,2322068,8946,18171,18062,27008,18171
7963,01fdc0355f527a540981398c6db230e4f0b81bf97ca97d876c613b02a608fb72,ransomware,2596395,10033,20348,20452,30485,20348
7964,0263aa330397ed92bc9804843c05644d914c7b0329d63c9aec51b7a163dc6ddf,ransomware,1040002,3702,8325,8664,12366,8325
7965,02a231d401b08f0c4060e59a75731550df860d2b276ba94c4d74ba7e20f2ef01,ransomware,1398196,5433,10860,11026,16459,10860
7966,03456697692f149105e6265fc39713e4f44a5ed78470b565254078aaa61441f6,ransomware,2074690,8014,16086,16170,24184,16086
7967,0394427c3a35acb5859cda0ab457e11e7412acf8426517f0bbfa2d3d3776a04c,ransomware,1304886,4978,10267,10170,15148,10267
7968,03e6782cc800c5086bc26b5eee59166da2beaab7e3afe5d8ffa11d30560684ad,ransomware,3292420,12760,25741,25636,38396,25741
7969,04223325c481eedcdcc3ba0fff0e78c4a39219f1f46f6f26f6438972b014d4cb,ransomware,3436463,13287,26828,26656,39943,26828
7970,04360105fbe76a7d61698349c94115c1cba123e2720591e2cfacef51cdfbaa27,ransomware,3141334,12121,24425,24567,36688,24425
7971,0448465bf65424a084df81ede88badf244454ed95b9014d2eb33e55b7a02a1b7,ransomware,1955234,7557,15253,15177,22734,15253
7972,048ba460020b786959f3fb42780309af8e34556879e9e70513c8800d6a864278,ransomware,1456938,5419,11454,11836,17255,11454
7973,050fff7e6b22e29c4f49c592f08bc01c88491be3d443099fe2ec6966e5e7ddb0,ransomware,837158,3210,6559,7174,10384,6559
7974,053aec778b81ef58f4b47e5af1412ac5a111d6adfaa987772380c1f131ca2e4d,ransomware,3439946,13340,26884,26713,40053,26884
7975,054244521b6c8e29319012a2c77b6dfa67a4e058fcde465689983b3531418d01,ransomware,3208787,12438,25026,25009,37447,25026
7976,0584e90763df3d83ececa1f1335a1bd3f8ef2537328a0b866500698a6516899c,ransomware,2045900,7849,15911,15982,23831,15911
7977,05d6a2a83c6d404ba7a9d4e0e30b366be8df7846b508ff46160cdf6eb580c7ac,ransomware,2453644,9448,19270,19373,28821,19270
7978,05e009c3fa93387e5f15593dc45e91aabec321e2774ec60cea4e25aa27e7fdfd,ransomware,3190735,12338,24933,24816,37154,24933
7979,06475408872c80ff87f400c041a2b2eedb0cf91feb551fa28965091920465f80,ransomware,2064190,8064,16060,16039,24103,16060
7980,0658c96a069339e94782fde85ad1a9514f6b16b16133ac165ac9e69d4d772daf,ransomware,1047473,3981,8176,8228,12209,8176
7981,06cea412c92d721aa9f53636637abdf067c0a2d93ed0db60867add3c00232f37,ransomware,3113007,11985,24252,24140,36125,24252
7982,0707869f55845497e8a0bc79cb6aeab1aecf10cee96eaa65a2afff14afd0c770,ransomware,3378257,13057,26437,26324,39381,26437
7983,075558b64462d81f14cf2c0f2a345ea9980e3efc4c1a6c7d6db02c2e4365b2d4,ransomware,2598465,10081,20376,20252,30333,20376
7984,0757cf9384470529e88e6c508fcb08d607606825f906500cac47407e74422871,ransomware,830880,3156,6514,6547,9703,6514
7985,075985fd5a05e5e15fb5a25b7e0a40845485920913496eb7ba59ed5720c8447d,ransomware,2466706,9343,19367,19540,28883,19367
7986,07669682b930be035bb92ba6d13daf237575bd4405184082152b0f1dda86d06c,ransomware,3001477,11573,23462,23455,35028,23462
7987,07b28ec0f6fc5ab2236ddf2cdb643ec05fcbcf22be6f94894003ab8cb0af4235,ransomware,2931577,11342,22920,22851,34193,22920
7988,07bb7a3b0503b63081ebcf939807c1f0e6aec7ee8e67d3445aa474a778e5f3ab,ransomware,2642770,10205,20630,20524,30729,20630
7989,0815542036fb9778f041ac479a3054561bbd842edd9732f595ee43b4d922c937,ransomware,3239789,12512,25303,25151,37663,25303
7990,0848965c46c96a3aa2111fa73b700bda76a5949fee0bff05af5d26a580745256,ransomware,1139579,4365,8874,8949,13314,8874
7991,087a8054e3c8b1a34b7d1138320899087ba6ea5a49fb63c37ca0fc46cca700e9,ransomware,828474,3149,6452,6489,9638,6452
7992,087ffdfc2118e05b69ff004e79ac57eb2fb44a04af6817eab0c596fbeb06dc87,ransomware,3077849,11856,24067,24106,35962,24067
7993,091255bdd30e3b64726fd693940e974cb38e8d0b45c874816a9c9944f7c9058e,ransomware,2099566,8038,16315,16298,24336,16315
7994,092adb6e29921a78170a2a7fd7e2edc262bd40b6880b1b5ed01200e24ba0149f,ransomware,2933367,11312,22874,23030,34342,22874
7995,0941d98f12b6ce3c969a426dbb0878869e6962a08dc676870e98d98d0d8e8f62,ransomware,2568472,9908,20048,20117,30025,20048
7996,099f733adc72e915baa9139ffae74ed89c486c02cdc56251e7bab3fcd52f53ab,ransomware,3386534,13097,26462,26326,39423,26462
7997,09e25fc07f597b7ad5b81cddb66643c96792bf4c69b58a47ee6390cfa36af961,ransomware,3378772,13084,26457,26241,39325,26457
7998,0a5b86ad31df3c19317920852c14913beb82efd11990f6353864c3aec9ed43a8,ransomware,2987402,11480,23233,23462,34942,23233
7999,0ab137df617b1421cad8238f20c97d4b24ebccf182ced6f9fc34d0f14e6155e7,ransomware,2118174,8236,16604,16846,25082,16604
8000,0b27c42cdc56e5e088ecdc9cac075f3b9bdcf147ecf2614d7c2193c1286cc704,ransomware,2127203,8090,16706,17067,25157,16706
8001,0b4f7c8ced4d3fbd07fc178b53297cdfdc09967a8df3f8778baed8665ffd6108,ransomware,2031099,7723,15938,16126,23849,15938
8002,0b788868a86d561468da57c6b512df7908f19e8b2b515f31d42d72d43fb644c5,ransomware,2127149,8149,16561,16442,24591,16561
8003,0b90a6eb64b9915d85c5f92e036dd903d1ab38aa06cb001bbfff2b807e4a1d1d,ransomware,330043,1289,2491,2814,4103,2491
8004,0bb547aeb2a540dd471a09a209b1ad1485321da49b370d77cbb86bb1db80b0b8,ransomware,104526,395,749,833,1228,749
8005,0bb9d9ce8a4cdc296c1a6ca67509ee5207915b7e9f02b41a8af0a68e0a99bf5a,ransomware,2152891,8401,16913,17242,25643,16913
8006,0be4ac523526b4c6586f458b24bd5b080e3c831bed486b611bfad262e2c1e222,ransomware,3033511,11801,23683,23753,35554,23683
8007,0bee96ee118fb39b7363749152f0d078447ad1499373b9633ff1a85cc93135f1,ransomware,1431876,5435,11165,11261,16696,11165
8008,0c186e3b9e2631679f954f368284c39e8e059d816f62f07f5ffd6f220e67bd8c,ransomware,2050092,7817,16002,16196,24013,16002
8009,0c5f94b039f2999e626c4ad1d3c3fb0bb86bc1c13252f9a8cd8aa74cee363c8d,ransomware,2152357,8301,16865,16824,25125,16865
8010,0d09111d0c1b1fe1bfe816b29d6b5bbbffbb7a44cd89b09dcbb42481ed1103bf,ransomware,2647566,10251,20784,20634,30885,20784
8011,0d9f97ca54f6f390b347fdb395275ebe19128447d621b392295c8bfbd9d80f9a,ransomware,644969,2455,5017,5129,7584,5017
8012,0df4a39a8b541011bd3ff14787284fa300a0329067098ba88e107a20b4b37712,ransomware,1696618,6261,13492,13836,20097,13492
8013,0ea79a8061a5438a9ddd2b906656d8775d15f8195868716fc0a26ff39d5a2780,ransomware,2348104,9042,18387,18390,27432,18387
8014,0f2819d1e6a25445c56478a06287003c74064bf38a8e9d06ac7e58e8b228ffbd,ransomware,3036067,11680,23737,23746,35426,23737
8015,0fa267d077d05dae948a75533d314f2427b59313525695f163bac5858dfdbcf3,ransomware,552062,2143,4552,5155,7298,4552
8016,1029ab559a26e7aa1c5f88284323facee3f414bd795ebb146fb6953c6ea6f153,ransomware,1770310,6571,13822,13823,20394,13822
8017,10711010a455350aeee8c25ef938564380195ae74d9c446f87611ccdbaab9caf,ransomware,2230860,8552,17400,17409,25961,17400
8018,1087012f649d377b9100bbb6b8070cd38e554526233e576dcebe62c356e26fd9,ransomware,3419724,13731,26758,24839,38570,26758
8019,10c9db617d48da39385ab995daec60d4be701a975c6f74af78744036dee9eb0d,ransomware,995870,3777,7738,7929,11706,7738
8020,10e1793bc3ffa85feeb4a8ba5239c40814446ae58d9fdeee5acee7d33eb55db4,ransomware,3484723,13462,27166,27038,40500,27166
8021,11045ddaf20f3bf9eea14fa4cc8ce8152596a43606ca2556602531b0c75731e5,ransomware,1795124,6748,14187,14454,21202,14187
8022,11163c37a5c6ace9051ae49413526873d45d5c3d8d5a3d688449a01c859d9ec9,ransomware,3089251,11950,24194,23966,35916,24194
8023,112069890cc06f2773de21d2a40374bba89488b4349a5d47bf9c15e28805a6d8,ransomware,2708213,10472,21224,21095,31567,21224
8024,1131e2ea9d835de16dce3383dcfd9b42bcd7c9f420a37a095badee4421fe840a,ransomware,1517501,5847,11814,11743,17590,11814
8025,115b8b48ab902cdae261c4985f978e95da2ed2965a8944275cf4a1afffb50727,ransomware,3061131,11904,23931,23762,35666,23931
8026,11898d15ff2a2919c402161a78f07d21ff9f7873826712e078dcd1b4a1762534,ransomware,115082,413,887,937,1350,887
8027,118adcc78fd3f8bae2a913f46315521214389c6fb816b31f0e99f0fc6fe9acf1,ransomware,1600087,6131,12673,12638,18769,12673
8028,11a26bd2548e7ac4b0f9eeb6e53505584d7b4091cd813202afaf9c55dc22f146,ransomware,2900436,11259,22714,22561,33820,22714
8029,11c6c3eda60c856f0e8ed74a678b451f1cb94a9374e62ad1c3b86ea2a8135729,ransomware,3117866,12098,24389,24206,36304,24389
8030,11d361d5a47c698ce92dd54e1b66dd7252b5caddb570c173314c86399ff1d18d,ransomware,1708589,6688,13297,13871,20559,13297
8031,1202a03f9d15c323bdb8820ea5cd31c1dfdf9677e85986dfb72e0b02d47babc2,ransomware,983235,3695,7825,7716,11411,7825
8032,1270ff801252e2cb9ad5f5b5147670c8dedbe99818bf3f72a998aee5bb1719fd,ransomware,1999587,7483,15710,16094,23577,15710
8033,12cc384289439b916fdcdc4e5d2c742b071594fe3f5eca50782808d4f0bef43c,ransomware,3464431,13416,27040,26914,40330,27040
8034,12d146fce1a760efd0506f6aef18328e2c59377e0f4d9d7fe19aa3d58d464826,ransomware,1490689,5631,11665,11915,17546,11665
8035,12e174e01d44f5e38f81e11777c44ba6bf0d4b9aa36530800ff29a8949770c80,ransomware,662532,2525,5178,5252,7777,5178
8036,13171c2476077e216aa5973db12df6359982c358fa1bb73d3e5023e978c506c3,ransomware,1713737,6541,13328,13422,19963,13328
8037,136fcf5f4f90e85f7483301c1eaf5b34112eea6a1910c9ca70bf3b835e32b57d,ransomware,3153944,12166,24642,24574,36740,24642
8038,13a141a0a69ec4649e96175995e55070c94a8d1917a445f4ea18fba4e2a654df,ransomware,3204555,12475,25077,24999,37474,25077
8039,13c4171a1a219802c5f62ef7739c38c298d015373661e2d5adf8a9873bc83c18,ransomware,1826180,7017,14201,14279,21296,14201
8040,146b847b5ffa638f2bf4bfd1ebb88f66156edd9d8d297df3527542b65f5e129b,ransomware,1956749,7492,15291,15361,22853,15291
8041,150f8d116676d606c925d742cda7a5ce91722bd597e804aff3a74d775fe5235a,ransomware,3158034,12265,24683,24478,36743,24683
8042,1522b01c657093944a470c67abfcb7ff59f63c3d5d27ccc07cc5d7fed43bece4,ransomware,772186,2898,5834,6117,9015,5834
8043,15a9da93cca1dd8e649663098894b30c59d0b0fccef288fe49554283be2549d6,ransomware,1887583,7154,14774,14941,22095,14774
8044,160f1e653f442bee672b35f9a72ae976e63ad61d147e5a4c95e9c5718fefa0c2,ransomware,1341962,5127,10591,10522,15649,10591
8045,1644331adc683095f06242e8dc8597b61938c530f636c5dc0b0be34f258eeb3e,ransomware,3100813,12002,24214,24131,36133,24214
8046,1661b3ee33a6cb754131467e2785e693abad43f140b5fdd3849ea7826daf141a,ransomware,2626377,10118,20526,20646,30764,20526
8047,16686a4a460ee213315250afd373a2d9a17a76a84a8e6904cccfedd5a759954c,ransomware,3300133,12755,25806,25717,38472,25806
8048,16c1ded6787eed32a459bb4306a1f0e1984fe26bb0092d840e5494b16935f2ce,ransomware,3472230,13337,27245,27382,40719,27245
8049,17862ec345b3594cc689d4d0ee42ad9e81999a4b5d7e12dde1854def7cb1c343,ransomware,2471735,9572,19370,19244,28816,19370
8050,178e0c8fc72ca016821f999e7a130e1428a79a2faa6a9a580bffd56f92f93afa,ransomware,834374,3169,6496,6539,9708,6496
8051,1797f718d1e31a5af7c56cf9f6adab0c7cc248825ff459f9723225595e42d4c4,ransomware,1268114,4750,9916,9954,14704,9916
8052,17a0c2cb51f7ed53cb987ca48b9d73a691aa37561ff7f262d8e21bb5b83b3c97,ransomware,3216913,12537,25107,25208,37745,25107
8053,17a2a344ebaa5aeb28f1b224a8fffe78ab9201b5929d4b19f9b9cd1b5a105db8,ransomware,2900969,11273,22743,22652,33925,22743
8054,17a55a87b9504eb0bd586d019c47aeca8991c1c3040cadb53bb47d9b77c7f726,ransomware,2101192,8049,16363,16383,24432,16363
8055,17f682e55614fc346ebe5cbda783964b58dffa461977aa44436c9f975d0da3a2,ransomware,2965869,11437,23158,23081,34518,23158
8056,181743d1e3c51aa55ef39c4a8ef8b39c97d2fe6fcdc1f602b9d7a7da3e5eb8b6,ransomware,3274886,12790,25684,25236,38026,25684
8057,1839e0d2ee3088686a5f30a9d40f23466863b64ab92c64a85f5f4b00a1edce4c,ransomware,1824192,7031,14218,14189,21220,14218
8058,1886c064502cfad2f6907b836fe7118428dd44f28a904044d410b81abb2c162c,ransomware,3361777,12992,26303,26323,39315,26303
8059,18b0795126fa23f6669c5223fb9561f886e1f43ede6582fd7c1a1f868bd7bae6,ransomware,2497522,9570,19734,19612,29182,19734
8060,18e72e1673ef97f499b60e3a8e4ec4cf1310be4dbde6af2c8150a65980c7a060,ransomware,3156053,12220,24641,24711,36931,24641
8061,193837c5ffe92bea11d2810ffb3c77685f52347f9420c8e985c771aed5b14980,ransomware,2774236,10713,21628,21459,32172,21628
8062,19a3a2f9648d0a5390ae3476154754a834ed48006ad87cd38cdd05a8dbe4cb02,ransomware,1683488,6432,13081,13105,19537,13081
8063,1a22ade91a018ab51132370a99e9493e1f821de1d78cca7f05d64cb403ded806,ransomware,302624,1176,2335,2369,3545,2335
8064,1a2cda6e9c99eac691edacd200856cdc2e6f506d7ce03c002796b55837129fe2,ransomware,3062599,11800,23962,23967,35767,23962
8065,1a484adfa97618305d3dac9e8c801e8ba7565295dddb6e141aa2d282e6db6139,ransomware,3415105,13196,26692,26581,39777,26692
8066,1a627a0540ad62dc7e6b0a7e1fdcb72f6d204e8199448f09c7ed0c8121b866aa,ransomware,3171010,12360,24839,24561,36921,24839
8067,1a75d5053dbe58769ec8a6fa555b30faaedd5bff2914701bf4976b4685d607a7,ransomware,439423,1527,3517,3828,5355,3517
8068,1ac5dd5226044464ea3bf4ec5944a966e2562f6658a1edaf55ae4d5df16d0501,ransomware,3465242,13420,27032,26889,40309,27032
8069,1af6d4e3776cf2d162a7a1ff927644d05b71c765efc35aea1a7096ddeb4f123d,ransomware,2882900,11153,22484,22527,33680,22484
8070,1b327cbbf6b13803c33041b02fb48f6cc464ed901905202bb84d9380457c5de8,ransomware,2622306,10178,20522,20441,30619,20522
8071,1b4fb2a7654bf05ce94908dc888fa07d21f29c7fb222499070c070add3356311,ransomware,2937245,11404,22983,22814,34218,22983
8072,1b7db46d9d02ff159ca3d7613975c5ec432a49c552c37929329004ded70347cb,ransomware,2008369,7683,15607,15660,23343,15607
8073,1bca435f5ea4184d174406eb3c5832c4913560a91b0b345be27b390be8b490af,ransomware,2930830,11390,22894,22765,34155,22894
8074,1c020b9f03abad3602a495a318ddf8575c8a86262d900104abb6c089b7ddae56,ransomware,1234155,4642,9434,10129,14771,9434
8075,1c453658c8a0924c9ad7fa06eb949ec298e7bc9178bd1760993e0ac315b4f1d3,ransomware,2045127,7827,15935,16236,24063,15935
8076,1d22b67c70d5db42c8a4e03b0e8a7308cea3d2217e14ad28c9a4339dc5ae0953,ransomware,3068109,11877,24003,23911,35788,24003
8077,1d24aca694cc7be745e0c0c1dd7ad424c729612584fc76c0711e618caf1617c7,ransomware,3112525,12200,24358,24218,36418,24358
8078,1d2796b4a5cc5e0204468337736ab31f1905201a971ea26906cfea4d769d4d7f,ransomware,2789874,10787,21839,21936,32723,21839
8079,1d88b8a698dca924d4920bc2f8252e1fda19cdc1d7140c3608f047d0deaceb3f,ransomware,2417690,9369,18962,18843,28212,18962
8080,1da6cb9d19f579b11f2ff9dbc4b2058668754cac911c04dec037a7fc6cd0f14e,ransomware,2358558,9090,18451,18381,27471,18451
8081,1df7a76429c4260136fefafc32f4923ff08070ee5ab62abe3a8f30d268823c01,ransomware,2700962,10430,21198,21245,31675,21198
8082,1e063e590c134fcab429c5fd2d8b2a8898c673b1019ec4a16cb3da0c620ccdfd,ransomware,3127025,12044,24505,24411,36455,24505
8083,1e4750deb9e067cbbe968a00ae69e4b57c7b5f40fd2e6df69589e65ac4a67f03,ransomware,1841304,7031,14353,14370,21401,14353
8084,1eb6a142fb79c4dbebed5ba1b8e0d5f57e8cf853769c57689a613b76a81573dd,ransomware,1928742,7421,15026,15009,22430,15026
8085,1f4935c0709eee2abd6c189becde449a169ded9af08615de098fa5c1bcb08be4,ransomware,644721,2456,5008,5062,7518,5008
8086,1f6ef1f80972be57a573bcdf701db98a36fc670f48ce3cc3b2324cee68e7830b,ransomware,3484798,13449,27260,27020,40469,27260
8087,2023c117d21a1edcf12ebfdbc4b1ad48cb679d7f7273a52132d4160794859f45,ransomware,2392330,9318,18718,18749,28067,18718
8088,20951af9c7f01414db5220195a960c46dc50f16ff086bc239d320f5473536f97,ransomware,1500941,5786,11667,11705,17491,11667
8089,209c9933cea5b8c00add83839d9eaced9b443cb7de82d97dee2a070f174bce01,ransomware,3484775,13527,27138,27067,40594,27138
8090,20e853b9cb6cde4e37558569bebe958a31ba2822cab02de0c6ac0584148ee50e,ransomware,3231613,12539,25255,25077,37616,25255
8091,212c064945e86e81d5e4469f7723268d7a92081502f4a4ab6a7d65160b64045a,ransomware,2543880,9772,19922,20065,29837,19922
8092,218ec102cb112e51684b5fd51d9a6daeb85bc5244adef700fe5ec07740031d1e,ransomware,2001592,7533,15675,15980,23513,15675
8093,21ffad863d2702018571526b280f28fe362a271687d890b75975219a8005bd72,ransomware,1127340,4287,8783,8954,13241,8783
8094,2204fc332888538ed8dc1c944c53a9b4b4b445b9d7c5b2d34917a8b99df2d49c,ransomware,1607553,6206,12511,12583,18789,12511
8095,224c0cd016e8277e4368f5108bebc41c9a735f2f3619a23d4718f9fd80b1d427,ransomware,2913052,11291,22740,22599,33890,22740
8096,22755c3a6569bf941d6adfbf5dbf5e1637d4a7f8165692214188fafba9f2f43e,ransomware,2217127,8455,17264,17677,26132,17264
8097,2284715ad83180897cff411217c4d5e9ab1500ec4075451efa95dc2a0f9bcbb7,ransomware,3399088,13171,26584,26385,39556,26584
8098,22b5b90db4a2bd1d2e1d1e967ed44daf89a55b4a41262cfc893ac5e608f94537,ransomware,797920,3032,6187,6300,9332,6187
8099,22ba129e4b6ab38b0e0441788d1f8fce9bacc0f0cc97d8beefd391a418aad708,ransomware,2276287,8757,17971,17789,26546,17971
8100,2334428d8d07ef196de9ff905c5285f8bde95901d2a3f775ebc3a5cf7d8ea915,ransomware,1999296,7586,15700,16033,23619,15700
8101,2338f2cea95194a07448392ec6ff47b0df3b301930376f38c6b488635dcd61d8,ransomware,1815548,7055,14202,14234,21289,14202
8102,2344397ae9c10abfd8904079a768a360bdd284c076572d78860ec19665e3f2f2,ransomware,2843806,10925,22261,22183,33108,22261
8103,2409dcbb797339b92c532902c054027724e6b14220baaaf1a1392b9cfb333e18,ransomware,1283392,4912,10042,10002,14914,10042
8104,240bdf1a66714a61c24a7b0dd7e8d3279498956ad018bd16a0dbfee6315db6cd,ransomware,3258945,12509,25571,25599,38108,25571
8105,24343f4481fbcbe8a2e5f2d2c14272a4e68defab510e935416e55eb31965c961,ransomware,3239793,12564,25325,25146,37710,25325
8106,249690d3939c7a7c4955e234bf234e3a66a756057807c55f388331e49ea2d13d,ransomware,238832,935,1837,1951,2886,1837
8107,24c420571bab15576b99db2f7b41370bdb58e436543d30a5cac3d77850f3789c,ransomware,2367879,9131,18566,18433,27564,18566
8108,24e5b5ddd2673794e790bb7a4b8bbd49af9830e38dbdfee8d2a78a13135aa133,ransomware,1780478,6798,13843,13948,20746,13843
8109,2546c0396375ff13b08af11b87298128ed60fdb91a4f8558454518d8b856848b,ransomware,2074021,8084,16184,16213,24297,16184
8110,25700cfa85c90dadd1c1c92013d85c66474ba936c98076d698ced44ccd2dd549,ransomware,2304333,8937,17986,17939,26876,17986
8111,2579f0541962d29710cf338f4cc1847ca37e0af6eb42bb93952d8d40372de181,ransomware,3484775,13604,27226,27097,40701,27226
8112,257fbff93f17a2dc13b1a27be5d78bf506f6a518e6efb6e9a66c28f1352cf808,ransomware,2493175,9684,19538,19444,29128,19538
8113,25988bd60bd2bddd82b08f2c2e3ca563cb53b0a03a762bdbf517d7c9d0ba3757,ransomware,2844284,10900,22289,22268,33168,22289
8114,25f4bf2c18c4737289009ab2c3fb7070080300504d9df0d8db545a51c46047af,ransomware,2562844,9979,20038,20276,30255,20038
8115,25f5ab11a488c1438de1831acf641ba9eaf4db9625a76e1c6a63f9016290a83f,ransomware,3346113,12979,26161,25989,38968,26161
8116,2659455ecfc6abb0611c83500fc8ef0246cf055dc1d8f8a1906e308f71c2228e,ransomware,1714547,6541,13397,13425,19966,13397
8117,279f43ead89bcd886d3db04fbdece9c0242518305050edb21a0cd18d6e2fd08a,ransomware,1394828,5369,10839,10917,16286,10839
8118,27d986c0dbfe409336f58c4ccce5e4fbc4cf19b83b0e35c90163d4ed83ea3572,ransomware,2223780,8557,17424,17277,25834,17424
8119,27f965d01ca5abe0b4b38a7c2f936d14f8976841ddfbeea863173bbbab262332,ransomware,3269096,12668,25555,25410,38078,25555
8120,286d81b82d2fd964b40f24954a180b692e8a4fc4fd4ea14932008f8ec1f884dc,ransomware,644338,2436,4987,5182,7618,4987
8121,288c1b3eb0d8c2b09b74a2f1cb69218f693e276df86893720d3a43ac7aaa7d4a,ransomware,2706940,10381,21084,21399,31780,21084
8122,29251ba62aabc84b344d1f79c0318adc2494d24e73c04da876d3327de2b46fd7,ransomware,1537519,5969,11995,11909,17878,11995
8123,294b42bf9aa8f33f34181bc9fca1674e484d640fe4e01d34b4338d9680582df9,ransomware,792193,3050,6197,6169,9219,6197
8124,297741e6be91f00aabe6734ca3c1522d1154d537ec78892f769a77002a61d0fa,ransomware,3443509,13368,26901,26760,40128,26901
8125,29c05c86a5743808a6623a5e9576424925b8371707ef7a0ba73eb3e7732e50ff,ransomware,3422515,13242,26756,26598,39840,26756
8126,2a537a5b480f390a09ea25639edf9408cf8f4740a895cdb9b4622e7d20db7861,ransomware,3320919,12832,25958,25756,38588,25958
8127,2abcd3351c19c800fb72c0a41710398b4044a0621b32aac966efb4ef3f3e3675,ransomware,3444009,13325,26941,26765,40090,26941
8128,2b141db065b20a54a1ae56784c24c3a4c4a39922f8b769aa23374246b6825226,ransomware,2479566,9433,19559,19597,29030,19559
8129,2b25d4e78dabc2447be21133a7af6b692997e61dbb8c192e3d9618a723b0d9a1,ransomware,2498726,9689,19491,19766,29455,19491
8130,2b9a86a21aa58b0f7ddc55b24a3840b042ebaf249c4102d6b3bd313c755519df,ransomware,2785924,10777,21790,21678,32455,21790
8131,2c03ee0686f17ad81b8c405eea19d4c6a5152ea7a0fc0b67d9015c9e602ffff1,ransomware,3480737,13482,27207,27016,40498,27207
8132,2c5417c4cc6c272a7f31b26151573a1b74dbec1e27a239170689fad76914e0bc,ransomware,2833129,10950,22075,22122,33072,22075
8133,2c8634eaad9cc6cda5735396a7cb953be045c911d91d5906e55817dc45f6541b,ransomware,3158175,12240,24686,24563,36803,24686
8134,2cb5406bf1afbae304a0a2bafaef7bb8b3d0a994f7719324b67319ec37d504bc,ransomware,2890461,11088,22744,22495,33583,22744
8135,2d32fbbb1805dfcb273a11c71c3cd0958bc0c4e175efaead3240209016144895,ransomware,3141898,12407,24332,24171,36578,24332
8136,2d8ba84dc0d1f95019a62b2189495892f6d88fffd25ce2c00058e36014f16d5c,ransomware,2835381,11001,22264,22097,33098,22264
8137,2da7b39a1412369fe16f59954004a529cb15203729b01cb693322c606d761175,ransomware,3481252,13434,27174,27075,40509,27174
8138,2da83f4fa259823f1244cfd5cb6d11f1081225585fe92f9470b0e6772177656e,ransomware,1962727,7613,15314,15267,22880,15314
8139,2db2f98fc185d694e8db9b1203cece8419eed75d46bf5916f2477b3a8568bacc,ransomware,1709521,6633,13341,13253,19886,13341
8140,2df75d6b4624cb263ddb28af21992ac5e5449211abc47eefd21faac92daa8bac,ransomware,3378703,13089,26342,26208,39297,26342
8141,2e09b6eb98d09e8dc417f830ab6e9df7b339fe56904f6c601f9595948dc4d2ec,ransomware,1819217,6927,14193,14191,21118,14193
8142,2e316efc35437046824c5ee9313697183f1a0c45668037c304304a71c4c47314,ransomware,1615680,6257,12541,12514,18771,12541
8143,2e81fbf1e1b1a90d6ca3c70bc4144e136e85b3464d31e68da7d9842f5ddd5e9c,ransomware,2569466,9866,20069,19892,29758,20069
8144,2ea7eac5ec51e0230224e76f3a84e4fae505eef705b7c78afbf8e4f0c4e9ad41,ransomware,2945347,11387,22989,22887,34274,22989
8145,2ed0f7f655f36676fb62faa820a4af1084c9792d512380101782e7bd1aa3e806,ransomware,300257,1165,2300,2402,3567,2300
8146,2ef79470d39b508f6d2ac40b20c7ef17bc9737d560060277a9e5ddc50fd0bd7a,ransomware,1999512,7500,15670,16026,23526,15670
8147,2f0f99cb7de97e063cde4034d8384114b2120d1823e90aa89ab9d6041a99c471,ransomware,2700801,10369,21152,21046,31415,21152
8148,2f4b0caaf4a1c8eb3d174603f98dad0a9819bbe54947b3576a140462c0376ba9,ransomware,2080433,7849,16323,16732,24581,16323
8149,2f5ce58d6b67c4668e6756983adc7b0a3fde28f0771a8b88158710a997532aef,ransomware,2620427,10103,20528,20425,30528,20528
8150,2fd3f2c11d689e22fb2225c9fe257bd8a4774ed9bc477b9f1e2702efc06d620b,ransomware,3447408,13337,26913,26793,40130,26913
8151,2fe4cbcbe293632552a7704dd24a6abb0681637bbfbd4f5f07699bd2b5e00865,ransomware,1321458,5051,10327,10404,15455,10327
8152,30f73cff5b8c6943758d01aa53d94f62b556d228a5a755428402f3fd066fd86f,ransomware,2066466,8039,16175,16066,24105,16175
8153,31150720766ba002ba17aaa8c94f5f539dc897260bd1e651e585a4a55bae90a4,ransomware,3287786,12725,25708,25573,38298,25708
8154,31c632a8b11171c39e1294c51fe681df64edc51737a99c990fa6f79647ee2037,ransomware,3232428,12613,25296,25100,37713,25296
8155,31d5da4377e51cfade377deb989652edb5c0262029d8df7d0ea64a7ce25cfb21,ransomware,2879066,11089,22832,22477,33566,22832
8156,31ed4a3b65856fc6a265b96020082237c921f2c221edf2562bcc714645de8d0e,ransomware,3034081,11734,23824,23647,35381,23824
8157,31f6a8c88d8d3bcde93a68890b158ab7b8528d21ae4f216b9ea722ad04a0e75d,ransomware,3482500,13483,27253,27088,40571,27253
8158,3277c2c078a952007f4e99323420f438fcf1c646795cf50ea09aeefa97f44f7d,ransomware,1692680,6462,13160,13207,19669,13160
8159,32c45b619a80dcbf6d099f78896a9a3e7100712a1a582a5b1a612342a37af4b5,ransomware,2213452,8412,17339,17600,26012,17339
8160,32d3cb9e34930b314c2121b4ddb1a59045cfe94202b83b1d8410787ea9c24073,ransomware,3331203,12870,25966,25955,38825,25966
8161,33156fc5e3f04fcdef09246a7ca06a22ad9dd4d96ce01fa1b2528eb349e47342,ransomware,1915509,7167,15096,15379,22546,15096
8162,3316641e5a54107ae5c0c5a483c582242ed4af0956d51bac75f77559c4566cf9,ransomware,1673154,6502,13046,13001,19503,13046
8163,3349e5266f2e8955c96d44462c1acff960a7943dbe78174763975b09679784ae,ransomware,3055084,11873,23908,23789,35662,23908
8164,33b18921e8530cb2aacf6a551b707c4bf127be4441f8a626e63bd272831facf5,ransomware,2308923,8805,18077,18079,26884,18077
8165,33c2583898f9899ebc4ee592165abeab3a6595422e7aa5c18097a2bb139aec20,ransomware,1211266,4504,9472,9625,14129,9472
8166,33c5a7aa562dca917830bddd4923cbed28a6807f885aa501cddc95d30f97903d,ransomware,890476,3412,6926,6923,10335,6926
8167,34470d49c56ddecb53d2b0c2e3f83875507d82fc55209780140b9b4c2a8bb700,ransomware,3194823,12390,24949,24766,37156,24949
8168,34bd372eedf07aabf748d563a1faafb48b82bf249830a0f5c757a17e76fc45ab,ransomware,710710,2731,5548,5536,8267,5548
8169,34cc74cb010f648acfded286e1bcf838bb4c77e248c164ec97bcf64c07c6f34e,ransomware,3155549,12190,24669,24696,36886,24669
8170,35102720e57a03778730e2c370330baecb306a1c265cb437d9f0b1972bbbadbe,ransomware,2801726,10712,21898,21754,32466,21898
8171,3528bee13167b2845cb38e9a7424b05c1578222b197a3f2d86bdbc47bb3e490d,ransomware,3444026,13320,26915,26740,40060,26915
8172,362d4e49ded0484b0f54b9f68891790e01ebcdec80f3d58145311bfefc5274d6,ransomware,879616,3161,7089,7248,10409,7089
8173,3640d091c8e5079fed4b672dc15d85c279947fb5255ce87f3165f4875f8ec6bf,ransomware,3152851,12211,24658,24519,36730,24658
8174,36e8caccacb3a33e96e4b747203c4059d0452a2ff98374cd4f0f6c5e0eabb4b8,ransomware,774171,2852,5966,6368,9220,5966
8175,375875e0261089f2421e9809579336b6ede6f21e6835bbf4fdf80caf5738b6e8,ransomware,652037,2489,5059,5089,7578,5059
8176,37c0252cefd5d3ba554ef21d57750dcb28d8a7c9fa9a57653267e8f4def674df,ransomware,2945192,11349,22949,22899,34248,22949
8177,381cd063f3e2c940a92a8e188da8582e9013a8c343c01de12109c793de28485e,ransomware,1747392,6768,13619,13520,20288,13619
8178,3866f9f66dbdeed124b37202e604ff6de6be544b76424c87288b69538734bdd6,ransomware,1213706,4584,9486,9674,14258,9486
8179,3868ff09b866f31740e78977425951b9ec2e5c1eb1f13d59b93fa2833b2511de,ransomware,635740,2422,4942,4972,7394,4942
8180,386d390584f2e264a1e09272ecbdc0d2cba9507b1b31823684a42e3cae73fa68,ransomware,1341678,5145,10491,10496,15641,10491
8181,38b56d0106ffd672e19bdafb0b379177f6148bdd7ac6746b2c902986dbacc753,ransomware,3481250,13470,27209,27000,40470,27209
8182,38d65a6ca2c1910bbc0c63d0c50a4a3151ff5955d23947b2ed455ed396e6dc98,ransomware,3121360,12032,24424,24336,36368,24424
8183,38ff54670e01642ba1a86af2fd531760be267e9b6e55f28a48b7a589a1d0ab2c,ransomware,2570273,9894,19996,20136,30030,19996
8184,3941211de4f3649d3f9930cba21a08a7ad7b567f12a68eb3baf1e41674d5a2ce,ransomware,2405980,9190,18884,18987,28177,18884
8185,3a19c0edeb3258bf1711a41568d0d983f7ed7e74e7450cb7376d06ea1f2d4671,ransomware,1693853,6503,13301,13313,19816,13301
8186,3a51901392ee137d820da39e85cc409e7cda6528ad5b275249c42773276d50b0,ransomware,2401805,9242,18795,18766,28008,18795
8187,3a9c7fee74ca521638ae01052040192ab3a578b48560e68fcba102a33f2c901e,ransomware,2921073,11318,22898,22733,34051,22898
8188,3acb65a710a4d6219c7185a2731c3331ecfbce597ac1926edd8edc2e79ffb88d,ransomware,1863412,7145,14519,14536,21681,14519
8189,3ae3dacef2a2f67e65550cacb44123f30a6c4487353f940eac7486d933c61f32,ransomware,1414014,5252,11237,11435,16687,11237
8190,3af992ad4d3131618ba6ab622330658897fe71b0316da520ecaa551aee39652f,ransomware,2675458,10398,20950,20863,31261,20950
8191,3b2c9899dbf571528e3816ffd4700b9091bb7e8f56e3d77b1e289777d595b9f7,ransomware,1811400,7024,14225,14454,21478,14225
8192,3b317bd2832b22e77357e83abed93ea352c7ce7402d2335f393f904ce13bac97,ransomware,2359344,9083,18467,18381,27464,18467
8193,3b7953781397d573a7c7171f78db08819605a39db3119122d30e90e820ebddcb,ransomware,2825712,10905,22009,22048,32953,22009
8194,3ba7be7bab5a6ba43db326ea795ff624e18cde2e8b701036d702637ef83cf07d,ransomware,1759918,6761,13726,13802,20563,13726
8195,3bacb5641dc1c8c1c465c51e569d403382ef609cd3649a0d12b9ee4e8e8c5012,ransomware,2366973,9010,18420,18940,27950,18420
8196,3bdb8954ec1a074ad328c8afa3bbed682b6436994ca0212baf7b691af96252da,ransomware,3016269,11561,23595,23597,35158,23595
8197,3c19e3f291a905c3605ce50ee33a5d46d4710be1617b8eecdb9a22396c2cebca,ransomware,2789973,10743,21857,21818,32561,21857
8198,3c36ad957ba10f6b222e01e6ada27a07eb71bb74d87bf28f11aaac452855aad2,ransomware,2982365,11574,23420,23269,34843,23420
8199,3c4bd4360aeb553ff886b2908f38a159a278a854c2c9742e205504c0ac626cda,ransomware,2932439,11325,22840,22737,34062,22840
8200,3c68853e63c4feafe751385dfd3748b4ba3176f319366ff382946173cc07d5f3,ransomware,4056498,15718,31669,31450,47168,31669
8201,3ce8e9c7a42ee83cf2b9e80d960ecd34e12191cd0841b1f1183c24ff3e0f8ab4,ransomware,1160049,4495,9074,9040,13535,9074
8202,3d1899b76221933097317a6fdbd125e677c4303a6350c073df6713d7d1548bd3,ransomware,2482394,9550,19388,19373,28923,19388
8203,3d51da83f31db9800b7006d266e629e7935b9333cb99503764ee64ea2f7016b6,ransomware,2105058,8199,16471,16433,24632,16471
8204,3d75c3af160141e926c3a4e66b4c6d30cfae7fb7d028d0ef8cf9a6ac77548c4e,ransomware,1879614,7205,14664,14649,21854,14664
8205,3d9cb1b36786ba890aae10bc3b3ea4bee9859b9edaaa050bf8581cb221c0464f,ransomware,2897472,11212,22596,22612,33824,22596
8206,3e2ae5cca88599f24cbbefc871309527997d2f744ca30ca6da5269b707add7c1,ransomware,1528960,5873,11850,11879,17752,11850
8207,3e91639b156af9e80c8bb1d82cf4ab4e17bbaeae34df03a2eb20426f81e4036d,ransomware,1809396,7116,14147,14356,21472,14147
8208,3ec061593652c2745522dbfa50a6d2a4657256853bdf10e738319c1f82df6f1e,ransomware,2315386,9017,18142,18002,27019,18142
8209,3f30be7807676abdc66f3b4acddb211d2201c776468e3f120b44bd00550a16eb,ransomware,1458891,5600,11318,11341,16941,11318
8210,3f448e97b6f2d2789e0501175842e7ce02550d024e5ac7731b11a5f3ca577fb5,ransomware,867936,3342,6708,6816,10158,6708
8211,3faccc8123250769c45bdba96032cdcb880150cef30f968ca5c7b00983a396d8,ransomware,664752,2552,5154,5205,7757,5154
8212,3fbf00ab9538d5fed17b04bb6e3a870aa6e3df001a33a32b298b61add468077d,ransomware,1587101,6194,12459,12455,18649,12459
8213,3feb0da99d4b64a3682cec4905251d7545aff51635f27310a0506954aeec5fe5,ransomware,3460392,13389,27023,26894,40283,27023
8214,3ffbaf4b9bd71163f1f67c8447b600cd7df2bcb362574506c7bcfe5510c43660,ransomware,1676946,6441,13173,13168,19609,13173
8215,410cb76fc000b33e71ef33dee1fe6024c13533244c068b23a42098b2d4ef61e9,ransomware,3260225,12667,25494,25319,37986,25494
8216,412737fe58747ddb365a1962e384733ca8387a07c3617610b97cd75c86f882ad,ransomware,1864105,7122,14527,14567,21689,14527
8217,41512f7064d0ea4994e3403e16194d8ac996303f37d70fe43a973742d7cf2997,ransomware,2587821,9896,20257,20419,30315,20257
8218,4190bfd1100c9800f8fdf3eaadafe69bb3450d680d0136d2b430882578ef8e37,ransomware,2514807,9694,19663,19616,29310,19663
8219,41cc0581640654ad03587a365adc0f76f761f4ab1a9a8cb94feb83fb641c0ec3,ransomware,3353486,12991,26202,26046,39037,26202
8220,41ccd6761a2a18924359564d3d20f664224939270158bc155e76969298cb133c,ransomware,2560571,10440,19361,19538,29978,19361
8221,41e62c3416c4b452e6b9186bba65cb4b4445952af5c3e3bc15837c9418a19b75,ransomware,3150552,12198,24674,24545,36743,24674
8222,41f44c4dc6dc14e56eafd05169a60cf2ed3021663f680a0b0cb1fea9a55a8254,ransomware,2384967,9280,18687,18551,27831,18687
8223,41f873f71e495d823df767422e621adaba4ed5526fa37bfcdb18297117756d3f,ransomware,1999545,7439,15673,16118,23557,15673
8224,424c3cf21d28401f6373dd607f40982e15b22993c017645ee4fca58e7e2df3a4,ransomware,2041491,7922,15900,15985,23907,15900
8225,424ec5ff958891688d1ef5f1c1e8de6467e48ef3cce0c4208b95a6c8ee6619cf,ransomware,1886589,7226,14697,14733,21959,14697
8226,42904f36a544d3c3cfcb4bd8c164f62cb6f44d27d14a93a5319b85d836ded42b,ransomware,3120761,12076,24474,24219,36295,24474
8227,429325af71d157012870587da5fb5864a1fb5b41b3870ae942c862d043a7f280,ransomware,3353435,13024,26177,26186,39210,26177
8228,43260bd6529950eb144fa35159a12bd916a01e980841c132651a4632c826c789,ransomware,2700041,10387,21090,21041,31428,21090
8229,437cc98aeeb8ce8c14be2e2365d545d8b5755ebb51c36cdc97b533730e3a3d1a,ransomware,2155638,8143,16810,17200,25343,16810
8230,43b21a15e5ea2f6c169e9b10e254b44c604cb7a840b0b8b48abdc00e919320cb,ransomware,3322649,12884,25945,25819,38703,25945
8231,4477079289fdeac7586eb1ddf92d5d3cc5487e5bfd2b4ab4414d5b1db503a764,ransomware,1605888,6153,12506,12520,18673,12506
8232,4499b9405c983d0ba6ba08aef1b0ff67dc839d3f8039d4049c26af81a15db58a,ransomware,1758669,6820,13715,13638,20458,13715
8233,44ac8acc84456c36af2d436e20ac111660001df669647f8df25ce4888038a4fc,ransomware,1711033,6514,13318,13420,19934,13318
8234,44ee01d9e497c745becfbf59a1352a27e1bf4aa0d7ac9a930cf902d98cd3b591,ransomware,3076796,11942,24037,24081,36023,24037
8235,4543084a12798ffd531badb372618d8bc2fe507466bb0de0fd2f6566cbf6ea06,ransomware,3313334,12863,25919,25741,38604,25919
8236,455748577db1ae065c5faea53fdae956661102b9be76be938bcf02a03e7f6127,ransomware,2427666,9425,19030,19436,28861,19030
8237,455d6aa45f05b32c5077f57c1d00f80d5948714e157ba4f8e344ede42c4dbbea,ransomware,794861,3228,6233,6979,10207,6233
8238,45dc98a814d1bfd4ba7790b607da53678df7c99e3e1747f7ad4f56899e3805e4,ransomware,3351084,12928,26233,26287,39215,26233
8239,466d181857db73bf801f762625d43911d6b538f5c7a1003510f8000cb12e0b0c,ransomware,993262,3844,7780,7825,11669,7780
8240,46806e9dcae686f0c061de42ba2fc168cba2803591af42e1cbd724a055227083,ransomware,1472430,5630,11553,11582,17212,11553
8241,4693b092e52a513a8187f48d09c00006949f4940cd00c38fcc87e5dd58c9955f,ransomware,3003260,11662,23500,23435,35097,23500
8242,46a6db41a9539d9aab67ab625bdbb4bb71533d7bb2e912c8f7dd91c87bf1854f,ransomware,2403040,9246,18789,18784,28030,18789
8243,474962a869ecc6fddf7ce199c3adde6258f7ad8a8c6130f9d62515ab6bbd8a24,ransomware,2402775,9258,18822,18885,28143,18822
8244,47ad6cb76f932756ef8ce624eae0dbd3a2b5226b82c64ffe3396e4dac0fec334,ransomware,2447085,9470,19165,19178,28648,19165
8245,47c30e4550d92bf6ac15d7cc34c7ea94113dc2042658adf2ed3bad2c0e7841f0,ransomware,2338079,9001,18248,18248,27249,18248
8246,47f5f4d3ac61171ef3160398582f6c7f47b162a05723544b8f28263a1164a582,ransomware,2421237,9331,18977,19077,28408,18977
8247,4841b3fda00f1440457a27c3518c81d1192957ad40ae92828ac6e4fda71eeae8,ransomware,2334782,9009,18287,18216,27225,18287
8248,4877e0f82298045afe967ef1f6e225464c3c673e30fb43cb2df580df6d00feea,ransomware,2269525,8687,17741,17855,26542,17741
8249,4891b7f94966accf7fa885a11a4125e997f955754f49ff5490db575bb7832bbc,ransomware,3356546,12936,26163,26087,39023,26163
8250,48add5a73fb76824852eb27e955c9dd47c2606391d5698d5d5efec8ea4db09d1,ransomware,193880,712,1464,1617,2329,1464
8251,48b634d42a8426c5c7e88f63095ec0d5b51ae0492635efa16eff5789a08393be,ransomware,2952732,11929,22599,23370,35299,22599
8252,48db8d3c9b114e7fa946c76d820c9eaa971e484c13bef517fb8834153de31189,ransomware,1910467,7342,14944,14948,22290,14944
8253,48dccb04ec609abd38a4c337015ed36e18e93269ac15342971480dcad17a06e4,ransomware,1198946,4749,9319,9531,14280,9319
8254,48f6a9e1a512591b3a1c10ae3da431a196ea638e1cd0a876a82c4729abb376a2,ransomware,2953929,11534,23131,22966,34500,23131
8255,492990834569fbc24d001bc927b003250da572fd86415a31d1442a5be5a236d5,ransomware,3211179,12429,25086,24896,37325,25086
8256,49b8899a5e1b525e137faa277ba97bfb1fdeb8c00ae6d493f7ab47927092bcb5,ransomware,3088546,11992,24096,24000,35992,24096
8257,4a80b757df074a1eeac1aeee6d2f475b449879b329ee07b6d9b12226591f1408,ransomware,1549819,5990,12076,12114,18104,12076
8258,4acba9666603f5922f4ff7373b19019f590d1198cde5a6f697d635d647fa6c20,ransomware,1118874,4274,8727,8782,13056,8727
8259,4acbd3604393f8514373ab25200b5874e6e2db732473707040c38e2ff33c9735,ransomware,1148826,4496,9015,9705,14201,9015
8260,4ad84d3b6b041346c06a3c81ccc355dfb9d9f8264476ea84e7101d0dd7d64ad8,ransomware,2695373,10386,21112,21021,31407,21112
8261,4b5dda44e655a5d8f142815e502c7d461ac8df87e21f876189112724ffffd58b,ransomware,3034749,11770,23756,23631,35401,23756
8262,4b9e8294c6ff3ed6bfe22e90c228804df6c53c7eae0c619cb1b46e7b326a6043,ransomware,3484775,13492,27231,27061,40553,27231
8263,4c22a9c53aacd193b6ee3c6415980fa1a8a5cf2b100228eed6432b65c204f647,ransomware,2430641,9410,19083,18989,28399,19083
8264,4c922a8c2ba88b451fb834d970f4f5673d04037a99f88e8f79fd0f2b31bf99df,ransomware,2479076,9558,19295,19249,28807,19295
8265,4ca0ed6ee37bb9b4c9a8f950e99701ff9cc4bf33844f014525c2aa7a91f53849,ransomware,2423304,9244,19156,19227,28471,19156
8266,4cc35bd9e603cb6abbc4c142ac585ee4f41f371a485f7283f0bd8b31f4fe6c48,ransomware,2937618,11349,22892,22778,34127,22892
8267,4cc3a728f5cedcad6291149c9c879d9b98ffb62557dbbcba193c2ebb0e2d08f7,ransomware,2278338,8681,17811,18189,26870,17811
8268,4d6fb06f48532443e1ae18fd05693d8ffb584e42831e80ea940275b63a5258c3,ransomware,1552864,5948,12033,12033,17981,12033
8269,4d98ed287d3de373f4dd92003ee3cdfd10ad311272c591f1064c836ada73da4e,ransomware,3480736,13478,27162,27035,40513,27162
8270,4da24df67caa654774377d072126d407aeb20aed88cfcb4d72797ffc5a0fcb04,ransomware,2058249,7864,16057,16157,24021,16057
8271,4e38d066604d5539d801e2d16aa28925db5fcd4d210a6bfb29fec75feeed54f0,ransomware,1614714,6100,12674,12927,19027,12674
8272,4e3ffb478593267ffb6e455fa59b0feb75875c8bbc26368ffed264542940351a,ransomware,1616078,6591,12860,13179,19770,12860
8273,4e41b68c5b9587aaead7859e991d3aaf67e9ba0b7408d52ab9d4776e95487d4f,ransomware,3396537,13175,26539,26520,39695,26539
8274,4e8fbbf57278c7eef8dd0ebd9f1de41906c206a58a5788acdfd2f69725cf3869,ransomware,2764058,10545,21718,21782,32327,21718
8275,4e961fd26f221152e4489d76ffa2bfa1d14946b420feed409fd9b0cfce55ee86,ransomware,1302375,5004,10146,10194,15198,10146
8276,4f20583bafc780c97ce95607dad2f869a37d7667c29d0151039f73c05e20dea4,ransomware,2450303,9436,19029,19087,28523,19029
8277,4f418fa2d23be76712a0ba2a95c2ec7269bace3647272b819a98c159280905e9,ransomware,3177442,12301,24781,24769,37070,24781
8278,5017c9c48528425abbcef60bae5e21315510acae6cbbeca2174b8a088fe39f51,ransomware,1414362,5436,10983,11008,16444,10983
8279,504e3c7caf8e1204d10b55e30f9a9eb17d8acb55ce38e56423775fdbb289a8c9,ransomware,124965,452,957,1002,1454,957
8280,50b3d81640747f87b2a2850581e068e1bc77f9279e890cb679996f3a930f891a,ransomware,2172205,8379,16995,17046,25425,16995
8281,50f51e08180220f9a278394b240bca2a9f08005dd7f4731de77660c5775add36,ransomware,3051957,11761,23775,23782,35543,23775
8282,51027357023efc7ddba6acc6bfdf1f2bfa0748fbf37457e62d689500c10a438e,ransomware,2187483,8427,17062,17023,25450,17062
8283,513e92979cc1eebbfe17e9d963fd152f49e44f9ca8144935d15fcffa18a1babc,ransomware,438385,1695,3419,3461,5156,3419
8284,51526c8b491d7adaf5c583b56db21d249963e153f7f5891746dc521ea0352921,ransomware,2597057,9964,20305,20555,30519,20305
8285,5194c5292bf61bed438930bdbf7dfcb7b5e80303c104df8b9609e8e2b8f1078b,ransomware,3443234,13317,26896,26744,40061,26896
8286,51be6b9d0bbf497a180d91e0a3b2c6ad9a685d460065bf7e78602794e5353600,ransomware,2050904,7826,16024,16113,23939,16024
8287,51eebc6ca132ab531be47d1890bf4d692d4ee15df5e0cec637b756e3ed2e1099,ransomware,3039484,11731,23741,23635,35366,23741
8288,526e155f9039c409eccf69814245e3c35aa4d11632ee8d5cb5e6de75e620fa9e,ransomware,1434300,5518,11141,11126,16644,11141
8289,526eb6113b2b9036c8a5d3c4298ced468280d71adfab30cc7e1027f1c591399d,ransomware,1834531,7034,14274,14386,21420,14274
8290,52f9143ce95e54868db13216866a95a4bf54cf5f504f965ddd6412589445da02,ransomware,2109206,8086,16462,16464,24550,16462
8291,53288dc570a3a9fc4247bfbfd63b0ace32055191f46f6ac387a9b421c0bf0891,ransomware,3390952,13127,26476,26409,39536,26476
8292,533d40db6df861f72de31710c6143ee72986c05ef516b16b5294d194e7ad2487,ransomware,3194697,12335,24941,24889,37224,24941
8293,541fe667a6d332e0a25adeb1395370bd805320cd60282adf138b19e502401300,ransomware,2871586,11123,22447,22400,33523,22447
8294,54459745697621e84cc534a9ef85834f196e812dc990794a4d0381b92c184244,ransomware,2126285,8200,16792,16753,24953,16792
8295,54699663abace8c4be91c32cc1075fcd3784711df12407dd8664e5102e10004a,ransomware,3327441,12560,26228,26816,39376,26228
8296,5488097a6cf11bce1888618815bb97e321e8f098f34fad2e2282092ce590703c,ransomware,3484775,13508,27234,27069,40577,27234
8297,54b2ca2b129aeb1984ae26d0bb3ba4cef83477f0c182aaabaf4a52c14657779f,ransomware,2528180,9814,19835,19659,29473,19835
8298,55c140f57d293385f880c1cd259adba8dec8b611881b28e463eb5496b54a7e91,ransomware,3182562,12329,24876,24731,37060,24876
8299,55e662a0025a7b35fb08445726b3ebc1b9456afda6dff0e6d3d2f717ec147f03,ransomware,2601523,10094,20472,20246,30340,20472
8300,5626b1bdb36c077ec6a626712d2328e643a77c62fbdbfe35bee2f5f63ddac501,ransomware,975487,3684,7617,7739,11423,7617
8301,5636613f6aec9bad6813cfc991c9049cece0ab3047bf61b939e0e09a3c99c056,ransomware,3252032,12537,25421,25375,37912,25421
8302,5697df65f5b2146aa91097d6608fe28914430ca5bb81f31bf97580d625186ced,ransomware,1775042,6875,13837,13777,20652,13837
8303,56f8ced8ff3223a177d19f1398d2876e8fb8ff0a43e1b648554e2f8caead352b,ransomware,1139159,4365,8874,8949,13314,8874
8304,57305003ebcf0eceecd95e1580fa6de92c5ef9e8b2bdee54cccdcc2aba439161,ransomware,3098828,11949,24085,24231,36180,24085
8305,574835b083cc6e7bc0ae280fbe09310d716c373d91332bb4ea092d263e3fa850,ransomware,2478015,9526,19346,19346,28872,19346
8306,574a9cb25c697db64c7989f05c74fc013425875541aaecb03532cbac0dda6c75,ransomware,3451445,13360,26957,26817,40177,26957
8307,5752c92145d4f4b472c6a28ce95026cf07a1878d1d16edd4f1541df7370a6ecf,ransomware,3097639,12006,24205,24149,36155,24205
8308,5776639e8bfdc83f1812be159b829c2b2f12c828f5f3da8d915f2cd837a54200,ransomware,555245,2108,4470,4800,6908,4470
8309,589fd24e36218bb65db884491805080a128082f73da38aa8cdc9123e4600980f,ransomware,3484362,13488,27217,27049,40537,27217
8310,58bcd7f80e4ca5f5b38f3439d348bed5c709cc74b15a6be8a71416b38b773f0c,ransomware,2782020,10786,21644,21618,32404,21644
8311,58dd20a625dbab7d15459c0148ef9d791ba1cb5bd8f25c05ff72b52915423c14,ransomware,2033216,7924,15993,15779,23703,15993
8312,590a5fd8d9e4b9ce527b03c7702eb17ed0bfe6644cb4880e5e0351237af76ba2,ransomware,2196701,8458,17108,17059,25517,17108
8313,595734f89ec874625c6f696f0607b52379e537bab1695f7bd204619befaaaf19,ransomware,2152077,8282,16734,16669,24951,16734
8314,59962b4dad3eaacadf54d582657bda0d1139d86077b5310a519393faa69ecd20,ransomware,226304,877,1621,1824,2701,1621
8315,5a0a70789a41a7d18cc82b7c4dd8a5efed9a4e4dc588a7b6e3bdd8ec2d4f95a2,ransomware,3480739,13478,27212,27029,40507,27212
8316,5a61e29188aad312441e48258cdd45e27a82733053f66115af76e496dd316430,ransomware,2076450,7905,16082,16529,24434,16082
8317,5a9d52d85fe9e54245327aef2f11514bc443fb4b469cd6dfb2b4d5f44841c2b1,ransomware,2533570,9742,19779,19759,29501,19779
8318,5aa12999f2c490fe19945cb06d5de9108e034a016b1d4b70de6492a2aa34f372,ransomware,2324231,9000,18176,18192,27192,18176
8319,5aacbf97984cfd0b724982bafdb06642a4364600855f195d7a12edf232b3cb01,ransomware,2573348,9914,20143,20125,30039,20143
8320,5ad7aaa402afedcd1eeb2c3ef8d327392b2ab488730abae12bf0d6274c9bca45,ransomware,2200181,8303,17318,17533,25836,17318
8321,5ae9a4655cf63779f804d42fd23542678cd38ca268ab602dfaf73062177a2a88,ransomware,1918973,7314,14948,15279,22593,14948
8322,5b14c92bc3988cae837f419a67660b6f9275269ef9a3c043136cfde2113ea7df,ransomware,3472916,13474,27301,27160,40634,27301
8323,5b280fdc7c647b9b2085b85e2f80e6ca5bebd14ba17f6e77d016cd911571f387,ransomware,2870487,11102,22410,22382,33484,22410
8324,5bb193997dd08b6b554b8702af41c5dbe0dc8ec53b71f53f5e04fdf8e574c24c,ransomware,2801575,10886,21896,21830,32716,21896
8325,5bd7c4c88bc4f604d77670c970de87eb619dfcd9cfdb29ea7b170af25232ed41,ransomware,2528185,9798,19704,19573,29371,19704
8326,5c591d12fdd60f7e7ec62bec1d1f0e250b20376fb61e22cf9a3be17b56bc2da4,ransomware,3219213,12508,25212,24978,37486,25212
8327,5c9e87da1c86135ec54c8ede1e05b6ed60ad6ade2bf91301be564c909a20018c,ransomware,2728891,10630,21432,21447,32077,21432
8328,5d10541ef054afb9a4b196e568a05f1504de86d6178ffaf89d150acc5d0b3ebc,ransomware,2885222,11093,22560,22401,33494,22560
8329,5d5597a4d885bcc18be133a851a1eec4929e233be56d28920335aaa9ef605177,ransomware,2336226,9027,18301,18231,27258,18301
8330,5d6c1d88e928d352223c633d2662d9b2a2a47cbf9c15ee1ea86d0acbabc0b972,ransomware,3452182,13360,26921,26793,40153,26921
8331,5d82c746e7a8b3e4c85a63942ce825a6f80fa7b06e0eccab24cb9c7d706b2e7d,ransomware,2509997,9581,19627,19782,29363,19627
8332,5dcf3adc6fcbaa16f35b7457a74b8ce92d9f1553af5a74e943028ddbf9679210,ransomware,2784441,10686,21726,21848,32534,21726
8333,5dd8d72b9a9935193630a23ca142cbafa35486dae6705db32d582e4256a5ad42,ransomware,2463457,9345,19259,19413,28758,19259
8334,5de763ba0ed32503406fe0188755a2b34afcb8c924d3ba6ffa36571182d6aaeb,ransomware,936435,3638,7275,7334,10972,7275
8335,5e359baa2ebbd89a7d2ecdee8004381e4bd1dfb6787572e4204bcaac83538783,ransomware,3162128,12255,24760,24616,36871,24760
8336,5e3c727e2010faad7e5cd4ffc72ed3a57d768cc35212cb134c3ce3540f8a9608,ransomware,3416242,13255,26682,26651,39906,26682
8337,5e4d87118c5590a398119474639d90d9b2ca9b17e20725c68216052fef80c00b,ransomware,2199974,8583,17209,17775,26358,17209
8338,5e9755c4beedd2ef6b589be79e12481adc152cd1d160d036566e524666da3eba,ransomware,2149471,8331,16788,17382,25713,16788
8339,5ee14add7ef658c1dc716f0188c6211225edb3444b361cf25b63f3a37140d07d,ransomware,2788430,10913,21612,21872,32785,21612
8340,5f384c60c8f1c9f431b847ca65a867484b53180d8145445ae205885e932a0d31,ransomware,2714901,10362,21378,21334,31696,21378
8341,5f5de724855c2cd9bf55a9b2071fc45f1c2cd817c512bb4310b348d440e0511a,ransomware,3484775,13485,27240,27053,40538,27240
8342,5fe362c68f8e8291bc8fce644c0673e15cdd1e4e27a6a8e3212248d24a73a5d5,ransomware,2912392,11283,22772,22706,33989,22772
8343,5fe9f98c4e21e8e8c481ee1d2d0adceee3f825bb87d26f0691dc0b210bfb1eeb,ransomware,3484775,13490,27231,27058,40548,27231
8344,605f7c9fcf086dc25a60db62b7370a6ac5297bc0ec3705f9ea4086ab90b9beca,ransomware,3145970,12141,24642,24443,36584,24642
8345,6077ab219b4e860c1a1a49f0f63e47e8ec3753df61ef5b216a6ebe5ce79d7ee6,ransomware,2598715,9920,20351,20428,30348,20351
8346,607809f56afa30854dbc2ca65ad5be113c1c205467cfd02ca33c70da61818bf4,ransomware,3026236,11720,23656,23576,35296,23656
8347,607d4dcc0fc140e88e99e314967d26b2858ed49aaf70bfa180eb91606f168c95,ransomware,2483722,9451,19663,19701,29152,19663
8348,60dc45c2b4c2fc9ba464d41317cc7b3cec8761237f13260fed84b7291799670f,ransomware,1973029,7553,15377,15346,22899,15377
8349,60dcaa4012a5f8aede4bd012a5709e3b778d112e3f06ac1c4736b55d93dd688f,ransomware,3323413,12880,25956,25887,38767,25956
8350,614b0af20c2c85d82d5236365b9e615cbe5ff81f30168838a75a767cafceabf5,ransomware,1831513,6992,14470,14550,21542,14470
8351,61752d1bcc9ba1b755e3e5b8739698aab1a36762a2bc1bed9acad416e984a1eb,ransomware,3238744,12512,25316,25234,37746,25316
8352,6197fb71542e689d0f6526363983c0e3186b406fd931a0b0ed5f6f372121d205,ransomware,2476158,9527,19379,19347,28874,19379
8353,61d878b7864525cb0c9949d5bde9fcdb4ed6f1683302be3c46aea7279a07c1b7,ransomware,3377991,13062,26403,26227,39289,26403
8354,61e8653e70d6d415ad779309c9a991fd76255627db35592352b583e00125de63,ransomware,2920872,11261,22664,22688,33949,22664
8355,61f76f1fb98d724ff7d75c35e9d0c094dc1eb5f29cba89faecd9b7c888833757,ransomware,2654951,10367,20866,20782,31149,20866
8356,62349b3bd675f9c2ccd86bdd64f37730f4408adbe4be22c08cd1c5d6f7b3e040,ransomware,3015463,11664,23553,23580,35244,23553
8357,6236266460e3debdc506aaf1ae69a5f87f7cd074c78a0fa7738a2558ef8ef5ad,ransomware,2875723,11093,22480,22351,33444,22480
8358,62b5780854e45a2cb9570d2f6be0ac058778a1472f7adb53cd0c0966c923357d,ransomware,2402651,9329,18856,19182,28511,18856
8359,62d25e690287bb9411a2eb1afb1dd4f5c854e5e7c47f1b28ad02962e41dcde9e,ransomware,2450082,9517,19185,19480,28997,19185
8360,6353e0e343376727509e08c6a49d7902a0cd2ec1adff935c6135e1fc3379ae81,ransomware,1710462,6499,13251,13279,19778,13251
8361,637b2a1865d52951edf613700c004786224f1223f18b423f96e28cbd8c6303b3,ransomware,2081465,7948,16222,16371,24319,16222
8362,63d2f48702fe78351146342eb9771896e2b299c5db6698508062d123cb19d93b,ransomware,3483609,13497,27267,27029,40526,27267
8363,641b04a99beaae7f6c821dabeb7269e6f2725ece1fa42cdc89163f671c07ec6e,ransomware,1475248,5658,11433,11465,17123,11433
8364,6420c8126390872334c6914a8d8d96e4c116440e8152250efca35ca28d775189,ransomware,2360398,9162,18486,18376,27538,18486
8365,642696180b35ba0764fff837c2be0d095c46128fd35db53f521dbaa03a8d7bb2,ransomware,2819822,10931,22161,21924,32855,22161
8366,6439fbc22cfa31a856db339c648b9e4611ff7f4bf3bbffbf09465d5e1fb7b369,ransomware,1067308,4057,8326,8343,12400,8326
8367,643a94184ef6ddd8b6da052792670ca64bb61050e1450d032acf7611b683dfa1,ransomware,1934496,7426,15146,15119,22545,15146
8368,64782cca634e0ab624fda8e0abfe7a7e58982c43efaab6bb87e557421e3c81fc,ransomware,3456274,13380,27023,26809,40189,27023
8369,64dc744f8ed37805395a2fe35e32ea93af1ce71ac723b1baa86572c768224381,ransomware,3186646,12381,24906,24748,37129,24906
8370,6515832c2cc68f20127ee08231f0f7f145dbbfed5309b1e9ab4aff7c5be22817,ransomware,3327966,12806,26116,25918,38724,26116
8371,6535d4b7abffe47884b630217d63d0c999a02dcd30b7ee4fec6741ae78e8ef61,ransomware,2782250,10741,21747,21550,32291,21747
8372,658821db0f3790903d353744ee77d8a5f115e1c4e68a969f72b771a0c99c88c7,ransomware,2308058,8745,18165,18196,26941,18165
8373,65a466fa40165ad2fae58b18453da51aed334275bb8805351664ca6f017420ad,ransomware,2127056,8263,16671,16584,24847,16671
8374,65c6a09640ab43dd2829b904df5993d1e9b07c94003645992ea854174ab6fdf6,ransomware,2592290,9986,20268,20209,30195,20268
8375,65fbfe2b11a1460724d2f84792560285247d1548e2ceb7cc6fb475c2415c6bee,ransomware,1902079,7359,14854,15590,22949,14854
8376,6600eae7fe686e1006578406902b6b0ad922762b2fb1aedfe2c2d545f88d8f09,ransomware,1958467,7507,15414,15303,22810,15414
8377,661fdc4e5073b6cbfc700844c8612d24ab599ca59c6df3b642fb0968bf469892,ransomware,1871114,7228,14785,14676,21904,14785
8378,66303994149c3757fb0e27cfb02553d0ac6f3bdba2334c9821f59088f6715f86,ransomware,3038821,11784,23773,23664,35448,23773
8379,663a37d4a1b260f1c32d359b48b253f01ee3628697f062cbc7c2ed9f9a63e5e2,ransomware,1206495,4616,9373,9444,14060,9373
8380,668e5c63d6e7e96f49cf0ed6fd3c3adb11101faf4456fedfcbaad6d4c9ec6240,ransomware,728926,2799,5640,5761,8560,5640
8381,66a9cf8ea933ca83ef7e44af8b9ad26a8591b5c956c6d8cb2fcb571148eae5c1,ransomware,2524196,9705,19781,19742,29447,19781
8382,66c280c1fc0897db745799328b7ecccb01649014a903c616c8458a57fc4b27ee,ransomware,3309294,12784,25958,25588,38372,25958
8383,66cc2a01cce21da0fa39591f9fe2ab0b81ce85c20aef7db83c139122f7c89b7e,ransomware,569353,2183,4444,4479,6662,4444
8384,66df2e647b2f3abf3c01be52f977f6dba49a7dbb899c925dc9d1eac253da60db,ransomware,2677442,10406,20973,20848,31254,20973
8385,66f6b81a9ff57316c4415ec26c51aad429242dfa7545da1e42da22d5b7abc0bf,ransomware,3215643,12442,25146,25043,37485,25146
8386,6709fc456d4c506d81043a1c8119d5384673d038467566961647831bd513b988,ransomware,3329776,12904,25991,25822,38726,25991
8387,679e0bdd9cc28348d29564a718ebcf58f99ea34752ee0938711aae98bd9643a3,ransomware,749225,2819,6040,5928,8747,6040
8388,67a494fd35d652ebf5082fe1164835f9067f2291febad6910f83b3d264b55610,ransomware,3426723,13227,26825,26652,39879,26825
8389,67aa758443fdc9b16bf337801db0f6919197242cc6ff902fef0e9556439d5a87,ransomware,1172145,4487,9127,9081,13568,9127
8390,67cb5cbdec36c0cd541a5b6c462d46352653f801a527ba7b5ce936c9f8c756f9,ransomware,2139596,8211,16654,16630,24841,16654
8391,67ebe1cf90608f203b22332ccb53d00050d8f91ccf69757ae31de6db2097c8f6,ransomware,2270713,8743,17717,17716,26459,17717
8392,681701220a5ef76cdc0685e20a3e56d2152cc832f408cf6390f18da27f8999a5,ransomware,2223112,8489,17489,17730,26219,17489
8393,685d80b5ac122d072ed7212ecf09d29fea49d948fd61cb951b48d65260e77d37,ransomware,866329,3271,6782,6809,10080,6782
8394,68cd5847d3fa84fc758288ab2463eca9449d406ce66e87dc7e86cc9cc444b5a6,ransomware,2168214,8285,16954,16925,25210,16954
8395,69143dbe806a91a2979d521d3b12d21bd650b88a2855ea73f3d274d693bb04c3,ransomware,1605307,6189,12566,12825,19014,12566
8396,69496776a7d807976233766c3cd190656ad4a9090b423f76ce72ca873cd1dbff,ransomware,2271009,8767,17687,17796,26563,17687
8397,695497693b99af200f7bcd335afd3979b33b87794d1c960f66ed32672b9ba615,ransomware,1925513,7399,14997,14998,22397,14997
8398,6a0bd98e7169cfc4c01942c0ba82bfeef77531ff42da26d1612e72847ce8137d,ransomware,1902001,7277,14731,14743,22020,14731
8399,6a0fd21350c4d5eb33dc69f62560dec2a7e14f3bc6128f9637a78803c45cf8c3,ransomware,2945427,11391,23020,22857,34248,23020
8400,6a245635ee16bd7f3fe6c19f57d9de5e4b24d3ed2713ac56c8385d83996e781c,ransomware,3399177,13162,26586,26326,39488,26586
8401,6a775b8f416953c657199404240a18bd3a2fbdee51dc7ed545a1a866865cee39,ransomware,3137598,12122,24526,24323,36445,24526
8402,6a8a408a1e2011c08d740e3542c99914787b959d4e5b84a9a1edcb089aa45290,ransomware,2568326,9775,20218,20303,30078,20218
8403,6a9a90b368ada11a10f9d4adead4eefd44efc37ef33a0d71143a39ca67b8d6e2,ransomware,3298028,12746,25772,25695,38441,25772
8404,6ab178c555fc5effda069ff30e0cf5c9c41b171634b4851ac8816bf1a25daba4,ransomware,1897213,7246,14791,14809,22055,14791
8405,6acf75d138ce9b3f0e6220dbc5b483181c94c386128841a5cde2dc5c927659cd,ransomware,3370565,13039,26336,26370,39409,26336
8406,6b2656cfb71edd48e0d4f11f1ffc84a0ac74fdf462620f7aec9bcc6fd33dfc18,ransomware,2557782,9702,20155,20301,30003,20155
8407,6b64090f7695103c76d9fcd18f4354decd1ae2625a216dc270044ffc7ed0d93d,ransomware,2428642,9344,18982,18956,28300,18982
8408,6b718ebc3fd5004128df528a0a2479dda7427c30ff66c49136e7ded5ce1f85bc,ransomware,2440433,9316,19167,19372,28688,19167
8409,6b8c9927994145c1abeb163a3ba643890e879efc822c33199287e12b0f060b03,ransomware,2134735,8197,16671,16627,24824,16671
8410,6b8de9f2b6c4ee49a326307581bd8cbce1f638130a9f408b63be18f851bbb0aa,ransomware,3481975,13489,27266,27104,40593,27266
8411,6ba64be2a339b2ebfabf3846786db1889a4d6bf1f875408324a00d88d5bdb392,ransomware,1110774,4297,8720,9272,13569,8720
8412,6be775e354fef6f83653a7735bb2a714eb9256a9105ecc095354de7ff1f53eff,ransomware,1996316,7456,15648,16079,23535,15648
8413,6c46f6c3c398e930fe32c051cb8a2fb4d3997bf5e845c5e359d8172750642fca,ransomware,3365627,12993,26263,26181,39174,26263
8414,6c5026ee8982655e0c981cbcb112a9b131289e06a2399161ff504ee9544e96e0,ransomware,3402176,13146,26572,26424,39570,26572
8415,6cbe04846b8069a4c4239a2286bfa6fad237495ac67724d227206aff7312e9f4,ransomware,3354197,13019,26220,26049,39068,26220
8416,6de21b4029db17e773b13e4599964f35b03f4feb3a2ec211562eba6ab8a00b53,ransomware,3388150,12998,26522,26624,39622,26522
8417,6e650c04b494edf9dc04449070e48bbe511d902c9e2ab135aa52772eeffaf43c,ransomware,343362,1321,2606,2715,4036,2606
8418,6ead93eea8539c6a6483637c3714997fb0d62435e5104af6846924476b71982c,ransomware,3366445,13003,26317,26125,39128,26317
8419,6f3cc41014f7586007c8a1ced92cc9470a6d4ce0faa858845c6d3f1d809d2027,ransomware,3051755,11743,23899,23749,35492,23899
8420,6f7ca7b3240704019e25e5700fc449bfcc5affcea116e71e2c211f00686d7f36,ransomware,1825439,7024,14292,14378,21402,14292
8421,6f951e5f4d809438435a249f81f83e3d9c70f2528491d0c5d8deae5ce1fe35af,ransomware,3472918,13318,27150,27610,40928,27150
8422,6fb8ae5370ce45509a503dd9443a49a5b2008ec388ae5fe6d99d423693ce427c,ransomware,1993660,7653,15544,15441,23094,15544
8423,6fea2330300dc1397dc28242cc77e031979c08291110551cd8533b6a9b194f26,ransomware,3023023,11668,23629,23559,35227,23629
8424,705df6507e0d9b8cb1d3928b04823660c935cf6b855dbe5622e18b8295dec180,ransomware,3357817,12978,26223,26098,39076,26223
8425,711d3923b52755cc0703af27c140a1905f06f415d78db85191c106a78d0f93c5,ransomware,2177369,8378,16986,16912,25290,16986
8426,7131b8b664d85a109569be7e29233ea3f2664b175471fe2cd2d70a3e27653870,ransomware,3390954,13146,26489,26333,39479,26489
8427,724f9f67c503ad7ae59bb3ebd865352ad094007b8afed46795aa9c502f35b957,ransomware,2856900,10935,22352,22320,33255,22352
8428,725d5fc992122d1426b40499bd761e92849529501b2a90f88f5580ed12ec573d,ransomware,2671882,10292,20930,20843,31135,20930
8429,728baf8313186b1ce6292b02a0a1a10ed4bfc79c7362486fc11e4ff454476ab2,ransomware,771718,2995,6041,5898,8893,6041
8430,729a07f3e17306b1efe9cce36594fc5b602782ddfbe56efa3a29dde7bb2d53f5,ransomware,1852031,7089,14399,14572,21661,14399
8431,72b5d21f20036784d3b6b1538e998b10b16cae63c0338c9bc44bb002233a941b,ransomware,1962000,7525,15269,15263,22788,15269
8432,72b6cdb4d9a9da376d8ed096386a75e187432cb03b36f41fcfb3cb2cd19e5189,ransomware,1100989,4291,8535,8745,13036,8535
8433,72db3d53237c7c16311b544b32e82bdb9c0cccc1c3bf6d1d18dfde65c731eb9b,ransomware,3207820,12380,25163,24919,37299,25163
8434,73cf4bdaba4f885584978f940ed2386846e62fe686fcb4bf44081cba59d24f79,ransomware,3480737,13477,27210,27014,40491,27210
8435,7407c59504cf3969b9abd1c6853a4bfbdecc86dd50ef4a878467730f821649f0,ransomware,1825431,7038,14185,14207,21245,14185
8436,74577239470a22d95bd8b6eae6779eec34fdd161a2eb761d01da44c6a3e753f4,ransomware,3464432,13404,27090,26943,40347,27090
8437,7475a1d6c1b538da68750f5820dcd0c194f5500462e6903efb2e6d64c2c08b1b,ransomware,1941105,7376,15111,15416,22792,15111
8438,75bf192777ada637018312202854b8a4435f7d92115fd76d697eacc761eb3f0e,ransomware,1895122,7296,14744,14807,22103,14744
8439,75f2e5d3e43f3372d94a525ef96cf8f82568093679f7120ac68e49dc68d0e91e,ransomware,3353857,12954,26198,26069,39023,26198
8440,75fee6fd0f9a3085c148ef004687f592ca21132833946719a0514c0741a1312a,ransomware,2547534,9803,19892,19920,29723,19892
8441,76a833d939add5b1d6d306afd5d26482961b091e1e54e21ee26adeaa62e2fd47,ransomware,3406161,13180,26608,26468,39648,26608
8442,771c00d80bb19f03847b3d1c0c2157ec37892ecb12d5c42208af7f3189dda363,ransomware,2073534,7947,16148,16129,24076,16148
8443,77360fcff104f83c142f48a7ccca62c0a5742538be98618da5d88d7e2b1e89d0,ransomware,2315074,8900,17937,18328,27228,17937
8444,7788a865a17d1d82402125ff147de0c5bfa0dd0ff044ebe75bd6616c02a8a7d2,ransomware,2470898,9566,19224,19164,28730,19224
8445,779cbe0ee7b4d7094cab334666e2b6ea995122c600d52f08aa60b63c7cdaa363,ransomware,3452187,13358,26974,26829,40187,26974
8446,77e9daf0734c709e7a8509271ee4030b7b1b8f19304276175e45997a4bdb0510,ransomware,2601840,10064,20375,20246,30310,20375
8447,783808fb8f8714d7d4f59384bcf60be835731d87781883b1b08adc8b674e2781,ransomware,2532488,9823,19820,19739,29562,19820
8448,78602c488744f183c91a36cd5a0a216a1e16b29028dc387fedf4392d0e35e860,ransomware,3099947,12055,24238,24324,36379,24238
8449,7917c4455d96bf4fe547bb1f3bf1b3e7a1a8c26bfead44fec6b049730cc9c3bd,ransomware,3391025,13104,26444,26341,39445,26444
8450,7947aeafdebfa29c57358d39552025ff558b67dae7890f060ad07545cc192e31,ransomware,2696358,10472,21115,20917,31389,21115
8451,7977e5e1ff6acd863a18ab9167f7f425fd6d1ac2330cc2c692d2c9efc17296b5,ransomware,2253023,8748,17542,17525,26273,17542
8452,79852b23fe61892833713db1db2eb2485e538e4b85fda3cb5a7b56342e375946,ransomware,1897919,7372,14696,15478,22850,14696
8453,79b151a8e231ad1f50d35fd581884fa7974535b7d0836386afd82fb3ee1c98a2,ransomware,2642062,10242,20614,20558,30800,20614
8454,7a34b0387b5dcb7066a56e1d568a3d8e8b26aeb8be354b6e645e3e86c372f60a,ransomware,300698,1166,2302,2406,3572,2302
8455,7a515968c18102f5fa2d66573e94dc0d18745d9c5abd5781d80bec9b47960295,ransomware,1755799,6937,13839,14052,20989,13839
8456,7a792b5dfeaaac7c2fc5df6f9dfe2ddc499a831f0991ff0e363c4ba737a6cdc2,ransomware,1538834,5789,12112,12330,18119,12112
8457,7a7b3876df3b74b8117fa964bc0cc6ed5039a8826978e48f832ca845ae47c801,ransomware,864197,3291,6739,6747,10038,6739
8458,7aee516ff0cab2bcdedec8693010e7caf8925cefb6735cf3277f27e464ea2dff,ransomware,2284382,8693,17759,18026,26719,17759
8459,7af6d72ebd6758b2f20f67514964c19daf7d15e7865e70cd37615855366fefc6,ransomware,2879902,11112,22413,22315,33427,22413
8460,7b6b45000ae901d633e9dbfcf8e597323f52c0a21f9872877400cbccad813980,ransomware,2633091,10156,20591,20482,30638,20591
8461,7bf932b5d8bc574b05d49e15117df168251495bdec9bc8c1010c64cf4e542cc7,ransomware,3014314,11661,23591,23480,35141,23591
8462,7c2f8c7e15d8245b5a417c7edc4893296046059ab0fe8995a116de494df3d35a,ransomware,3301080,12803,25763,25657,38460,25763
8463,7c3abb784500d7e818f4877491e8a95a96b0d9c7c9dfb2f728dc2e57e087b4cf,ransomware,3712995,14243,29205,31712,45955,29205
8464,7ca536e4a9bbb16869a72570dd5f7e8e31a512266d7b0f71870035ac298ffedb,ransomware,3157134,12218,24715,24609,36827,24715
8465,7cf4c7182901b37b6b7f1006d18d9e32b7faf0190039e0d9a81a277f142f146d,ransomware,1804146,7590,14371,15181,22771,14371
8466,7cf5ff1de20a20bc122b4c87401e2a2dd1b1fa652b52d42d3dea6b0f8c63031a,ransomware,1980657,7462,15557,15940,23402,15557
8467,7d88d7742bbdec7d3d196a6580e078de1c19767f7df1f33518b9ea50fae69077,ransomware,3071047,11890,23981,23912,35802,23981
8468,7da9bfbbfc61e184ac65df22a924ffbe3e7d2b7f8a489bc34461fda9eb03a0a3,ransomware,3431577,13280,26837,26690,39970,26837
8469,7dc072f50fa3abeb78420cb2aeeb1eae02cdb8e0a4b2f9d9816eb9ace9815365,ransomware,2371217,9139,18537,18492,27631,18537
8470,7de09b862adb39cbb1f34e55508fd8022a046205b7de7a16265802a42a12b46a,ransomware,3297111,12708,25888,25600,38308,25888
8471,7e04b190fe946bbabbfe898e7fa8c66d017d387315f77992a82769fa01d1835c,ransomware,1473625,5680,11534,11539,17219,11534
8472,7e06667842004105198db97674072383d4c0d42cd501a74301e427946e7b2cb0,ransomware,1346339,5181,10450,10444,15625,10450
8473,7e0f59c7153a0efd4e17f1589267ede63817c8659ba3ccad01b9ae24d2365620,ransomware,2892788,11000,22101,22638,33638,22101
8474,7e3ce6c1889312c80a14e526b7cd7d4a441e52a7ae0e9a024e809820a2f413d0,ransomware,3153950,12229,24655,24514,36743,24655
8475,7e43d2acb3aa31df2fd3de3a72abe3412d02b7dc4fcf3f90cb667666f72c1212,ransomware,3314636,12776,25890,25727,38503,25890
8476,7e98de00ef805aaa254417b1bd975c6d8d44d0b400145c92b5a7750ead04907a,ransomware,632564,2091,5305,5828,7919,5305
8477,7eba872549489f387d82f3bb41a5d521f99a3e5778699f75aff76eb4b8740f1a,ransomware,3481847,13480,27189,27044,40524,27189
8478,7ec60661ee1927f6f7e418c7d59b44f26b0e856f4f0c5722cf5a3ef11ddb9b95,ransomware,3484775,13492,27231,27061,40553,27231
8479,7ed0b8aa20dd4bab9f9450e7c2db1d5e2104a4a0c4fbe606cc97bf4aedf68c99,ransomware,3484775,13492,27231,27061,40553,27231
8480,7f1ad3d414227fc92abbbfbdd37589afcb851fdad5e8df66653d1442bea6637c,ransomware,752961,2891,5879,5927,8818,5879
8481,7f3d86146a0c90a68dcc9e7f29e348c865e2a80b282b5f4f4e8fd4029b85d60d,ransomware,3177098,12285,24871,24723,37008,24871
8482,7f46e1343c563168fa78819a71854b00356dc1363018003000448c0bedccfdb1,ransomware,1181175,4583,9197,9205,13788,9197
8483,7f4b2c8717c3cfd2de134ff3d038c313e8bdeed5a7192d44635ce2ea321ad348,ransomware,3058771,11874,23901,23829,35703,23901
8484,7fc8b935fe5a0727e2ecc14f33e2557218f621eeadc009b7158fd573795df605,ransomware,2621514,10088,20460,20503,30591,20460
8485,800f95f573cfdf69570b9c7753f65fb2ed38606cf1e44e5b03805080d661f27d,ransomware,1952913,7363,15300,15572,22935,15300
8486,8012cdd990fba67d2057abcea8db1084a553103001cb3df180353ab7feb8da05,ransomware,1758171,6737,13683,13727,20464,13683
8487,805e1805c8b778e9d2cd61a5c7a9c217eabe08a205120e35ffb3ee55e98cf325,ransomware,1655821,6319,12800,12919,19238,12800
8488,808905143b7066107d74f39f6e5ad45138170ad1bd0e3f703840072708ff0d68,ransomware,1518582,5815,12030,12576,18391,12030
8489,813207ceceea12941f4d790b2cf7ebb96bbb7e4cd42bd1070f6422807f7d299f,ransomware,2861190,10952,22344,22247,33199,22344
8490,81553a6fa3cf2513aef8ea134c5cde3ffcf6fd528dd25e7562dd7b5977269266,ransomware,2337152,9022,18244,18226,27248,18244
8491,81905fc1fa4f897cf3bebf86f0ac41d561d0c1ea399e424f1843ff8091654f3f,ransomware,2192620,8427,17078,17028,25455,17078
8492,81ff805608ae99c80c9c7421bfdb2f39c42b9a2aad3b3920b8bfae550e7032a3,ransomware,2998716,11947,23847,22573,34520,23847
8493,8210075372418327e5cfdcd7c81a3c316f2e0f59603979355a82b9d0f8c563ea,ransomware,2037822,7932,15966,15845,23777,15966
8494,824b032a932ad6861a83417898108a1c95dc17b657e887a4fec627076cef162c,ransomware,3055847,11780,23861,23784,35564,23861
8495,82cfdb6532de3bb102ae1430db8df788b30f8391491a1c76d7ac04540f3a1c42,ransomware,2385661,9178,18612,18534,27712,18612
8496,8329c0ed69ec607eaec08d8fda91359ab1f2b7ff51f7e8e1d8d68319849c9f4f,ransomware,2250614,8731,17611,17476,26207,17611
8497,83a0f9ca30df74c4040a172ddc96b3e826090906d71b6bf735b0708ee8b47512,ransomware,3365381,13010,26299,26151,39161,26299
8498,84284f359bf7ac4a437105e8284b7f95f43d4a56aaae1ecac902759bd02d73af,ransomware,1467092,5725,11500,12081,17806,11500
8499,848853bf7291ca8da790d6748bee53fadbb3443fb8aa6758bdeecd9881a52779,ransomware,2592062,9889,20329,20377,30266,20329
8500,84d4386a8116b0166525c911aeb17f4c8ebe90c6a42e4576439c8542a517d377,ransomware,3477885,13456,27147,26981,40437,27147
8501,84ead68a246a6f54b22ce11e15c05a0670fedea765983411292fd4e7084db872,ransomware,3328518,12849,26067,25873,38722,26067
8502,8501feb8e2a4ba63ca20d434d4d97ac96b316a0c6ef5395c999e1ec4ea95c226,ransomware,2993792,11615,23387,23351,34966,23387
8503,8506f02d1371e3ce2dbb14dbcf591f791ecf58d83f0063cbcd0ef1240c466a2c,ransomware,2021935,7772,15762,15686,23458,15762
8504,85185514ac27740169bcac52c27d1562cf74696334fd57de4ed43f0765f6d001,ransomware,2775871,10720,21741,21620,32340,21741
8505,853ce6ecbccd6172afd51b7dbc360e23f2ffd316a22b4f871b167aebff4b51a0,ransomware,2993793,11603,23375,23260,34863,23375
8506,85e0784f32ce5261d7544a1c07620a6ae5b30afb15fa1a96922aacc6ef4aaddb,ransomware,3266430,12560,25509,25487,38047,25509
8507,85e7d7be325eee8522f74aff492a65287163dfd9935993087b6fb79ad22c374e,ransomware,1423684,5488,11281,11333,16821,11281
8508,85ef6bf0a7f0effd2393df8dd51949daf6e5ba2c7f422bf7c71a07a2de489c91,ransomware,3235309,12511,25288,25196,37707,25288
8509,86033eed86842f2e55a19bc62b266d7e1e33cf557419ebdf59b0e8f3b49d7695,ransomware,2574863,9926,20159,20193,30119,20159
8510,8620597b067be52de51868e8d3edfab7167ce35a34306d956232279f12cf310b,ransomware,1289734,4923,10047,10178,15101,10047
8511,869f2a76e85da1458a2b238bedb2927628501e1a12c045fcfe9489e85758271f,ransomware,2091122,8031,16360,16300,24331,16360
8512,86a7bca8b22f06b9462e410bbb983b39affc9f3c61e82658797a96aaead7bbae,ransomware,2564312,9859,20064,19908,29767,20064
8513,86cc30eee324afae20c25a8f64c10ba824ddeaffa7df44a30e0158d743fe1b64,ransomware,1997329,7514,15559,16021,23535,15559
8514,86df990ee40983d9c0f3469581dce627434ce626db94b12dfce713e2f764ba49,ransomware,3299007,12785,25726,25612,38397,25726
8515,86eab06adb7c23d7f95b71d6814654067c5ae80d605debf0cb264b10861f43b7,ransomware,3258924,12618,25468,25350,37968,25468
8516,86f2f06f07fda4f5eac6f29ef4c6003aea6ad70630403a54b4eeb7858856da8a,ransomware,2721570,10513,21363,21288,31801,21363
8517,8713f9640fa6601076860a5bd18da3457da21a8b033f11eb3703c692fd4e06ab,ransomware,3436598,13283,26863,26744,40027,26863
8518,87647a1dd212f4c7820eb4e8813361a4bdd51d75c927db6b286953c3a19ccd13,ransomware,2225887,8561,17461,17332,25893,17461
8519,878e01ae41ea3fa2beaaf38a0ff61c9a1828a7c4ce5a461772dcfb3b094758c5,ransomware,3243301,12549,25336,25247,37796,25336
8520,87c069788e66c7d4d898594023f541afc28c7546416473ca21d53c9413977f03,ransomware,1329156,5144,10434,10391,15535,10434
8521,8802888a702f4354abc1f7e1e982a79727496f6fa7124d0aae21373ddabc7866,ransomware,2099089,8021,16270,16428,24449,16270
8522,8858e59109902d9486c483eb7953893225e168dbd5aae7b8e0b46018a01feb22,ransomware,1735006,6755,13567,13495,20250,13567
8523,89d41ea8ff8ede377c17078b8c1f471d84fe1a5e3c51d50455f99edc4c40fc94,ransomware,2237616,8457,17580,17804,26261,17580
8524,89d66c74b79c584696d46964caa74f1a16941292feb220957cdfaa29ab513a30,ransomware,2891866,11112,22551,22635,33747,22551
8525,8a66b3267d8f918845726cbea1d9cbc5e961ec00f0ec48d609f061bd58b3b984,ransomware,2742035,10503,21539,21619,32122,21539
8526,8af8023c43e3fc3b8122f3614b52801bbf3b4ca45adab5d28da0cd65f998a78f,ransomware,2322892,8760,18283,18335,27095,18283
8527,8b304f885ec127d8ffefa4b89d9dbe65569f7949538bdf97605f97a836053a5e,ransomware,3043577,11744,23726,23605,35349,23726
8528,8b367c441193a7bd42b36063fae3fb35deff080c78eb102bd2bc418189db70b2,ransomware,1955554,7334,15295,15498,22832,15295
8529,8b4172388ddcb40bd1552f7a7b92d4f5678f24eaf51bb7b1c2d46d8f6b1687fe,ransomware,3062900,11788,23949,23878,35666,23949
8530,8b5ae1a10c45f9af763d3ddbff7e3908a39f9ddebf3849acd855251435c985ac,ransomware,799385,3033,6210,6239,9272,6210
8531,8be13f1bcb86a82944f4c60d1f22df8687d02658bbb241015d8e8441fc3446ca,ransomware,948278,3586,7374,7477,11063,7374
8532,8c6bbcdd699b4068f6718ee0b15e03e7930cebea3d922d89e59957e70c923fa1,ransomware,2528234,9707,19809,19837,29544,19809
8533,8cb0d3623051ad3f0a0f4860ad9b89c4a2a518b2ea98af1ffbd2105e5bb8386f,ransomware,2678939,10232,20860,20869,31101,20860
8534,8cee519a61aa53b964a8b827ed657b33e29808d6f77cd927fa361fe0a3c22488,ransomware,2015893,7692,15670,15652,23344,15670
8535,8d4f96d2bf75b7bd0569eda14a69b47bb3d6519b4180a663a0803c700cbc733b,ransomware,2888632,11270,22753,22516,33786,22753
8536,8d7d9c8e7b5f24300f69109b68e9b94149153601a29b959eb26737eec55e0ea6,ransomware,1290882,5059,10113,10697,15756,10113
8537,8d9392e0f38b4821af0159f470f9aab817f74ba5c753c79a3c007c2d9c012d1b,ransomware,2860239,11088,22348,22291,33379,22348
8538,8e1c7f2113cff0229bc0db77dd557b9c07d0714620d51f2e98b2a7c0287cc45f,ransomware,1797710,6926,14009,13989,20915,14009
8539,8e2bedf5a51765ba73953ef912f449318ca5cd17b3eaa0206f863bf7ce3db998,ransomware,2796251,11144,21784,22232,33376,21784
8540,8e3c57beba2d3a3a3bf5b2ae2940ef25ea7edc75ea9b59672b63e828671d88e3,ransomware,3453430,13384,27016,26813,40197,27016
8541,8e82cf2151e0304ec673d51f8a190092ecf83aab1e19f3112b4f297ac6d584d8,ransomware,1947579,7451,15129,15713,23164,15129
8542,8e90030ddc241484b9ddc4dcf5e7cc0cfcb4c36f3f71c8665a0516ab31362186,ransomware,2772309,10708,21632,21590,32298,21632
8543,8f662f74e13a69c15d5d78e87a7bee5d39ea8288756dbea77b00a76082b05bd7,ransomware,3162124,12207,24671,24505,36712,24671
8544,9048703720e50d61c2688416943268e18084ec3019208cb4afa934a37931b047,ransomware,2148502,8235,16843,17050,25285,16843
8545,909834b6a74f4d3ff68be45226a11a5cd1469f1ab7cfa538d221ef9cecc3a489,ransomware,1673673,6377,13023,13100,19477,13023
8546,90d3b0728468671306421a49e7b8ba817b4558ea23774535202b404709450bb1,ransomware,2541369,9719,19889,19947,29666,19889
8547,90fc5df1945d70d44cc0f032831da1413a6fd0cd0dad8749df567b41deafe8dc,ransomware,1382758,5352,10927,10991,16343,10927
8548,91347d969365ff0fe90644314b16a2ebe9d6e3ddefe5d7d72a6f0ff1728b14ef,ransomware,635694,2422,4943,4968,7390,4943
8549,918b660d075ac5f498e8ee5b34c307214d3a5f73f7cc63eb30169b4cd91b6939,ransomware,2753205,10649,21582,21449,32098,21582
8550,919e8ec8c32df9f32c172097b18df6cfab6ee30416157dadbafa85b0d6f972db,ransomware,2883907,11280,22594,22450,33730,22594
8551,91de0a02d136a36b059975224d03af99c165c2c3251d215adb2bf812edf92af8,ransomware,2131942,8282,16692,16585,24867,16692
8552,92062f00b4f9ba378f75c524600dce32178de78f8d68d78a72294c0e49870c92,ransomware,3287928,12748,25743,25581,38329,25743
8553,9232be1ac7bf2f5d2ca253045656cc0fc31faa9d9fc54f40e99af40136dce9f4,ransomware,2189405,8403,17054,17022,25425,17054
8554,92658a056455267227e5e70a5e046dd67547610430fcec86c5efa1e4c17e5aec,ransomware,2056876,7879,15999,15977,23856,15999
8555,926e22cef5142733b5f698ed61b3e0b9c7652531d8ae66862e4a1fee6429425c,ransomware,3393576,13124,26631,26388,39512,26631
8556,9272ae88992ebb21a8af47d0c2d7c9fe6eb8557f9bfbaca891f9ae62f4ed8961,ransomware,2540469,9876,19898,19783,29659,19898
8557,929b9efa873ec41e86fba02f558039a7eb6339c21d0c815bd2407a4a1f16f757,ransomware,794530,3020,6191,6212,9232,6191
8558,92ff937fed13df58c472dd19594ffd18e32611f4ab3726ddaaf8783604f335ff,ransomware,2327671,9048,18243,18093,27141,18243
8559,93405b5c911f8c4f2de5c883f4ba6d57e00f7df4813b960ec7d0f0d33505f0e7,ransomware,2697260,10732,20997,21438,32170,20997
8560,93fac39fa56eaac80c5c92c973e153bfc03792a80f7b6c43eef3ba48bb76caa5,ransomware,2646711,10102,20712,20780,30882,20712
8561,9422861bd87a5403de56dd735572c0f7831fd1db0ddbe436f645017b2ae2ebe0,ransomware,1879377,7154,14675,14828,21982,14675
8562,9450b89bfeec4f69ce7de73401b55ba0ec13ff2c0d03106222808da7c3b5bac0,ransomware,3407547,13144,26621,26531,39675,26621
8563,947143a84f8fbce90e40393aba864639d7697a61bfabb598053d5a56e83ff38e,ransomware,3159055,12166,24738,24539,36705,24738
8564,94b3fd2e3db80af78a791ba4a3b66fab80542fb069419ec7cff5963008b0855a,ransomware,2435149,9278,19052,19338,28616,19052
8565,95051a80e4bc60353e092fcfe782089546863aad7d27a56a7ff05dc15c32a934,ransomware,2558672,9836,19828,20306,30142,19828
8566,952e9b9b2a9b4ce9dccd36ef20431a31ead2b9dab80b95b47cf5b38a85e82ca5,ransomware,3397958,13543,26233,26758,40301,26233
8567,955c0732d932e2d9c1a5ad4e0782aa6988d6b2b787ff358faebafa3dde59525d,ransomware,1398523,5380,10885,10918,16298,10885
8568,95bf6883be53dc87cceebac2da6911157b674f87a0cbf0fc27010ecd274306a9,ransomware,3220308,12431,25172,25098,37529,25172
8569,9629440e44bbd128c41d66ceaacd4d1947dfd5dbd55ac9d25ab027c8650cd7f0,ransomware,3224102,12465,25223,25095,37560,25223
8570,96daaa8fe6c6027912a1f1dd72f180bd5a4c4f2d23e0063090d6551e078405be,ransomware,1833453,6988,14272,14379,21367,14272
8571,96dd2c9eb70ec9d7dedc464a2de1fa6ee8f14c751d62027110b18df8f4ca288d,ransomware,3351084,12928,26233,26287,39215,26233
8572,9739f508224b9ce32c191b351a50c3d524d54b08c8b030c8f7473ebded3594dd,ransomware,1283196,5011,10330,10552,15563,10330
8573,979c049b03bbc06d8bccf3625cd21b50548df9d1eb4a206836b006ce3c66e139,ransomware,2565012,9930,20066,19990,29920,20066
8574,97dfd2a7c164dc4c56966348e4151e0b56e5bcaa98c894e81e6a637a1da8360e,ransomware,1809500,7104,14243,14718,21822,14243
8575,97e085e6dcfbbd9665b925a608418798739f5e2d839bad80360462f9e1efb1cf,ransomware,3325604,12899,25904,25831,38730,25904
8576,97feb4ff0e816da9b868f7972cfe53ebe64c8d12e8a2faa8e51528b9ddd1d329,ransomware,3475814,13436,27116,26950,40386,27116
8577,97feb56d6bd71142ae6dd2a6077daa7132ca2ed58e2a7303d1d3a9c74d93d3d1,ransomware,2239817,8063,17605,17714,25777,17605
8578,9874e687eda9bb6fa1edd87cf04b45e836109df7125594ec64583c781dfcce04,ransomware,2873841,11212,22433,22627,33839,22433
8579,98b1a938cd35476fcd0ebc3656f9f5f48aa6abbfc1a11633fe5a2d22c27a418b,ransomware,2280058,8620,17878,18016,26636,17878
8580,98f34ab23327f22a10056db2fe944f36acc00e0cc70a7432a229002b8fd0dd76,ransomware,32027,112,277,220,332,277
8581,9925b4fe8badfa36aab7fd35e2d259a44e94671cf65d9e707499a33a2cdbafd6,ransomware,3407819,13157,26641,26481,39638,26641
8582,9940ac32a8a3a32ae9e42f0445390b176d25ea582db43c34fa38f0c17d891dc4,ransomware,446580,1778,3491,3485,5263,3491
8583,996200d7d5d35b0f1da16ef141c4b7c20aa6ca9391aa0fbedd82a95e9f1524d9,ransomware,1939703,7496,15310,15095,22591,15310
8584,99e6254503b6881da18edc1ce5e6cac7d9816f0b3d3b4927f75ff335d6a945ea,ransomware,1592450,6165,12414,12374,18539,12414
8585,9a1f0e42a866eb4426f25800f666e5b6fb43620223194d7997230eb28bdc1872,ransomware,3199616,12397,25016,24808,37205,25016
8586,9a4ada7d47afecabd07e201aad840a871397572bed29894f6dca277dea82a4c4,ransomware,2442209,9416,19132,19163,28579,19132
8587,9afb2653c3ec17136c26e894428c4cfe93af04241f28e49bb0029a0f3b2b4581,ransomware,2384567,9269,18611,18609,27878,18611
8588,9b2eff7eda6c7a925c9063cfdedb4ef349530aff488bf1c01eb73fe3e78605aa,ransomware,3144452,12248,24597,24692,36940,24597
8589,9b355eb718557caebc970902c21b07f58ed02ca95d728b575b351f816109fdb3,ransomware,1931958,7440,15180,15505,22945,15180
8590,9bad2d8b7d4824c874325322965e35f85a07d0d5486bc2151976ba24616c1978,ransomware,3480884,13470,27202,27052,40522,27202
8591,9bb832c86ca47465c9cff4d234d98bc1acf0027143cc4832da5b1dfcd05365bf,ransomware,1342963,5140,10449,10539,15679,10449
8592,9c6f293294f9dde9650e215ae41672dd31b24f7795489809ebf1bac707be9d7d,ransomware,3463856,13415,27049,26907,40322,27049
8593,9c92245ead131c200ad3579b3d0c556b47d61e17d077e9be8a0de5a5309ae0b5,ransomware,2536713,9907,19934,19796,29703,19934
8594,9c983d0aad8597b705e271d957fb8d29a3830bec283eba95368fe45d2775f2ea,ransomware,1143209,4388,8895,8951,13339,8895
8595,9ca0aaa31db749bffef89fd5d60b621d64e3f605e3b282773a7c7087f069df96,ransomware,3023446,11726,23599,23585,35311,23599
8596,9cfe2cb73ca545fb3122ce6719bef1e4b4108133db4e1730000c4df807a40798,ransomware,3145821,12142,24513,24475,36617,24513
8597,9d1f63bd49dea01cc07e0ec85bd99967c8ee8a794378adf08365aecb70f065ab,ransomware,1527875,5718,11937,12177,17895,11937
8598,9d20e0330b89eb533c698a5f122fb2cefa706b200c9126a546da2d27a5d26ac3,ransomware,3137876,12174,24536,24412,36586,24536
8599,9db3a422a687d0a3476172c0d77408e2ab320250d3666f611b76cc6df3ec40a6,ransomware,3015409,11654,23612,23357,35011,23612
8600,9de5871bffa235d7802faca3e6e1cafbc3fd6183a489fe6d7f712ee65665a208,ransomware,1444386,5773,11271,11599,17372,11271
8601,9e0ae72830f1fa2279a6c25d91e8d3aa27982743ef2f1be1777c9d662471160c,ransomware,1632160,6250,12701,12722,18972,12701
8602,9e41515f59292e39f2c2e5c1fc2f839a4ba559c9dedcc7a6b68611a93348aebf,ransomware,1400903,5440,10998,11296,16736,10998
8603,9e9b9c95b317f33445ed5766e88736bc588817eaf0843595d12c168b1e871cc8,ransomware,3356408,12983,26123,26133,39116,26123
8604,9ea241e9e6248d1f829b54582628ac73f22a7403326974c179af97a6ad518bc7,ransomware,2767056,10604,21471,21789,32393,21471
8605,9eb67944d6d15621eb78be9cfb73b4ed5727e12ac6e568a7b3197de79078662c,ransomware,3096727,11977,24207,24060,36037,24207
8606,9f19e5519c3c2b181df2291ca115225abd42ae1e622e7915950ee7e32b0f9178,ransomware,2986485,11577,23327,23080,34657,23327
8607,9f50fb3c37167e40203dcb2e455a47e563129c93e302840569f3d08d56c89021,ransomware,2882264,11103,22617,22569,33672,22617
8608,9fad5da72cdeeb0f405082fcde110d8031740599693cd038adf9858e9ac70d04,ransomware,2315382,8940,17996,18018,26958,17996
8609,9fc46c007899e6507d0c96bfe87a8a91f4b33cb1aafc4d678469cf2118fe3e3b,ransomware,2855209,11088,22484,22191,33279,22484
8610,9fcb1f969dfdac928558b48ee74e2e2f97cea8d8f79f6c40b65e5f494438ab8d,ransomware,1585938,5951,12486,12991,18942,12486
8611,9fdb1e3b43b0d60f7c7303128ae5e01366320272d7cefde3314c60e54d8b279f,ransomware,2883187,11159,22524,22484,33643,22524
8612,9ff39ed15cf2c2e0a86b03bee790c72cdb836e3f8d2ae0883591070a5df3d7d2,ransomware,3088370,11955,24182,24057,36012,24182
8613,a01a356800d85e282dfe1bf058ecd8de3b15d2ac9b1ad1e87a24abbb727d89c7,ransomware,1688442,6394,13254,13574,19968,13254
8614,a0f7ed61c8a823098f8691b15764dbfaf407580c89e5764c5baae1d6b08578ad,ransomware,1426102,5446,11710,11242,16688,11710
8615,a161b3c5749c340463680c7c5e998e83350860b5c46f165871663333b37af07d,ransomware,2276908,8522,17982,18005,26527,17982
8616,a1bf8686cd65c186abb7d214e6404fa8be106dcde17df66ac71960e796035a43,ransomware,1514768,5802,11764,11809,17611,11764
8617,a23caa208069cc5a01635e18aa698f34e3a09847b7fbb9f4d6484f3a2ff7d65a,ransomware,3019308,11727,23560,23467,35194,23560
8618,a295f3ab2850aa2404130de71385512625fd7ec2472fb97c92bd15f0b801fa28,ransomware,974147,3830,7730,7684,11514,7730
8619,a2dc19f4a6065a95e2100b81ca324f7d37478c1a92ab6555cad8e9e8b5f86171,ransomware,3377601,13061,26389,26244,39305,26389
8620,a2e75ffb789960e474c335f91138a7ebd92575bc958b6a29ff0063ca44643952,ransomware,2993551,11603,23504,23332,34935,23504
8621,a30ed72953acf62594064ba2e9318259bfbfb4719deca02eb85cfbd23da8e46f,ransomware,1484398,5750,11566,11552,17302,11566
8622,a31d886bd6faa5d832ffcfa6b904cf7b04c540e68e6e27b23441a18cd014afee,ransomware,1741840,6805,13665,14103,20908,13665
8623,a362584929b0560010f927c3c67526f0bb043ecd4f864b49a3f7a21eeb6b2e6d,ransomware,2024232,7825,15882,15772,23597,15882
8624,a38401d8ca6d0b79c3df0558dd1a7d6ceb3db881ffb4f7b06a60a2df6a7acb1e,ransomware,2221913,8489,17370,17386,25875,17370
8625,a3844442a806b7713c10e963e9959511c4e9d1894e49180e8e958ad5dda53b38,ransomware,2617107,9982,20527,20540,30522,20527
8626,a38ac3c96620b74b382a3cd66f943c942cdbf5d24cc5b8d3c0059c86dadee695,ransomware,3481234,13477,27184,27058,40535,27184
8627,a4095c5cf8073c057ac2b6c266bdd41c83bd04452821bc6a38cf5634ee68575b,ransomware,2266982,8733,17658,17560,26293,17658
8628,a4138a49806c238ab0119abf0ac08abc60d07670438ed41fccc93970a4c88cf8,ransomware,1564126,5970,12123,12280,18250,12123
8629,a4f37df3a7ae8b252c5ee6d4193fa08f29d10047022f51b0b6f751235967b9d4,ransomware,3007943,11688,23602,23489,35177,23602
8630,a4f85a2c538f170d48a47a1c56960acaf678530ecb78d4d2db5cce2bfafe9e38,ransomware,2591940,10174,20479,20849,31023,20479
8631,a54782f20176bf02c8f69b6def893550550e5ef6cb104136f6a567c6682b0237,ransomware,3149783,12180,24575,24636,36816,24575
8632,a5c600be67e8df26b8afe05b99d0e488bfdf80f98765881fba1fdfa06a309758,ransomware,3051931,11877,23766,23662,35539,23766
8633,a604d15e4185ca948c655e7aebed5c7127daa1eddecd7924f05ab2752269e3f7,ransomware,2768206,10618,21656,21652,32270,21656
8634,a66395e475d0773ad2765e490e74f63552e2c44d1d2fdda07ad53036651de24b,ransomware,3472478,13449,27143,26962,40411,27143
8635,a66c95da527d9d9d3ef95e2ee0e75bfe2ac689558eb8e4ce87f3d32b93369976,ransomware,3481300,13456,27189,27050,40506,27189
8636,a66e6666266138dd761e415c377b89776cc706d90a3e4ad64ed030574398016e,ransomware,920594,3402,7306,7649,11051,7306
8637,a6a244a7e2434b64f3a731e9ed01187d21346c06117c789e3c13fa648e048d91,ransomware,1568759,6002,12352,12389,18391,12352
8638,a6dcba7b5064d689ffad9e818aea98bce1888c07a258b92348da1b47c9823dfa,ransomware,2516486,9750,19718,19674,29424,19718
8639,a71473039da984241a182c098d1416269fc4136cc55bc01ca53d31b3395b4969,ransomware,655846,2500,5087,5134,7634,5087
8640,a7442914c5aaa65e32e70108e85560c5368bd9c9325a828784b56f20ace1862b,ransomware,1316729,5050,10242,10329,15379,10242
8641,a7928fe37e01469bfb4c85d0805e3d0fc4fb15dc1547e962cb34082e536bd086,ransomware,2810079,10842,21910,21917,32759,21910
8642,a793d8f29756de39f548c48ce4e34b249c24e03c57d1c188df488b231db815fa,ransomware,2374928,9144,18564,18520,27664,18564
8643,a7e92b68e90b891c9d41a00e827c2a965b4807717025be913d026e5dd3007699,ransomware,3481442,13457,27238,27024,40481,27238
8644,a80268c08910aacb2f66330fbd2a836e0b92dc8daf5d819faf7abbf900517167,ransomware,640052,2438,4975,5010,7448,4975
8645,a8c20ee79f6b63550d03065396eeff645c3cfef84b57c3b4e5a44cda2da2981b,ransomware,1356044,5228,10536,10511,15739,10536
8646,a8cf6cac338430fbcaaa6f9d0745acc4e817662b6d8c6f556779ff68e60dd02b,ransomware,2204649,8493,17220,17170,25663,17220
8647,a909921a88a69b62faa8d94d6b9b3ea8d9e7d1f5c27f12e39d154ececec40fbc,ransomware,2004607,7826,15816,15864,23690,15816
8648,a9561c24030b24f52dac2f8c05c91a8b1c4ad70c39a1d8521920ef66e40f2a27,ransomware,3162430,12265,24806,24832,37097,24806
8649,aab49d41533bf74a1341de7bf07bb75cd2bda0dfc0708b5ae28cfcbd454f556b,ransomware,3097686,11964,24242,24173,36137,24242
8650,aac97e9c51db7af509b60eab4e84aaac900f0937937503380410f800788e5aeb,ransomware,3419852,13233,26737,26595,39828,26737
8651,aacede7ce26c6e9416d66cf6abf1c3318884edec6968b5a0b75b9dc461b18498,ransomware,3484778,13513,27224,27071,40584,27224
8652,aaf9ac6ad2f288a5aa65fc7abe13d42b215a56a0c4a61218b7aa8471ebd0590f,ransomware,2401731,9317,18743,18727,28044,18743
8653,ab7478e964c7e851d964c809dba48b1de55552ac77584145357d9274b01113b6,ransomware,3235695,12528,25322,25163,37691,25322
8654,abe7fc34a88fb6e23c4748216df3001e6c152998edddf49f7c45f25adaa77a10,ransomware,1902184,7350,14858,14868,22218,14858
8655,abea6435909d105fe7f6d4acb1d8da6bf8788600739aaccd03f0347b34e61f6a,ransomware,1586559,6052,12358,12310,18362,12358
8656,ac12a242d389bbef7cae3dd9ec38ba24fda825cfcda0ece8ac8e76bb611160aa,ransomware,3332693,12895,26024,25926,38821,26024
8657,ac60a35fdf4599edc6793e0e8a7e28e40b0c04f66298f74e43ea444a48790bf8,ransomware,704959,2696,5509,5503,8199,5509
8658,ac67cd1856c65480f05fe1afebdae1a38ae95c8679663d457d2f910c573c713a,ransomware,3288830,12692,25649,25545,38237,25649
8659,ac71adaa667f3822affbaae02c93345bcff6349e4bf3aa7465858cb1e4798e9c,ransomware,3195456,12325,24939,24837,37162,24939
8660,ac92030d1b375dbb6e1181db02d20ff48c268e86de9c26747330eb3210ddb8dd,ransomware,2929064,11376,22876,22764,34140,22876
8661,acac12dd37ce1da2788bf054b2ebddfd54554afc4ce923cfdb83402a1e4775b0,ransomware,3072198,11883,23951,23926,35809,23951
8662,acd36b90b9042c8ed615b339af9e76ddbdc30bc9703013842d81586e93b3a670,ransomware,2101613,8054,16347,16604,24658,16347
8663,ad311a839d5e4edae3561d6e2f38b92c33fc451e07ba8437fd41316161334d8f,ransomware,1275869,4936,10074,9996,14932,10074
8664,ad5d1be1c08e2afb1e3da54607cbb1d10a969b347254d15701d6af96f121ab20,ransomware,1860765,7115,14498,14524,21639,14498
8665,ad7b1d7d9a78a0d9a14c641bd829066946232364eb46d5202333d1109840e8bc,ransomware,3158091,12171,24679,24493,36664,24679
8666,ad801b3c77a21ac40ba8897f3b683a6a6dce4c1d9bf3865baba63b63c5aaf63d,ransomware,2969427,11507,23220,23134,34641,23220
8667,ad86c0357836f30efe7e7d57aa02383daac7cf7c6bf3e9a930893c9374f67695,ransomware,1864366,7088,14501,14480,21568,14501
8668,adb6d2d45283bc99da366d0bfb62d83a522fcd2c2b80dcdda4039000ab411b0d,ransomware,1975322,7590,15452,15367,22957,15452
8669,adbcd83b9bac2fd6cfc46e68b6572f9417dcdf69eba7a942ee1868fb56fde78c,ransomware,3205561,12461,24955,24895,37356,24955
8670,adc82f823f3a56524ba534fe969313b8026032890554c9fb444bed6d444b0a6c,ransomware,2474406,9598,19364,19308,28906,19364
8671,add87b63b13eb0e0e6c561ee452149ebba29b59569ec1fdb490626e2a164e2e4,ransomware,2951780,11395,23142,23008,34403,23142
8672,aeb0793295d2c3b8b87a4affba022f5f1283004dffc9cd1c51e7cb3e4f0717ba,ransomware,2875022,11145,22458,22471,33616,22458
8673,aeba26dde76a632acaa5eefd405060d6f72e308acf98c02ca416334ee068df2e,ransomware,3308027,12732,25902,25850,38582,25902
8674,af3a4bf428354ab447bfdbbfda46d957c6d540a709cc7861cf598364a769654b,ransomware,1802980,6897,14041,14046,20943,14041
8675,af3cade5d5824a2ad0b269b5e513043d791fddefa89c9d591b9cac87c1a69b2e,ransomware,459377,1772,3616,3658,5430,3616
8676,af76da785f10d0443fb826e695231d9500f55414b7a84f7f3a2b4766b39969f5,ransomware,2129010,8294,16637,16638,24932,16637
8677,af8e53b064dc1df65828ae97157f01582a8f45cf0a28444cfa0d3536a840e437,ransomware,1735199,6730,13498,13444,20174,13498
8678,afa8568ffb203a8035c92c76f6c3f02b2092a0e5856699a1ba721b10cf089ce3,ransomware,2289029,8829,17946,17810,26639,17946
8679,b0810fde1efd2449778a35b25eba655ef6122a3cc80b5ad919bfaf78a9c26989,ransomware,2877177,11135,22492,22303,33438,22492
8680,b0aa365d3e5188d1eee21ee35d08849a0240d832419910ded1ac031320685aac,ransomware,2697096,10484,21082,20972,31456,21082
8681,b1eda4105400491829945ca434f769ec5ca45749dec95144e8d096c5522cf365,ransomware,327844,1254,2467,2633,3887,2467
8682,b2122b5b7fa011953a84d43cc1ac7cec486cff6407840623bf1cb3817f25c2eb,ransomware,3151633,12161,24598,24658,36819,24598
8683,b27f27dec2e9f01f2e2d8e30a8a9e258da4912b5a1dbca2b3bf03593f27a433e,ransomware,2876474,11130,22404,22286,33416,22404
8684,b29822cdb15fc1619317b30dc8d2eb297ca7f7887ed5fb3f6ad5f25eebb15f66,ransomware,1814481,6955,14053,14055,21010,14053
8685,b2ba83cbc1943c7143c8e3d5b52b9b013542e956b6d621d8b87120075689820d,ransomware,3133196,12113,24472,24481,36594,24472
8686,b382d4f93ea79153ea67955167e36a7aab22bf115ff52309679099fd5030ee48,ransomware,782395,2923,5920,6217,9140,5920
8687,b3aa8b9daffe9c14f62bcc5e3372554d8df608428c5a57704247ebbae281d945,ransomware,2371394,9126,18524,18570,27696,18524
8688,b3e5153d96990d6e16760d3fada357887fd5f6e2cca779608b8dbcb3789c2518,ransomware,3419708,13229,26674,26569,39798,26674
8689,b45876972297e7945643087daf30a3b840756780a671440f455634fc950f7841,ransomware,1429945,5493,11516,11373,16866,11516
8690,b4704766cb6912262861f723371d3c8d496e8e40498f2936905836a04e254184,ransomware,2041388,7842,15862,15860,23702,15862
8691,b4be01ab53d22c02950bb9b03866c6bcac6dd5761bf344cc53c97d509be5fa6a,ransomware,3252050,12603,25420,25237,37840,25420
8692,b4cb2b43d1ad364ba3abe430f807597473ab12fbbb2b15df8881c42c736c0eb5,ransomware,3084605,11919,24142,23995,35914,24142
8693,b52cb819386f0b3dc10a4e8326189e24fe176535d39f156194665c97f35afeeb,ransomware,3048517,11793,23792,23625,35418,23792
8694,b532dc01c77d9e0e8476f174c189b63e94b3038104af3bf064ad49f7e68fb562,ransomware,1839309,7044,14330,14455,21499,14330
8695,b572c06c6b6479cc2c54a93afb0b6cce3d971439c421c94369ac5b6b6fb7f5fe,ransomware,2950431,11335,23134,23005,34340,23134
8696,b61577f013b58a708fbe30d5a40ca84f8ee2ea8756b697179cb6d93ff13dd796,ransomware,2604645,10034,20907,20389,30423,20907
8697,b673951d30106a811936aadad09c1e6d3f154b4979eb905e70c49f939a12efc4,ransomware,908040,3542,7044,7132,10674,7044
8698,b6920029895d39373cee6b99c746e6add77620bd142c9e408eef544623f1aa42,ransomware,2597819,10041,20302,19990,30031,20302
8699,b7f778451dccc94b9432030f03bba1002ca0025e5ea017332572f9efe8af3d77,ransomware,2855448,11003,22226,22178,33181,22226
8700,b801e791e17edfe82db53a8d61549ed35a14e621f2edb0b5693bc25719f8b0b8,ransomware,2392236,9213,18743,18700,27913,18743
8701,b82938dfc02d74b8e622994d045e3544abb12855d136a3348c065f0e35f3f28c,ransomware,2935726,11309,22968,23059,34368,22968
8702,b834cac1e6b283cef9d9eef8b05cd821cf4bcd63640e208fff2d664c6aa95222,ransomware,3395035,13124,26575,26349,39473,26575
8703,b8558edbeb4f784b3e0012d42b7ce21a4d780fd37958209535516e4caa349edd,ransomware,2438783,9275,19040,19275,28550,19040
8704,b9b7e11924baee66ba38eb66335c2697f2bc95b208eed537135eafce1923bfbb,ransomware,1992993,7686,15605,15581,23267,15605
8705,b9eb10c608acc0fd92d7064dc9c6be2e8f6df14ab7a2ae9ceb8ec616be7b6390,ransomware,2298182,8759,17997,18251,27010,17997
8706,b9ecc4210cb53b24c81531913a3b63624f328b8cd3f3898bb0a152aaf6f99349,ransomware,3185944,12315,24878,24786,37101,24878
8707,ba0a50999e30a0d9593fb47b1db0a877bdf1f97853b6a5545c228f2f4e710448,ransomware,3455809,13384,27017,26849,40233,27017
8708,ba18bdf058df3ec0a9d0d77a15b10218c48ecd19bda673bcb7b98c39ca16c597,ransomware,2009265,7847,15648,15760,23607,15648
8709,ba229a26286d9e725cb3385effdafeb1d4a0e8285f83cfab746074b509b45bfc,ransomware,2860213,11104,22402,22271,33375,22402
8710,ba4e5d75a2ba3482c9d2328e74fa1a5eae844172c550497a1346b23797ab4d8e,ransomware,2333685,8818,18324,18438,27256,18324
8711,ba5139531c17492d05fe860c852da132ea5ed92474c1b3c89c82c6edd88f311f,ransomware,3161858,12242,24683,24544,36786,24683
8712,ba7d6431ce5b3040609706480bd99301c580680437b451116f43f686040942bf,ransomware,3243878,12576,25375,25159,37735,25375
8713,bae401e7ac308ec2b18dd3992d6289b588a3d652c5b08174b5980ac1a84e6384,ransomware,1994368,7645,15555,15649,23294,15555
8714,bbb16fda8cc43b4f56c3d38de62cc414d869ce39a9c7fb03a6e64764930a2a60,ransomware,2908617,11220,22721,22625,33845,22721
8715,bbb341173fb2098923bc93a40fa32f746346b92af7541a0b16f121307b5836f5,ransomware,3456021,13369,26976,26851,40220,26976
8716,bc2d43093f2538f4562c8451c21a3438e9b2d1fcd067fa1c997f52e6139f78ee,ransomware,2001397,7558,15802,16040,23598,15802
8717,bc89d1ce1530d5e13b9d69c9cd6678e1554c2938f8c2cfb6b0553045cecacad9,ransomware,2629381,10036,20587,20618,30654,20587
8718,bca6323ddfce026fa77ca06eb956b55cfad6ef22cf838a20c7c17657b68eda74,ransomware,3366321,13011,26282,26239,39250,26282
8719,bcd14bd049544e40c22660d923bcc413613b50c6eed3d8944c0ce06c897c2746,ransomware,2969600,11465,23237,23316,34781,23237
8720,bce22c50fbd6123ec1b7c7d7e438128df70d1c84b321336f1b0c6f131bdb4578,ransomware,2956382,11394,23064,23095,34489,23064
8721,bd29132ae91b9d684a94b4e3993e95b44e3078036436c4df2ce4da152fb870b7,ransomware,638782,2433,4970,5015,7448,4970
8722,bd31bf2a575460671bc97f690bf3d70c1a75ef82e10cc5b4d84e2607f518b826,ransomware,2806683,10793,22074,21889,32682,22074
8723,bd5bf6f07551b5ff8346340208d356eb4326002c33f227884c76f35cd336fabd,ransomware,2122507,8181,16726,16726,24907,16726
8724,bd6e26861904f57a30326f291b682911e05080213e2286972d838c5313621c20,ransomware,755869,2911,5923,5941,8852,5923
8725,bda5634575e53d1adac6a30ad4860525479238dbce90d61d4f387451dc9d43c1,ransomware,1906677,7280,14794,14758,22038,14794
8726,bdace5902a59ac22a86cf15415f04b9f139190a08c33bfe46157204f3eeb5a13,ransomware,1999161,7676,15561,15525,23201,15561
8727,be041a063117507a3e3bcdc255114d671d6618dcffbd6357dd6beee91608af60,ransomware,1414833,5448,10997,10982,16430,10997
8728,be25ef19d9703b005b947faa9bd78acbc3a74c9df3d2ec7c1054cee0664e4e13,ransomware,1551609,5917,12155,12478,18395,12155
8729,be291b2a8227f974370f134748f980585d7e5ed9005b2ff2068c126fbddec675,ransomware,1903220,7285,15189,15132,22417,15189
8730,be78bb02dec90484e25f669d903277baff23ab4a0bb1ca5b2d68e48075f9e582,ransomware,2899456,11259,22646,22635,33894,22646
8731,bea2df82acf508e2e61cb306cf445aa7186795951483e142012c07cfd601d1f7,ransomware,3268353,12619,25526,25337,37956,25526
8732,bf0c07c0042c363561a9e7ee8db2801bd979d7cade3b8d198006d03bf1ea3cca,ransomware,1994432,7562,15813,15868,23430,15813
8733,bfe2ac72bec0861d39175e47eda960df54d34dc67236d0d097fd965c1d308fd0,ransomware,2008474,7673,15611,15571,23244,15611
8734,c0bbbd5f3529f14cca06e65b36dafb8001d11ef49ad47751dac25a7e2e366ce7,ransomware,1298898,4767,10180,10729,15496,10180
8735,c0e78b6c7c5094210bdaaca9361207e6d5b00e2a9605af124e339a6305b6d283,ransomware,3252218,12530,25293,25262,37792,25293
8736,c0e905cde5996722a12802f00c24ce96ab22af9e62b22f6af552e8fcf94dc66a,ransomware,1482866,5710,11556,11581,17291,11556
8737,c14c92c9f8c9c4be5102a118f061af173ce8e3d93c783298824ae0ee5ca3c109,ransomware,2533803,9974,19627,20095,30069,19627
8738,c1837ee653f3c76a52b121067774e66ac80fd85d5909f5f313713bc8a5b1893f,ransomware,1776074,6919,13891,13936,20855,13891
8739,c26e5eb8ec5b72e2c6368156f112f78906a57b393845233e727a8b2e3df790a4,ransomware,32108,165,223,276,441,223
8740,c2cd0f24abfb93b8d86befea2f04ac03c614a659d14740d15c318681b30aa723,ransomware,3214244,12413,25163,25047,37460,25163
8741,c2ed149a4413d9ae9a0362c0ddf7aa4ac1ba0a789c05ad2fc69b02186c7c4c2d,ransomware,3387721,13060,26443,26514,39574,26443
8742,c3178972006b131f74b040640090912597042d565ad8083e8b774d2c77b110c8,ransomware,1354184,5014,10625,11168,16182,10625
8743,c3cf26293c3a7a1c97d9db8cbabb664c2068e8c2285779273cb5c50617808931,ransomware,2583387,9961,20258,20088,30049,20258
8744,c3e3a15d5c28bb7dc34c6231a9787192c573e004e049285ee5bb7e756a91b65f,ransomware,2844795,10985,22238,22169,33154,22238
8745,c4c8bf93581e8c4eb5039c5fefcef0ff9faf50489cbf3e0f2cee66215eaa1bc9,ransomware,2017172,7749,15727,15719,23468,15727
8746,c4db1bce36860ba41deec7813c46e9af0d1fe8da380b651184eec961c07716e5,ransomware,3036483,11696,23754,23752,35448,23754
8747,c52649dc3620d8801aec479cb753f46bbe5793f5b1565ae181644a990ac18447,ransomware,2915497,11302,22738,22728,34030,22738
8748,c558b5cc7541659509a6b6cf63dbe833ccbe3ee0299421077a80f20fb2d8e8fd,ransomware,2959607,11445,23106,22998,34443,23106
8749,c5cf28da225864df16fd1eb8729a604fc384bb0c053d9f3c6f28fa5b2380c2e5,ransomware,1681460,6394,13030,13134,19528,13030
8750,c5df775a098964a8990af125f71989be73c6f1d7f68e8fa5f88d70a16463e058,ransomware,1974577,7435,15520,15795,23230,15520
8751,c60481d6d795d11f773d81eb4133fe1fbc3e6a2702830024c4c93c6383da44cb,ransomware,2450499,9507,19157,19043,28550,19157
8752,c62f82c984163bca0ea657950727d2e4cd9e1e9ff3d3a83e2cf7ba0c0fbbbf6f,ransomware,3403208,13183,26620,26427,39610,26620
8753,c67b2328d8222e54744b403b3219bfe7441df976b0819fe97a48ff79212adc21,ransomware,3455086,13555,27490,26548,40103,27490
8754,c6b93bc14249c91c1eeae6006af7bc87c578a94a2c085c4b3604ed01dac1218a,ransomware,3053848,11856,24013,24024,35880,24013
8755,c6faf70c0b19c6f3a4f85b7b068c9be8233751cefadf0afc5d54334305a185ae,ransomware,2678242,10372,20972,21038,31410,20972
8756,c7379a73659dcb52f44b92775abe17e7758ba5eaafc63aa7497770c64e4a1d11,ransomware,1879266,7145,14782,14848,21993,14782
8757,c768acfbcd5c63b3782622355b3490a6806cabec35989df2100630c13b18c163,ransomware,2180487,8468,17070,16955,25423,17070
8758,c76db555284d2efbd5e790bc5ba9575077ed4b48379cdfc1e61fc130a15c4d27,ransomware,3180920,12307,24853,24826,37133,24853
8759,c77ed1dcea056acc30a5d660af891459f82cfee333550852171125f241bbe8ed,ransomware,3100027,12020,24157,24330,36350,24157
8760,c7c9c0770cb20d4978c5f2ae04b8fbd9cf3b0e7449b036c6af34dc63039a75ae,ransomware,3004130,11666,23464,23333,34999,23464
8761,c86c674b37d70d29541fc4f7e3790326bd264c22eb416b71eacf43c1b39e3b34,ransomware,2740934,10574,21325,21238,31812,21325
8762,c876be99725e7ac64b143e3d1e48c5e850d9db1796b3489bc8ac59be699c2868,ransomware,2758781,10632,21559,21535,32167,21559
8763,c8e704fbce6874918a3e4b2fc3cec87bec8d3347f7de33c65f1b36d8799c236e,ransomware,2003754,7685,15588,15592,23277,15588
8764,c9254f5cdcfc5f3063b1db2cc78ac1965980194f11c072353ca9fe0d828d445c,ransomware,634439,2405,4932,4986,7391,4932
8765,c939e7a2435fd4e645ca3e570a35b756deb973fcd89ab58b29fcfac625f605d6,ransomware,3404662,13226,26495,26631,39857,26495
8766,c9773961ced4cf36f9a1450794ca919d0b9a41932aee7022126629e6753a2f87,ransomware,2769554,10655,21611,21641,32296,21611
8767,c9ddaa354c295a5ff87a6f00c40aef4f38e10fa3f1da49fdf49aa2deeec7eeb7,ransomware,2697495,10356,21117,21285,31641,21117
8768,c9e23a2f8ad68bce374ea4de3e33a85d237c6e55d4af2247e2e6ba77d2a4dd25,ransomware,3044447,11752,23741,23652,35404,23741
8769,c9f0a042f6f4c832805bf9c004edbbbe9432df82b93751ab2fa587faf01e56fb,ransomware,2237166,8475,17611,17778,26253,17611
8770,ca1237adb1064d4919efada68542371244738db3b64ec13b8a664c52c11dacc6,ransomware,1998827,7651,15608,15596,23247,15608
8771,ca400f94a89132511a2cf15650b04998d586dec1f4e2af156ea3129d98c2ef38,ransomware,2957335,11428,23167,23242,34670,23167
8772,ca594cb92cfa2142b78fc22c145bebbc811fee0ef78e33bd54aa9ce3912a67e2,ransomware,2138362,8212,16699,16649,24861,16699
8773,caa9fca22ec8b7a660aa6b14fcea436dc56c2b17e393f0c77efc02f3a9297381,ransomware,1692696,6517,13162,13308,19825,13162
8774,cb126734cfcbd7a5c1fd42ce48ac4a9042c9ce8063b9ee79bd6d449fd396bcc1,ransomware,3468122,13387,27078,26921,40308,27078
8775,cb47b1109cbe4086afe9b98970d69baf3f3f7ff04093e060825f2058df7a35b1,ransomware,2858942,11075,22296,22266,33341,22296
8776,cba4212ff876ae945d6a8eb18ba7171d2a1aa23af43f3b17bec873ae6b1ad113,ransomware,2099482,8014,16395,16281,24295,16395
8777,cba9fb74b3a968098126990d772e413ed42ea410c1356ecbf254b03b181093c2,ransomware,1209417,4596,9458,9457,14053,9458
8778,cbb3bdf007dea907793f975833d79d67304d6fa91714b6a16c7f8e00bb0e0fb9,ransomware,3327044,12873,25981,25880,38753,25981
8779,cbe020634915443106a5affb62ef0a07cbc38590739d3c52d7a46a8b60819389,ransomware,2243384,8668,17717,17755,26423,17717
8780,cbe2c338d8cee1b1c5f2b4769a832bcf2c4257b01547a7492798362741343488,ransomware,3481250,13466,27159,26959,40425,27159
8781,cbe79c67ddf9da3ecaeabb6244b05711178bb5354dd9b01b9273febdea2f9072,ransomware,1267846,4815,9864,9964,14779,9864
8782,cd0f361acac3b76f3d73ff5a921c1e25bff5cb62e7a923157f44be82052ca8c0,ransomware,2384962,9210,18683,18581,27791,18683
8783,cd38e2c5a8571d68c0aee358d1ee18fdfc36329c7df484cf2a343c75a1b5d567,ransomware,2622965,10036,20645,20811,30847,20645
8784,cd7d6b141c1b32738cd5bee2817ee87384c2ab826a4279445412bab51b53dce6,ransomware,3276676,12676,25696,25485,38161,25696
8785,cde7e7f1375afaa087dd6ad51f0b953fb77d03cddb7d89cecb501121e2d8f1fb,ransomware,555206,2108,4470,4800,6908,4470
8786,ce3e0fed4dffe605e5b744ca304fc62130e9a5d5e9b916cec1d77a0b7182822a,ransomware,3479415,13477,27215,26988,40465,27215
8787,ce4547b73eee357af32965aafa75e71cdb5f912329573ea093f8e4becd1e17b4,ransomware,3091876,11968,24179,24051,36019,24179
8788,ce8bce7205515093ef009af707babf91f4a397d8315ece75d56cc295b113ca55,ransomware,2118363,8128,16521,16491,24619,16521
8789,ce991c808bde652b28fcba52efc2d90598c8788319aa98ef99d7a4944819807a,ransomware,2933610,11216,22981,23166,34382,22981
8790,cec61fb83e8c79c63e5dd7fe8fef9935740730c11c07ffa2c918b5e5616a835a,ransomware,2162455,8145,17000,17244,25389,17000
8791,cfb01ac86e61d2d5f65f49f5c751cc9a71a2686720ed70c98722b21b689b8535,ransomware,2248547,8678,17649,17514,26192,17649
8792,cfc764aded5de32c0930f6e02cbcb673c8a79b62bb9e5a7bd882965883d48e88,ransomware,2900431,11196,22720,22488,33684,22720
8793,d15118b08327001beaee5e5625bd92182b6f03b54fb3e0e02f6560e3e856927f,ransomware,2517640,9639,19558,19935,29574,19558
8794,d19c6a8666149dd7e046105c3204466832ce22349982d2dc46f84077e6eb2358,ransomware,3464624,13428,27093,26928,40356,27093
8795,d2162dd9bef1d91ab0fa4a954a2f0cb2b67fac77ddf65be9403d560bf044863e,ransomware,1294728,4765,11758,10067,14832,11758
8796,d2396bd508fff65d3f0f33243c4d58d2246b60d84a2e8b54bf9bebab3125418b,ransomware,2136460,8273,16895,16940,25213,16895
8797,d256edac643ec3181a52ad8e585c6d6639bd32a5a619ab181dcc804064999eaf,ransomware,3465735,13527,27043,26961,40488,27043
8798,d2b3f80975ab242ddaa096f73591379fa7a66ae3958b72a9e8b65dc5ea6f2d6e,ransomware,1600934,6084,12430,12551,18635,12430
8799,d30967f69789d3e8eb8201955368a68fec9ff2f30711c6f907506e083f79f75f,ransomware,1066545,4011,8330,8546,12557,8330
8800,d32a540e8bc4dc4efacccbdadc5db7f26cf05dbd53ba818b2638e00056dce4be,ransomware,3280699,12642,25616,25521,38163,25616
8801,d3c082e9b03b2fa48f98b0f5d4c03a935f4fd44964f6f104add321912e1d93c3,ransomware,3301078,12795,25804,25646,38441,25804
8802,d3d5136b498ce3aca7b9108a27dbb036f21f6a739e229936fd6f116b2102370a,ransomware,2490493,9624,19347,19428,29052,19347
8803,d3f9b662031f51e7e58630dcf563c6b5132ad997f8048275b36cf24cf284e2c2,ransomware,3132012,12130,24536,24319,36449,24536
8804,d43d58cd0a3bce481709a00a769f01de947682bcb5b6bcf25973c0d05a5f0910,ransomware,2558419,9745,20034,20121,29866,20034
8805,d4d558db2c229d65dc176ba26163938a4bf4c52d4b3eb8ab0251a3b125189928,ransomware,1584040,6069,12423,12317,18386,12423
8806,d51705fb5e385c313f81e15d173839f853b68db360cdb5d9635ab1757545285c,ransomware,2635252,10036,20627,20658,30694,20627
8807,d53fc4c1ca61642646d683d0b4e716a4364bed510428c15e93854f344d2d28c8,ransomware,2777744,10715,21586,21573,32288,21586
8808,d58d9f764cb809cb7e024fb58b79f0c5970bcb6d826a30c378972deb73368e98,ransomware,1836607,7070,14226,14373,21443,14226
8809,d5b7cff73398299f0d3f195d824f71c2a4c001809b4e1dd74bb58163809b8f8f,ransomware,1344183,5009,10566,10964,15973,10566
8810,d62b7fa730b7888e595584508657b736ba04464410d7a62e6949a677f4edc861,ransomware,2608951,10065,20433,20351,30416,20433
8811,d67beea4e4b3fdac097709114a9b4a6a1218d0d5f65cc10b45ca0a24dd41f38b,ransomware,2666043,10281,20869,20767,31048,20869
8812,d68b2eeaffecc696f8622332837dc48479f344d6b7b03843ea5a8ea9ca581be0,ransomware,1908293,7219,14940,15113,22332,14940
8813,d6c25dfbb8c74c0d516b34037d792a35468b4688b8aa4ca8c7e09b73d047a66b,ransomware,84784,311,638,714,1025,638
8814,d81a02c261d2b1fbd5e63ab7868e9e34a008c241546532626b152a2974081850,ransomware,3002952,11588,23588,23367,34955,23588
8815,d848bf0ff7ec87f34ff678d6fd4d92b55c0196241e0c144aa6e8c38bbcd42139,ransomware,2912233,11349,22831,23084,34433,22831
8816,d884d2c6c7a74a409428d369bd755c5df8bd975b64bea917ce1902437b3e3ff4,ransomware,2588550,9974,20237,20186,30160,20237
8817,d8bc33d18c07351f754eba7c723432a97ae2b382edb62af8497ee61c361a55d6,ransomware,2759884,10710,21537,21736,32446,21537
8818,d90388013577bdd91f2adb3eee2e2fead862325e143387580812828b5e001676,ransomware,3226957,12499,25248,25077,37576,25248
8819,d921032febf043287fc36cce9fb5ba3cbf2c7a7ecd71bcbc5574b2869650a06c,ransomware,2395071,9220,18739,18688,27908,18739
8820,d9287df78d68ef097177b20e05a49543c684841eedc1c5c56f65bc72850f757f,ransomware,1784245,6864,13879,13892,20756,13879
8821,d97b3d2e79d69c9d8b2f889e5cbc311b7d26ea8a7db4db6f0219f00f4b7e4b3d,ransomware,1942871,7245,15209,15672,22917,15209
8822,da7118b2c5e2e7ec9add5e0313851be30121c69d114ff6d3f7836c6ec0527882,ransomware,3387626,13120,26434,26356,39476,26434
8823,db6375d47e093e1e697dc17a432eb2c8cc9a1e2a69a28b0d6ef191148e46ad2b,ransomware,1212353,4631,9477,9518,14149,9477
8824,db719f21960cbc0a1f15c69ab7819d8653443affb7b68c9d87e7eec13fd30724,ransomware,3386763,13109,26421,26340,39449,26421
8825,db94b3be780b84b1be7c484db1655042b8b0efd1c25788f2e6900c3a3d47a874,ransomware,1693982,6501,13165,13127,19628,13165
8826,dbe89d98f05eb1e288c12840e1cc8c9588652ca930236bead641573cf5520b86,ransomware,3134520,12132,24555,24389,36521,24555
8827,dc3eefac660f594e57527ec959d52c210f5897d04734f0ff8b442ea2dc2dd407,ransomware,3462909,13404,27074,26901,40305,27074
8828,dc518bed0b7def886f2a23e0d6d6e5ace91b9077d5217f941b59fd8ca3596e94,ransomware,2720958,10516,21344,21712,32228,21344
8829,dcab2e62950230a5188d1fc0fd8fd3322afb504987447550c52db42ecb7c8d76,ransomware,2704074,10374,21229,21459,31833,21229
8830,dcacc78c5b4e3ae38e6f515783e6b48904d4d8c9735505ec4018b2dbc8a26c76,ransomware,1868662,7210,14563,14576,21786,14563
8831,dcfaf676584aeb2a2b9bcc25365887c344579b1608a938b44d297372705dc131,ransomware,3041610,11701,23788,23785,35486,23788
8832,dd21f4c51d2959d8b7458d72aedb6ceed364ef376af885dba98ef30d7434035c,ransomware,1838269,7040,14376,14319,21359,14376
8833,dd461e5e336dab58fa6e5d543053af09114c2225531e5325a62b06897c1651eb,ransomware,3449994,13388,26940,26808,40196,26940
8834,dd641544f948715fe9c92f2369680f9dcba524b8509bf34bb2e86833c9e56544,ransomware,2703422,10461,21179,21016,31477,21179
8835,dda49fddb6f3eefabb6b1eebd6f5372349a2d4372771c41526e8664ef1f35cd3,ransomware,2511753,9655,19810,19613,29268,19810
8836,ddc0d2cd5786dd65e8a1367d11243d7024a064bf480b7589b71724a3496b0d4c,ransomware,1456007,5393,11414,11811,17204,11414
8837,ddc5d3444701144655f650208b7fefd68887bcc5f032af521e578ff5f4ca19b5,ransomware,1906201,7276,14866,14828,22104,14866
8838,ddc9a25b1e2cf10f35860a5e133f56b83b192d5ad26093a07f987192789d52bb,ransomware,1924554,8066,13293,15001,23067,13293
8839,de2a0a1f50b5e304310373ff134d48507ebae25b84a2486b60eaa6a1292b8941,ransomware,2885972,11111,22508,22529,33640,22508
8840,de581c33b9e500cb9c2806fddb6326ce9bd6a777073e159c9bae98a2981e44e6,ransomware,2834677,11024,22181,22341,33365,22181
8841,de7e73b5390cdd009ea4c909486ae07ac5d09b8067f0f186326fd90919a7d7d6,ransomware,386380,1408,3099,3445,4853,3099
8842,de9af8502448d1b9f2fec43def7cda8b72f7b03571a162237850715e12ea97c2,ransomware,1964682,7606,15435,15386,22992,15435
8843,dea4fe4ebc18c0e6d6546f5b9efa186c88f71428adf8c2a490ba944a58d54bdc,ransomware,2011163,7604,15696,15793,23397,15696
8844,decd42f7dcaedd861283557170e8ebd28ffb047a6f08b75745101c66bf668502,ransomware,2015537,7715,15703,15655,23370,15703
8845,deced7eb1c9523b16adee5088e8e48fb4529f0b1890fd4bd5cb7571b6ccfb8df,ransomware,3309417,12739,25760,25684,38423,25760
8846,def8275111de2f28801231a4391b96adae37a031ada14b1ba93ecd9e00e42a28,ransomware,3435597,13298,26840,26690,39988,26840
8847,df91ce1854b9a1d82c201467bb99672a7176e6a3a75caf38da24d742d67ed374,ransomware,2907162,11325,22660,22730,34055,22660
8848,dfb61e3de4b29f75fbf369e04c053e9be64e6d1cbdfa589c89f4eb49ef178c6d,ransomware,2997599,11605,23381,23397,35002,23381
8849,dfbdaa5680ac4425c535819eb2086d213c64b3792ec874c4fc06e4a7c278cae7,ransomware,3256728,12671,25430,25257,37928,25430
8850,dfc79396524a3b51946fa26b6f12618cec3fe3df18d605f177994340925f7da8,ransomware,3222916,12505,25229,25013,37518,25229
8851,dfd081653452cbb82b40e6ef06a281d12d3b129d1c8aae8e56ff958496e2479f,ransomware,2902750,11150,22617,22673,33823,22617
8852,e0729e2ebf9f4d923531a1ab5cdfc1211a6104fc8b23324304e08182975a8450,ransomware,2989102,11458,23435,23323,34781,23435
8853,e0a8534313a3fc0154af00d8b02125638693fd2eafd0e5e2c4bf91fd99fcea96,ransomware,3155232,12196,24675,24693,36889,24675
8854,e0b35052d3d5a2226faba0f4ef97baed31e961047c423e4e51ea49dad18c9452,ransomware,2345166,9038,18232,18440,27478,18232
8855,e10067c925b0c33c54988d51f9a8683ee97746341648901bfb0225d03f20e0e9,ransomware,3479083,13464,27192,26974,40438,27192
8856,e1134a89a9684ef09ca9f02c563313157784bd1b1d4e4617761b4ba1ed3b71b4,ransomware,3382782,13106,26498,26246,39352,26498
8857,e12ba3a85ae03116d472cca5c548e078bd29febb2504c98542f2f4a0c04bbc1e,ransomware,1308602,4978,10214,10202,15180,10214
8858,e12c1b2ddbf5e1b92503f9a7ce33c7bd6acb66832979319bc26c39b1c8fec263,ransomware,1850194,7199,14386,14398,21597,14386
8859,e138f4a5acf1d8286fbf31997f251b2188cdbdd0268b8ab7a99acad0f50916a9,ransomware,1886198,7174,14726,14893,22067,14726
8860,e18c853675781f5cb9eb7d7a4840d0a59aa17d31a000ca7b2d8c72369dcdd22f,ransomware,833470,3198,6516,6570,9768,6516
8861,e1e2dd43379e8c5a4b8ba969ae9596029f7d716cc44e391e7797f7b75d066c83,ransomware,2215396,8625,17289,17369,25994,17289
8862,e1e5870f2dd6b0eacc1d490ef9c89969d829e3f3eafe9c2123ff8c63144150db,ransomware,2266285,8690,17655,17576,26266,17655
8863,e2150b8cd0b625d6f5ab5018c8ca47b2707e96fbeabd4e09e74560114076ecda,ransomware,3013743,11554,23553,23576,35130,23553
8864,e26ce4a9844cceb4ed59c1dc42849c91884f02f0f85253a2764803951a52ea3e,ransomware,3353486,12964,26182,26023,38987,26182
8865,e2760b60c422002df955e123655cc071f9e7e59dad8a86bc2c0f8dfe3f6c5f2a,ransomware,754077,2868,5875,5915,8783,5875
8866,e2bf8a3417cd9a3f1b99e246d3d5706dbd798c0ef6c3c73cf9f23e1c06361def,ransomware,3432486,13262,26898,26702,39964,26898
8867,e32c7981010a533617197b80ee6c359f1e968645de030c820536bb2eb7a35030,ransomware,1914790,7218,14912,15162,22380,14912
8868,e32f406a0475a43e9873730657afaf3c3e1fcfabe237bafd4112749158727f85,ransomware,1327466,5107,10353,10539,15646,10353
8869,e342ddcc7a206582663746b211f5a05e82d33f0bb0390a9b98f81d13560f3e0c,ransomware,639083,2443,4974,5018,7461,4974
8870,e34de00b79e25fa85c52572eb869ede4c9000e18a5d05b40a17adb483aa55be3,ransomware,2370921,9128,18540,18470,27598,18540
8871,e37964860e050e025ff3680fef70a71fd2c692df2956531fb73941ecebd1844c,ransomware,3100046,12264,24387,25057,37321,24387
8872,e39123f4e7c1b2cbc62e1a79d0b396c48f894c6f82f978a519cf23d77c0c77c1,ransomware,2862999,11171,22384,22515,33686,22384
8873,e40b49de5fff1def6a001272d2f07cbb5b67933be5a44359679554c5abad4d71,ransomware,1065147,4056,8274,8322,12378,8274
8874,e4151c2ec3a4f7f88d6a496abd4e10a4a7fc5eecb0f7a816957ae83e1a74a945,ransomware,3253137,12549,25436,25260,37809,25436
8875,e495f1d36a20481d1d9b90a8167a298244726ae40f47955f820734f6ebe54e57,ransomware,1769158,6776,13758,13791,20567,13758
8876,e4ecce17d63a36700e16c8911e11a6974079ba35bb50866aadf8de7e49495e43,ransomware,2801815,10804,21969,21916,32720,21969
8877,e529858c4c3ade975badfadc5707ad8b77b9e363cb5daa73c0ba4d7244dcb7bb,ransomware,635699,2423,4938,4971,7394,4938
8878,e53f652409fcef7f3eb3f8a8a1866b6861fa4eb6461e3b09b0ca16977f5f847e,ransomware,2386390,9042,18757,18834,27876,18757
8879,e5aa65b5c5a87bcf626a60515b013953115bdf92691017aa67b7de2f0cca4720,ransomware,3112360,12060,24264,24225,36285,24264
8880,e5bc13c336b5f705259aa6495243ad7016866864238b2fca10fa6af8db1cf1ea,ransomware,1950046,7481,15188,15174,22655,15188
8881,e5e4067a0867dfcadb4c9aba1f85c16622e13913bca63a19f0ab03fbfda39c52,ransomware,1235717,4709,9583,9627,14336,9583
8882,e659f12dee199e6fe97a9e50b1aab423e12f3f918a94e65eff9ce7bd8aeee6f0,ransomware,3219501,12421,25134,25069,37490,25134
8883,e698cc9272ac1ec948918ba8eac3698db01855c647d1a6e8340540404a41eda2,ransomware,3481407,13477,27232,27091,40568,27232
8884,e6ab6d1cd9a1aa86574f594f1b2f0edba23543b33e028758ce4a83877cf35b9b,ransomware,1211134,4790,9525,9745,14535,9525
8885,e6ce12644db0416fae54fcebdbdacfc2f0eccbfe53650e1752eabcf3c9838e1f,ransomware,2616313,9956,20569,20735,30691,20569
8886,e788a4161fbd3175bb9397c4c669e3d98194e7d09b5c62ae736718f18c7767b6,ransomware,3337847,12892,26141,25938,38830,26141
8887,e78b92adcc8ed2d92d222f66325e4c0bc71d91946e5dea1af12f61761e44575a,ransomware,1858719,6988,14479,14559,21547,14479
8888,e804dac9d8c68d24e0a240ee91d032adc8bb80acc147929c429786f7d189fd5a,ransomware,1713620,6591,13381,13333,19924,13381
8889,e8617a1fec496e47497c1517fead32ad1b2f460323474f9e021c2126508251f4,ransomware,3194625,12356,24936,25035,37391,24936
8890,e883bf43123ce89f5d4b124cd80c161644452b6624271e98ff91e6c6317e2b02,ransomware,862542,3123,6661,6658,9781,6661
8891,e8aaa22a6ef598e493b4ee79141dc1552d12979aeaafb3b4dc20f23da027402c,ransomware,1870801,7170,14587,14627,21797,14587
8892,e8cd970cb10dd55ef538cb2c2c916db69bc10478df17ad1f0353190cf334c7e9,ransomware,2545171,9785,19883,19884,29669,19883
8893,e9214cce82e26020345226b346c8f2c6db967d07dda566cfa000a4801b2cb73a,ransomware,1446308,5566,11232,11249,16815,11232
8894,e936061b0decef0d4de73b785c8bba8d5dd61650552a47c71b22befb88784acd,ransomware,2648673,10267,20905,20974,31241,20905
8895,e97040932e1f50f341824327e5137ef98a117c2a42348fdcb66b31687a01c244,ransomware,2413598,9265,18754,18758,28023,18754
8896,e9f2545fe0e8119933a216fe67025a4879f159c7f79027ebba49feadaa19021a,ransomware,3151133,12236,24631,24621,36857,24631
8897,ea083f31c85ac5d0c980d07eb31820b828626f01766c528ca1d64eb1a1931078,ransomware,1314467,4771,10295,10855,15626,10295
8898,ea8199751bf382c0f1bcce707f5f659f74148ab43ec6ed24d4106f2a5d9d9488,ransomware,1566909,6003,12241,12255,18258,12241
8899,eafab840dfd9c9f21a1bd4acdbb77b39c21822305dd116abb3ace17355ebc65b,ransomware,1610818,6161,12509,12527,18688,12509
8900,eb7902fe86ceace116016f74b5d8b36bfcb9f8670abb3576349e81441da6a380,ransomware,2318422,8929,18163,18052,26981,18163
8901,ecb128eb9db8a5ac6eba7319d4e5a536b4e475ac1c3a57e537975ccbaff647fc,ransomware,85859,319,683,652,971,683
8902,ecd73c4249302cd111391da952deb7640c2894c032cc240656a3c8253ca1b08d,ransomware,3341952,12917,26173,25965,38882,26173
8903,ecdb4eaf5a7484619a3afbec7ddfe95964092f446bf0a7dbd2226092ba43a4fe,ransomware,3474596,13440,27143,26995,40435,27143
8904,ed3b32473553180004662ea1d1ae2d995921ec2d90f0ff0b20133a59d48fb58b,ransomware,1814835,7411,14519,15045,22456,14519
8905,ed48fb2ea7fb3f22094354e95f7dda31d585a81922e199a112568ac8adb0a9ea,ransomware,3267594,12628,25574,25477,38105,25574
8906,ee3da15414211d673fd5ee868b50cfc69d731431e5fc3148eee0d40e7615c1bd,ransomware,2223862,8458,17446,17719,26177,17446
8907,ef18fef6aeb579502202e586187d7c0cdb9ea9a5dbf286fbb734f62d811b861d,ransomware,2793439,10757,21800,21709,32466,21800
8908,ef8d739428c0a04fe60510b479c2e564c22c0aab773f07b69e119fbcef07b6bd,ransomware,1483428,5699,11520,11539,17238,11520
8909,efb1515333af4fb7fae5a6991b905482ddba52120a28cc5d822466a4eb796ffa,ransomware,3096258,11949,24225,24182,36131,24225
8910,f0309d1feead6124bb52b78cb9b05c03674533e28a1dad63f606054dedd157d5,ransomware,2916798,11267,22727,22571,33838,22727
8911,f04a4881d37213378faa3fe35d48849065aa78d7d3e97fd79210f53e970bdc38,ransomware,1331440,5170,10298,10586,15756,10298
8912,f0c08860abc5f109c6e53af89249f3d816e9d3ee8c05ca0f35949c2a9d9f455a,ransomware,1718227,6575,13385,13311,19886,13385
8913,f0dea2d47e29bbfc82da2d3e7a42ef59300fb341cf0b06e45312d97b90477584,ransomware,3482656,13464,27271,27069,40533,27271
8914,f0fbb5bc88af4c6f919f98cb70305d964daa3278c7c1ba1707116da833be3af0,ransomware,2185569,8248,17180,17453,25701,17180
8915,f10dfcd1872ba9fe4cb9556fc7b143ef6e66904048a6ce265f66bc8ee028138d,ransomware,3476262,13413,26976,26984,40397,26976
8916,f13b502c0a6d55f01c26e480c3d182c9ae398ffe8316ef8a68b82ff4afbd9e33,ransomware,1129898,4311,8819,8892,13203,8819
8917,f26a44cb26ecabef6a944e8a6687df0fce281e323435a0afa71a31896bde0270,ransomware,2924596,11118,23013,23105,34223,23013
8918,f4cc139b669f29e39c63c0a9c48550d3e40e02aa53601cb5e11daf3b2d45471d,ransomware,1541147,5892,11961,12025,17917,11961
8919,f5671742e4711659eee014e4026ac6fe218d7cfbda5e2f34b744da5311e49e52,ransomware,2520703,9597,19803,19868,29465,19803
8920,f5ae33e367b654ae0175be81f76cd80d35823873253e64bc95cbcca95f7490be,ransomware,2776917,10712,21725,21649,32361,21725
8921,f6109edce20914c66905bfde73ff7d6dd0cad5ddd71cff347e8cbde4537fc3c7,ransomware,3465088,13573,27086,27096,40669,27086
8922,f62699be9e568f4b3fbf1131966a44421b07e1927ec7c42abe9b8fd95c0ec5ce,ransomware,3415445,13202,26703,26520,39722,26703
8923,f6996ffa27d6904d1d88343cfca099a1d458a112ce7e8fc64d0f36dcaa24acdc,ransomware,3100813,11988,24139,24105,36093,24139
8924,f78fb207484419d6e3a3da66fb02c5b99e4acd848c99dd6726135f3d1a47afa7,ransomware,2872607,10893,22755,22649,33542,22755
8925,f79686209ed662302b6b13d6a9bb341c1282aafbb7545e7418199504e43d9ffc,ransomware,2490426,9638,19477,19509,29147,19477
8926,f7d8a8d00b2b36104811661434f230b22de0af6d7eb837d57c4bed0643273932,ransomware,1927275,7477,15010,15026,22503,15010
8927,f82a01648e1d9904ab8cd82d196ed30badafeb497951211f52a78c65f27d9201,ransomware,349524,1344,2671,2803,4147,2671
8928,f8653b81f2675d5eaad8cdce63bb618674d8986b98fee3d3b732601fb759eaf6,ransomware,2891597,11116,22645,22629,33745,22645
8929,f87b0a84d2ee5451a292109d9d9a92f0bb81d2349095ad87f0556c6d6bd37cf7,ransomware,1978880,7535,15451,15737,23272,15451
8930,f8e5216dc42a9b182d17ae7f675d63ddab8b3a696effea7c72a2cd93a0ca9209,ransomware,3403876,13132,26568,26459,39591,26568
8931,f9815cd450eed2f0f0f253905254d6ccfbfc6e12c9d0caef2d692dedbc0fecc5,ransomware,1814201,6972,14117,14136,21108,14117
8932,f9942b96a93715c8536beb2f61e734976a6b718b5cccbaed05eb2b094ea73f32,ransomware,2866312,11035,22366,22430,33465,22366
8933,f9bf86423b825240ed950298de0d8181a9b6f8e1647f959b1d549922856f8808,ransomware,2111275,8080,16401,16360,24440,16401
8934,fa39b5f9f021b00099f278f268aad7a6af81946dd217eaf01361d1d032e2a26a,ransomware,1190320,4575,9291,9318,13893,9291
8935,fa938ace3b029313820b5648647d81f235f243a3c2f455d684aaaf0b2e016662,ransomware,2045712,7701,15959,16398,24099,15959
8936,faa777b7fea17fac558b389264a2acf1cbb2a2a5963cfe9f82e7f3a7c56e4dd6,ransomware,3252755,12594,25405,25217,37811,25405
8937,fab039ca0dfe54f8f6dc4f43a61e798bf4412cc7adae49b5832af51ecbee43a9,ransomware,1290562,4957,10047,10001,14958,10047
8938,fb0d0315ca0146803939419c1bf35deaabfe1d522a81255b70dc136a7a7a5266,ransomware,3035396,11798,23709,23561,35359,23709
8939,fb27e78cd4cba316b4bdd65305fe5f3475154055a601967ff873c0982f0d31cb,ransomware,3484775,13492,27230,27084,40576,27230
8940,fb667a472669fac3e6c2de75d3cbbbf3340d83e48aabe373398b8ab441c50841,ransomware,3088045,11953,24094,23947,35900,24094
8941,fbaec908ad4dcdb5dadde1953aa5145b318d877d4531445b3a289aca0cea228d,ransomware,2855729,10991,22342,22323,33314,22342
8942,fbb606b1aeed9e794b1fb22752579d2265c06d234abfc43e1aa1b6e4e11b42b1,ransomware,3408795,13170,26612,26579,39749,26612
8943,fc186dc2796709eaa66b9f3843d79447dc3af07baab43623617e8caff08f7a5d,ransomware,3455572,13368,27020,26824,40192,27020
8944,fc52955e8e7c90454a186f32127954885e5a0e74f754a8d04cb60357b4fde015,ransomware,2295144,8763,17985,18170,26933,17985
8945,fc86090da7c37aa4e73814434e5fa04001e47c9199c2bae254b3b3843fbda994,ransomware,1181790,4379,9375,9912,14291,9375
8946,fca4053c673504510ee824b8c00228a8fc77be40bf94873a1c3035af4a111f61,ransomware,2675853,10124,20930,21072,31196,20930
8947,fcc253c710a55eceac70c94910c97947ea2a33238d8d4a319e92a91b54e740af,ransomware,2048504,7800,15985,15921,23721,15985
8948,fcd8cd2d09b38fbcc45265a67af47696370ccad165828b7d5d193ea3381cda9e,ransomware,2700234,10480,21141,21040,31520,21141
8949,fd5c8f61b8218998063b491d2cfdedadcdf831a7925633c307961cbf5062d527,ransomware,2144261,8328,16821,16732,25060,16821
8950,fd71e9f034cc354613fbe6b8988d79a2b5f24920530b462bda72872c91c7cce6,ransomware,3193465,12348,24970,24843,37191,24970
8951,fe3f2fc87a0140d4071919d4f8c6d4f15bfcb0bd3f9940e7cf79c7e91f631afe,ransomware,714460,2746,5554,5745,8491,5554
8952,fe4544e0e91a69c47b67bb6cb5caf76264de7f71e37f52863c151df9a145dc6b,ransomware,2345988,8979,18305,18563,27542,18305
8953,fe7b12848210007e24734fd4243a1b61b821de11a48e3dbf25e78dc0f166ffec,ransomware,1377936,5226,10843,10957,16183,10843
8954,fef3fca8124aadc5f54578ec457be4765bebbc208091db56e827a3ae7a78b2d6,ransomware,1471933,5562,11669,11820,17382,11669
8955,ff201140741fbeadb2126d1013aee57cbfd1b1d206a05a3e5a9470608d019bdc,ransomware,2952688,11397,23026,23250,34647,23026
8956,ff5fac32dd52ad2ab71a1f08b07118923f83ce7f9d613d664daef98068e2bad6,ransomware,3362877,13029,26270,26221,39250,26270
8957,ffc6d5254e4955bb328ef76695ae411f8dd9aea6b758e9d317eb7f2b49a7bce2,ransomware,3355630,13015,26245,26377,39392,26245
8958,00795104f68baf68b5a2763b6c7c403b11911c35a5c8ae676d81d28de37487fe,spyware,345599,1382,2791,2775,4157,2791
8959,00a65e659a944c19d16b519cdd5a4a7c67a1d80d8d2a1fb35e8cf102c191b7d5,spyware,45366,196,345,380,576,345
8960,00d4fa5fad8b97323e06f15e58a6711c8ce32f0067084d49b57539c37b32dac7,spyware,372639,1437,2954,2937,4374,2954
8961,016ea67cd9551b7fb1bba88b35b4d2ae3e15d14b57f81f017baaaac0fbd8cf19,spyware,73133,330,544,596,926,544
8962,01b2a394f6b739c861705ed617e7d52f1a052c31ac013b41766278223bdc0854,spyware,345611,1386,2796,2770,4156,2796
8963,01cb4da284f7896956a7358f0166c58667c2b7ec53bcd9c3d47ea5125d32b22c,spyware,383481,1572,3057,3172,4744,3057
8964,01cbe45b8549b9bb633373e2eb28dbf976c082e688b7649ea7b94d9d8409aa0c,spyware,389960,1503,3093,3200,4703,3093
8965,021772513df3ba5f30519b2285b69b24f40c1aa4c0db886fd0dc66a979ded91e,spyware,345550,1379,2786,2778,4157,2786
8966,02a8f3f3458fcf831cb8f27c9387e68b55df139ca04c8f8aa4b3e71e9e95f33c,spyware,50182,202,438,469,671,438
8967,0390a14f80c65b23e96a66f9a0f2142e8308e4293bfba97c54a6faeda7051b40,spyware,369089,1453,2999,3091,4544,2999
8968,039b1a7d876a555b4889cdbed6ae2815dd2e2a0567fef440793f7c0fe73ab57f,spyware,330961,1304,2642,2571,3875,2642
8969,03b8fccc8eb65e501184d7fabb169f828b08c3fe21d120a2bd6ed4f30e51d7bd,spyware,31137,105,260,230,335,260
8970,03c53152c5de44767a785fad38404315e133780a040f798c6b33a8605aa54ca9,spyware,55439,228,449,494,722,449
8971,040345ec71abab18d79696aa27c029db0daa7fd399904ee78ebfbb27e71ca91c,spyware,328945,1300,2645,2625,3925,2645
8972,040cd3118242bfdc7ea407027762b6301b0c2773c2023298c3a59b963f921bbe,spyware,47240,204,422,415,619,422
8973,04555647250e1eff304502695ebf54964d7a1fee3175ca62fbb60036618652e0,spyware,345297,1366,2758,2746,4112,2758
8974,04704d6805c9678bf3dd1c3e605c76740ae0fa16f0c57dcf48aa46086b8a2901,spyware,345285,1297,2792,2810,4107,2792
8975,0474c7a6f659fea300181ea2d80e095a261e33863ba90babf6d190416fbf4f13,spyware,345579,1399,2756,2710,4109,2756
8976,0490aed36406022188adb222cbca9b8f82088fe506b499de71eb41da18614c5a,spyware,345276,1328,2711,2780,4108,2711
8977,053d2961ad90eba74a99ce31c37367fd12f74744e918767245085135cb2d7428,spyware,345741,1338,2769,2800,4138,2769
8978,05566e6b3d606805b50011ef59434cd428908e21d1c394981588d1a62aeac846,spyware,395827,1465,3117,3282,4747,3117
8979,05d086dcce1d0d439b6ed9f7eee803430d9ba169751a3ef603aa134c5e8fc01c,spyware,50216,241,399,401,642,399
8980,0629a00b6f123a5ceb1cf19f446fe3e82d5d5e6ca3643ac073b9bfc29c3c8cc3,spyware,12830,68,98,97,165,98
8981,062cb54bbe33a4de04548306bb380d18e225f4973101863b8737ea143579470f,spyware,390034,1551,3138,3165,4716,3138
8982,0637901a06427b994312b801fa199baa92e49040a3433e587145bf280927f198,spyware,357852,1372,2877,2877,4249,2877
8983,06a2e1f18c76a35efa09bef9bd6cb05ff51f4cd79c63734482798f07b870eea7,spyware,368841,1545,2948,2911,4456,2948
8984,06defa90aaee08518b3e15cb9851fa6bc90fc075c0e5121f7368a3e4121d6476,spyware,345783,1376,2787,2782,4158,2787
8985,0707f7c217b1394c368c053271d7e15fb27447778e9ef8c1a11638e979217208,spyware,357692,1391,2813,2839,4230,2813
8986,0726eaf8e674c7bfc557a3f226d2d3afd1e0b1df5784f9b01c6c0bd3429a0fcd,spyware,20347,91,162,146,237,162
8987,072dd3397207a55470d2e6ca6821b64332d3f545875179e62891ee91fe8ddf36,spyware,73126,364,575,574,938,575
8988,074ad57855dfe4db9c1d056e34ab79fa5e483d1cb5f3f16588de7e600bbb96d1,spyware,60902,280,501,465,745,501
8989,0794b976e59a46bd7dc3f46723d22014d3705b897ac0c2453ac8c7e1e7f3ce6c,spyware,73133,306,548,598,904,548
8990,07eedf2d1c817623a9086b3f0d33103071bb50f990d5c5d5d7ec3e74b6206a0f,spyware,21742,86,204,192,278,204
8991,080015c747a6a965c4220a72bad23eaf81eeff1691c1fe94c04c21992c39770e,spyware,51187,233,457,417,650,457
8992,081ce5723155b886894c33e15cb1a5c6a2e5934d4f9f3df4569318d5acbf7c7c,spyware,345955,1338,2799,2734,4072,2799
8993,082db171df206fe6e3143088cb0540f97c81156ae7422e8dc710312838ceea12,spyware,345412,1407,2766,2707,4114,2766
8994,084e19179b3ec17abb42c305f70d2c09f489e4496988273e8819a4114d6e34e2,spyware,42845,200,340,344,544,340
8995,085fcd88b1b1d5fcd398e67d766918b110b85ff9ca7441c602dabfcb7c61a7bd,spyware,48346,180,383,428,608,383
8996,089b4bf17bc168b62127a0f60af1e9ad771c05ad430a96bc0e0db162873530c0,spyware,15303,56,96,125,181,96
8997,08a2ca2d549fc896659c73adbbc2f180339fc33c24929ab58a6aabb695fc9bba,spyware,345304,1293,2783,2809,4102,2783
8998,08b0c977b6ec1e6591d60f927af8207e5944b862905cfd6de980ac4cc6419676,spyware,345801,1367,2714,2793,4160,2714
8999,08da67e36613f971b317d8f646b08b22262fb20d35a0e44dde60009e7d86724e,spyware,351972,1434,2891,2804,4238,2891
9000,08f4667a45279aea749ac217db325e3f48f084d68c828123b9c27930ea27ca00,spyware,355014,1318,2831,2911,4229,2831
9001,09004654440e6ffe70052da973a850639386f6211ab8771a47e241f64781b0cb,spyware,341192,1377,2677,2754,4131,2677
9002,0920bee83bcc5c20e211c5980eb35344deba84c4bdace14c7e4091bcf6e72bea,spyware,50154,256,390,445,701,390
9003,094b61c021c2b263fe042bf5a1bcd83bc2dac6681ec703610714a281bc03a0ff,spyware,73129,324,533,592,916,533
9004,09b312683510e6b14a8d5800e559497a0cdb4c41a65b975de9c6980ab6fd4a30,spyware,320624,1249,2564,2468,3717,2564
9005,0acc95d5df4d3a968752a38acd89a563055c510e4b694aa53f612762ad9ce2ca,spyware,75189,300,545,625,925,545
9006,0ad0ba6296d72a582c47c888e8838043215dc90a1f73a2586b1d4fbf220d4a84,spyware,58828,269,555,486,755,555
9007,0b22a2d965d965d5fd2ab3c063000e10b467f256c644c40cc410994dd5780ad3,spyware,16899,53,143,134,187,143
9008,0b24e20565cbac038e1d21ec5e095a5b6726871d84eab2ae6e2a0d4ab7045952,spyware,72224,336,547,617,953,547
9009,0b60cecda55728581d584c08991a00213c46e287ccbc44fa71a4ed153ad239a1,spyware,43783,202,392,373,575,392
9010,0be3544fb2186e823f1dc5cc6eb1867265fd8c741e27adb339de81a65fad6a1b,spyware,47895,178,461,424,602,461
9011,0bf54d587cdbaede13ba6fbbac3a658f643fac7b420f18e89fe80cfc7b5f39ff,spyware,1278630,5193,10143,10180,15373,10143
9012,0bfa7528381fbb8842491a3c7154aa08034ed408354e9d4f51e35ef60435bff9,spyware,43798,200,337,325,525,337
9013,0c0062c4066687410ac6b7b7e6819248c06a2c65cf4c0427b2ca00f93b606729,spyware,73128,338,587,591,929,587
9014,0c0bbce662a368028c28ff265075532a5a995b17845c05d15554f10437a7361f,spyware,73130,313,555,587,900,555
9015,0c15cd795b1031f497f499e12e1cf7b825226af4c54246a8b286f108c5a39f3a,spyware,450215,1760,3654,3630,5390,3654
9016,0c2983d6e4314df240577687e60cf40d8e833f02ca6ae8f5235a2ae25ed2731e,spyware,361470,1397,2986,2906,4303,2986
9017,0c384cf1962d7c755e3974edb6d735ca8cef7a7faffc64ad1d3e5341f38bc127,spyware,345289,1324,2683,2738,4062,2683
9018,0c5729d6163261ae11594b335311577f752bc30d5a4c304721103e6595a48ca1,spyware,355588,1417,2859,2779,4196,2859
9019,0c602cd9c15d610e4894b204c309a77e40bc044c08d020512542f23aaed11a02,spyware,345266,1374,2763,2784,4158,2763
9020,0c912082b7ea9b57fbacea3babd10d67b0153f6dc52f0bc60ec665ffabb0d581,spyware,889675,3562,7060,7197,10759,7060
9021,0c934607e7c3f5b755242d71a78fba9cb1ca02731534f901ed9608e440005e3e,spyware,348473,1383,2898,2739,4122,2898
9022,0d1ed724b81164627d626eae3ddc8002c461176faed1c189ac829de3accca841,spyware,390330,1538,3139,3177,4715,3139
9023,0d2c1c5c6d95d3123f8c31647239b653580a7a0f117d3bc7cf99436abbd8b12a,spyware,13392,62,104,88,150,104
9024,0d4e940de9eab895b9fab384996c80ee888f173e1a76189b4335a0df58563b8e,spyware,50511,213,480,430,643,480
9025,0dae1e8efd71d22113e7e34c69fbb0d7dbed7f542cdfd12187d0be5b16d37ccb,spyware,73129,338,533,551,889,533
9026,0dcc877896850d7621d4eaee0075746c9f7cffe5eedc0d99a7d44897f52c5a99,spyware,73126,349,550,618,967,550
9027,0de43e154cfb3242e5b7074b9ff19c158222ee282b5cb012a5b24e2a11242047,spyware,13782,52,113,104,156,113
9028,0e44dfd831c2fc9f783e6d953bb582d3dbf6026e5dad3fee1e1dbaf7089d2ffc,spyware,42656,199,351,405,604,351
9029,0e6d4ae12582ad5591c0f56dad1b7cad7b763297be78b54cbb36ec575a2928c9,spyware,8117605,31547,64120,65280,96827,64120
9030,0e82d533b7e3d98f4c008c5f182912a75ea95c953093a767e7a0bb499b5400ca,spyware,73128,314,557,580,894,557
9031,0eeb6c2e3732259819269ff2f2f275286a13727fcb788368ad47dc92a097d6ba,spyware,56032,306,455,436,742,455
9032,0efc689a24fe1add1c1b21d7af267913f41d6c00ba9af45c5d49c5d3f1e04d0c,spyware,74047,350,556,591,941,556
9033,0f0b45e7906e57e15465d6030afffe250bd96002c7c74f326be7129468a5e498,spyware,909361,3532,7171,7457,10989,7171
9034,0f77ba04ef7d828c9947918bac28abe550a5af83bb363bf0eb1582d20fcb4bc1,spyware,73132,323,534,596,919,534
9035,0f9de6924c277e8449ab87a263ad789f8a197a0cffe5c45bdb6cde81abd2adab,spyware,68611,301,506,570,871,506
9036,0fc356d92a887fd1a3182ff98d201772e2215f7716492fbf318dfc67c4aef69a,spyware,345578,1397,2755,2707,4104,2755
9037,103d2709645309ba533616bc2b13fde18f5ada5b9e0e374724f6e8cf4b28f30e,spyware,386396,1505,3081,3109,4614,3081
9038,106065d06e9b7254c258350ced29fc0ac44da4576bc944293e1619aa925d85a2,spyware,345593,1307,2784,2770,4077,2784
9039,1061db948678a7f29e8580ccabd30450892410af6f4a98fcdff5f66f7e796820,spyware,361891,1376,2868,2974,4350,2868
9040,108c833e270e2bc07de0b0e5470882b82762ee8461a97a75d1402f8dda91fff6,spyware,345664,1384,2777,2763,4147,2777
9041,10cda784d8e5f4a195a9ed6b101a8159dcfacd393f35c10be064647a7473ac16,spyware,74434,303,560,558,861,560
9042,10d86f8cb964d704532cd2ccb139b17fcb64511313550069dc49171a0aca9efc,spyware,385279,1472,3091,3117,4589,3091
9043,110dc36220fddd646853128b68314331518f5c7f298cc27f4cd6ed35243286aa,spyware,17730,57,125,127,184,125
9044,111784b9481d15f51f429e59a96bd805b4f19a47a3d3efdaabf4d34a824fde5f,spyware,55916,259,460,455,714,460
9045,1198942c58881a825dea0eb1e0f074be6791560f422fd9eb7fa036c027173b0e,spyware,73133,304,558,607,911,558
9046,11a2df5adea3c51bafb4181e9e890ba19d8fc6ef5fac826c500493512e858035,spyware,73130,314,537,585,899,537
9047,11e0e62908086394e16fa2a67edcaff8a559763f4b17daf34af7371e9529c5e2,spyware,853024,3417,6859,7002,10419,6859
9048,129ca1adf5324c90f55797384a3a20b970cd1fac4d6d9a8293e10efd6e8193e0,spyware,355486,1408,2809,2903,4311,2809
9049,12b96b21abab0e45694c76cd9e7871cbaf176bf7fbb912c448d42accae2bf120,spyware,43245,202,353,368,570,353
9050,12e18a9cb0c8a6fe3161c1636a2e605c20a45d01a497628bed72cb4335a87297,spyware,74042,356,515,584,940,515
9051,135bf4971aff0804bf5d72018f11861e7a4032e3b954e69476ac7462718ebae3,spyware,345418,1326,2787,2759,4085,2787
9052,13c817ba96775dfc3185d7e6b7539be97514ab8a2b158d7bfc95c810d9f26376,spyware,355320,1402,2914,2823,4225,2914
9053,1449daa89f1b65aaf5395f5d7db5efd224c12f2e746230b11b7e2707c77e4f93,spyware,345640,1349,2796,2757,4106,2796
9054,1494e177033a3e2f9d1000cf03af8bb00faa94f78dc7f32a4c12c53b808e5903,spyware,74042,324,540,616,940,540
9055,14b6ce570ae40005852298a8701b1eb036be6f527fa7ded84b0a58359979f174,spyware,345602,1392,2798,2759,4151,2798
9056,14bbd9e3bb26ae90578150a6026a3989a2589e5af369b8c0862502af73898b56,spyware,235367,911,1861,1955,2866,1861
9057,152ac08a033a52e8527766adaaf23b5d9985380952bdc0b5a80c2fb28332f791,spyware,597304,2316,4847,4862,7178,4847
9058,15414ee38721e4da7f6df34a859153b1143baba15b2851435cdfe7d3a469220c,spyware,345280,1365,2749,2754,4119,2749
9059,157d3f4d146f130014e6bca90e337deb935c195de328eabe6415d98dcfdc930c,spyware,360230,1488,2890,2872,4360,2890
9060,15979dd0dce65fdae90aa13c19c1c1f241ba05424d73c1fb974437cfaf479c79,spyware,74045,347,549,587,934,549
9061,15bca517523c56e23e9bba95dfa7bd1f1ab01c6b77501484334691b4cec733ef,spyware,45629,207,363,369,576,363
9062,15e58daa522f82cd79ec72591b857e5206eab6d54e70aee8433946fa46276bcc,spyware,73684,308,538,613,921,538
9063,168948014cd7f6bccf0a7a6451f7bcd54379a5e8294d6dafe228b2a32bb4a2ce,spyware,70482,286,574,557,843,574
9064,16e62624aa2bbb964d2b1b535ddebee329352a82ee2105c889c07eed73c896ce,spyware,73129,327,568,615,942,568
9065,16fae92bbd6a03308a16f8795348093b892131711b71584a63a1869ea50973f4,spyware,73133,319,543,616,935,543
9066,1733c80604c36bb1c6d6b3729b9f31f3c059bdf256f3869b2e32cec6503455dc,spyware,355345,1401,2845,2821,4222,2845
9067,1741de526b79e6345382d4baf35b36031c1fc99816242dbea16add88480d16ed,spyware,74055,355,567,580,935,567
9068,1769b2322d11099a172db50840a2f7c86840cff4da28fda12a8d8d3cc7965dbb,spyware,73135,334,521,611,945,521
9069,1820ad82f1fa3bccd1b53492c0fb89040afc48886ec5cd642da1f08e15071e7b,spyware,73130,338,546,620,958,546
9070,18406032fae3a28d3e27ae0d1ac2fd328037c26c02c234ba9b4278aa65b22b43,spyware,345305,1298,2791,2808,4106,2791
9071,1859a610564c6e3f71680552269a3e7df7248da6d3dc70bc713404d2d2b1dcf4,spyware,345616,1334,2776,2765,4099,2776
9072,189550ea3ac23489c2cb1434c18565baa5ae6d64879b0650f6703f2933fb688f,spyware,72527,280,555,609,889,555
9073,1906c44a7ef4718b4ed91f86e80c9107dca1f971f3d0d48899639d34ee2548da,spyware,73136,324,540,579,903,540
9074,19316865337bb5a1fbec48bdecf77aebfc7e73d48bec424ef6cf5fe5ddd02fbd,spyware,347441,1338,2819,2782,4120,2819
9075,195a26d3f50bd424f87d4ec121da71a527d07ea391300b8360dc5cf3d23801d4,spyware,73134,318,562,572,890,562
9076,1a257762c73b718240b2c4b8c1cc6670df375e2fa5ce21637ee415897b7d90c8,spyware,506173,2041,3958,4209,6250,3958
9077,1a38de23a1f323c690b938f1abc1185644ff8994879d35b14b634875c340790d,spyware,355346,1396,2852,2875,4271,2852
9078,1a62178d960027a842f05e2271f9714ee292cd236ef23f1e5a942d1885bc470b,spyware,401844,1588,3172,3281,4869,3172
9079,1aa0c7ece595eaba35c10982543516c747556b95fd4b60638e84676e4ae09169,spyware,74045,338,573,605,943,573
9080,1aa71296b0e1416eef0edd3aefbab0c6b19e5c555f0ee946627f3d4ec0590d09,spyware,345570,1307,2786,2774,4081,2786
9081,1ac8df6d27258cfa0816fdf9f09d14d49162c0c4be796f3db8bf07e54945458f,spyware,73127,339,530,613,952,530
9082,1b4213ca2151ffd613b777e6cb29fb4d3e65c70e4d9ab130b83d0f44058ae9e6,spyware,74049,340,547,609,949,547
9083,1bff6c3438f477f75dec07a3a80bbfcdf3a033421de1340767176b3ee822bbcb,spyware,73129,349,534,611,960,534
9084,1c32a83dd4ade4f464eaa8e6a279e1ad5caf54d38c4c95df89cd2f0edada1c8f,spyware,1495115,5887,11583,11970,17857,11583
9085,1c6751c2d06a7e7a0ecb3e310cf54b6778d4530c016f19065a165b15a5430d7d,spyware,33620,133,288,289,422,288
9086,1c7c0573a0ce98199991cdaca0c5f851f4fc8a7750621725c5e36433a4d224fd,spyware,399206,1599,3166,3260,4859,3166
9087,1ca093f8e10841b58cbf3eaa2b63d410f0214d64bafe965759a5d1a49fbe4a43,spyware,73130,341,577,591,932,577
9088,1ca5e3864b138deec3a19ae58a4ffaeb7560ce5746ae13eae4df3f59657e5f25,spyware,58283,252,471,546,798,471
9089,1cc93715f1889cc6c0d7fc2ef7a17388103ebbf8d1d5612fcdb97d1d1f7cdb83,spyware,374661,1374,2934,3133,4507,2934
9090,1df007847195bcc453ee59f7340ff0361aae88395075feb97839c6e2558c344b,spyware,47928,230,429,323,553,429
9091,1e574b2059b11ff6752520625a626b687c1bff1b0973b4dcf312fc3163b1f891,spyware,24417,100,196,197,297,196
9092,1eea0778f175a778d282c3aa126057bf28675a82ffe348a4684a3707f308cef2,spyware,74435,312,580,593,905,580
9093,1f09a4b50dbf29397c872c856c75499da1da29b8d428eb85340868f2949faf83,spyware,72525,294,564,620,914,564
9094,1f2db3da23fa6af82231cffff473c5dacd291e5a7aca8a841ba9ded59b77df57,spyware,73137,324,539,600,924,539
9095,1f317884bd47fbcbec4709c43d2c72f7c3cdda64b2e793eb0a0cfdd2b49b8b10,spyware,355455,1366,2763,2850,4216,2763
9096,1f6733b359e9fa291ffac7f94606506b4425cf4d45efab9a322537225c7e2987,spyware,345678,1332,2768,2813,4145,2768
9097,2012203c576c255e10f0d60df29a176f36d83b47aa19d6b260597eb6dc67489c,spyware,73131,321,550,603,924,550
9098,20dab65a4310de603a0d00e4f1aaad6053385a05b4bdcfc5dd544e533e1f0460,spyware,345622,1344,2783,2803,4147,2783
9099,20ffe8190fcbf965022b0bc6bdfbd7eac02d3b2beaebc7165f96d84f34a12705,spyware,345444,1383,2791,2769,4152,2791
9100,222f85764a8d45dc1715a43bb5ce5dc9c7f910e53eb80a0644caa88547bb8e10,spyware,73136,324,575,574,898,575
9101,22928af2cb8a5c1ab057e5a56ccb7a57f5db3737f4fce771a7300683aaba8eef,spyware,345656,1307,2797,2782,4089,2797
9102,22a7e347cb0c424b33a2599438f2d38225849da6b16e3dc0910f01e41e55044a,spyware,45366,188,379,367,555,379
9103,22b4713ca500a32bc09d9e4be336e499ec700cf685c1d70831f15b48abd4534c,spyware,72216,340,543,578,918,543
9104,22f235b760f61b12486f666005f09b95f8cc22d6dd8cb65b09cccb594fb255fa,spyware,380418,1398,2954,3156,4554,2954
9105,23244614adb05bf6b1797e9a2a51d49ef02e928b83228c9f361d927ea672f314,spyware,355615,1421,2842,2785,4206,2842
9106,233883c546fbb4351bef7ad5a7a9080cd83479bfe6d170d3d9d3a63ca0dda0ff,spyware,73136,372,558,576,948,558
9107,2348dd6d8f2c8900fc9cb01cedd65a0e275daefc53fd8b3a75f7f9dcafb01ee0,spyware,345472,1337,2755,2819,4156,2755
9108,239005177bc851ba05d70436e8de5c42948c1294be7e5bd47c89dd8026ff5a57,spyware,397991,1641,3204,3224,4865,3204
9109,23ed273d313bef85bfcc2b56b12f2b457425c2c22c54ee4d6e8d237117b999b2,spyware,20825,94,171,162,256,171
9110,242892bd03a80a449a4fc2ef2e05de122daf0405f1dbead56af77a5bc7003460,spyware,73133,333,552,596,929,552
9111,2442244d8cfa3dd9a256077195238dc540934eb502a842245fee5aaa169263e9,spyware,371967,1446,3003,3045,4491,3003
9112,2455bdc83e2e3c4e3a82afb357d720bdab19364cb73c0a8f8c1b494bbe8c40d6,spyware,30893,137,230,220,357,230
9113,246348da6670c1a7116904611076d65c375428da329460dd69e66f74c9c3a952,spyware,345565,1380,2778,2783,4163,2778
9114,247d1a7c539255e02fbafa8de4f9e9b5bdc6979ab65005e8e32751390b7474b7,spyware,345775,1386,2784,2790,4176,2784
9115,25456781358edc09397eb4c69b3401f2236444281eb4ba684d5f6553c5a1c490,spyware,46864,191,385,407,598,385
9116,257fa70ab9696a69654d527f0f6e5834dd504a7134d39db691ae534f96912b24,spyware,14763,66,121,121,187,121
9117,2589c1838253328564311a624e35ed09fd6ff138c3f523953352c1fcb6b6ae53,spyware,345810,1337,2781,2802,4139,2781
9118,25d5cbb56b094307db64c60bddba331fe5fbb4ea1453369a4d5a4262020d2aff,spyware,7270836,27536,57274,56988,84524,57274
9119,25d6aebb94a826ca8037c7bb5eba69f84550476b726c65304caa721f7a2fb581,spyware,910098,3548,7111,7374,10922,7111
9120,263e80e4450fe8e21c00d021d49d418ace1cf38c4d617c1aebdecc303feb17b3,spyware,74058,307,545,564,871,545
9121,2656d2f44f3f62b7ec099f0f538e183dccb90761ac7dee8db7ceda1da71b4bb1,spyware,345414,1402,2761,2720,4122,2761
9122,265cfb05cba60a5385baba05e19c41296dcf55102dcb3c43bbdf6a61f136f54f,spyware,73129,332,536,587,919,536
9123,266f8f29cdf4365caa96ba2977bf917d5ab3212e37f5dc692c9106ff03b12a80,spyware,73129,334,558,569,903,558
9124,26755293fcd9a9882e9c32cdc17e38bc3355f0c139e704f1de06c8d5be80e7ed,spyware,68105,299,516,521,820,516
9125,26e41615c1a240c7ed5c2fb28c0ddefb831225c0243f0f9d995c97df9c3e74d9,spyware,6953642,26108,56166,55087,81195,56166
9126,2702edf4380754ffee02415fb0182e7d3ac19495bb05d4d9f5e1c686fa769359,spyware,72252,311,542,568,879,542
9127,2715db7c57379520d7988d635b5b8a54edace7a107b1c616463f4102b6113f2a,spyware,45666,218,391,401,619,391
9128,27459599b39cb922e270d09d4c1ae3e954e9dc48ec4e47700a0fc29e5322f10a,spyware,320901,1267,2498,2578,3845,2498
9129,280624c4b9f45e1f22758a6f8f60a0b11a3609eb5c48a649e8303d1915e393d2,spyware,371157,1434,3054,3039,4473,3054
9130,2812881b284ec9dc9bae5311903c20e57b2ed30b2c284299185fc2ae08cfad63,spyware,49908,181,381,395,576,381
9131,28ea4977a130f3a59c220aa5aabc9364fa1bb84015ab5f80d00a4cce77a56272,spyware,12620,59,109,98,157,109
9132,28f1985d46fc6d99f608c31cfac9e58ed791ba5c8e6f4750b2e95604c03d68ac,spyware,574601,2281,4538,4763,7044,4538
9133,292cb8fd6e51c137ce1a6560d54251b2e819b9cd7e57a8c8750d4b839e060e50,spyware,351781,1348,2790,2798,4146,2790
9134,293bd2a597f5438ee6bab7c7527933234a7b8c8ba1f686161ef1b82651d7b9ba,spyware,40572,179,338,344,523,338
9135,2949917ffc708a28a61f62d9a21e780a45cfd81ae86428a518ee9ce4f8d8b118,spyware,328126,1234,2669,2605,3839,2669
9136,2980ca39551faca755d6a5a3218137d91e01731fcb84d9ce9d372df755941f5c,spyware,345265,1374,2748,2805,4179,2748
9137,2a70e3e5c88555c88a4276e2c0d1a4e9994f5b60a1a83af9c060490a9c458a94,spyware,73130,343,568,592,935,568
9138,2a781e38c7687fdbf67eda6614112a31e1d04b4a708e16d29644bd66316f59d6,spyware,43323,209,380,318,527,380
9139,2aebaa5f583967ce16c5939017d99553953cb74e699fcc94d860d9bf7f681b2e,spyware,51813,229,401,447,676,401
9140,2b4a3f2de91376dcea2c143fd4419a41d915796bbb6c578b0630e7cfba55aeb2,spyware,73133,311,560,617,928,560
9141,2be0899f99a8cc120c64e8d6d2f2d86361693c3270eab8b1a8dfc7de7ec82fff,spyware,435020,1765,3516,3667,5432,3516
9142,2be71cb9b1f70b2a6f8dc0b7b90b9e751ff766de0440b2e72013c144267ab946,spyware,69052,283,549,551,834,549
9143,2c1a36642b081da655970b6dea9469a99d6ec3cdb99d3ca53d81acdb2922aaae,spyware,2460268,9588,19543,19508,29096,19543
9144,2c35e172d78cd1eada5aedaffe8544a650caa4d0087850d7649da4338b623292,spyware,70482,287,545,575,862,545
9145,2c400ed54b9059f19be15f6acab5ec74372479fc399feeffe1368135dff45878,spyware,14794,64,105,103,167,105
9146,2c5bbe38283dff8e3184620dce65a920ae013d33e0ffe642a2e5703dcf6ae203,spyware,73130,325,567,575,900,567
9147,2c7ef9cf18eecc27f95e489c66206a9df2c615990e8f39f7190e63923c74d859,spyware,345570,1337,2722,2808,4145,2722
9148,2c863bb36a9775fe58e74263ba28d6089d851a7150569c00b1b47e6171c2b15e,spyware,345744,1336,2880,2794,4130,2880
9149,2cbe11ea64ccb9214c5334be5dcf6ae4253fcc88980fa71b25f8e45ffcd1f4be,spyware,345276,1378,2745,2794,4172,2745
9150,2d40f302e0e74f0beb852b5ede1d05d864aa635de4135b624d3e70fd1e7f5285,spyware,346427,1348,2817,2775,4123,2817
9151,2d532f8de2b480600fe97fe99b723a4fd34836036bc46567a71e426197477422,spyware,378040,1448,2968,3000,4448,2968
9152,2d817248b4eb697bd602ec9cc513889c4c5c79721952efbd856edcd610df7d61,spyware,366861,1475,2957,2896,4371,2957
9153,2dd4d9285ecdc381aa28fd393e23bfc691de6d1ab697c565c5c9b60f8aa14f64,spyware,470978,1888,3891,3829,5717,3891
9154,2e00816f1dc933128fea3f03f322e0a408fc7170277a12eec8441f690ba5a788,spyware,70480,306,547,543,849,547
9155,2e1029541fac9fc9c8044242fe6e356ca4a8786927a3cf0fb298847d907bafe9,spyware,345272,1373,2754,2807,4180,2754
9156,2e228f4c19987c47ce04792da8166e1234d9e36e0c2c93ecfb075fc6ab42136c,spyware,405037,1602,3252,3324,4926,3252
9157,2e4db0bf8cd3fdc5c4d739dc10862ba215d747f1140e2aa61227665e5d2134f6,spyware,471492,1918,3772,3819,5737,3772
9158,2e4e71a2e8b005949dd248fa6f47b834059fb06bab4958cabc8bf8bac6a06aa7,spyware,345283,1344,2766,2770,4114,2766
9159,2e6f61c3a8f29066c149fd7b4c9dbeab7f9c77db1d1f60d2c0e5061e965d601e,spyware,73133,318,578,563,881,578
9160,2ea50b7e8470b932429d0681b010e6fb215352d83a5b1711ceafd2b29142f13c,spyware,355204,1427,2853,2899,4326,2853
9161,2ed39bd742132560d4955fb9c299f94924f060acff14887ce1449d1838e69e18,spyware,6736,30,42,50,80,42
9162,2f257350fa5d61ec91b33f90d12d287a41aae46a1b5efd4951d27de583aa8627,spyware,347055,1342,2780,2786,4128,2780
9163,2f6a684ebe4998479eb096413d27fe57a08398ee89b76182476125fe2d2f72b2,spyware,4851509,18983,38169,38171,57154,38169
9164,2f6c6a77c466a97b16123a0246f7662b4e8c9441da616fd9c874a41630cfc65a,spyware,330881,1378,2686,2559,3937,2686
9165,2fbf6013a4414d490d0a8b021f7d59a73d3728727adce6ed7b1add1884f7314a,spyware,429832,1693,3442,3465,5158,3442
9166,2fd51508790f0f628b822e983781757b38642fa69d68f4064f519883f753f643,spyware,58258,223,485,496,719,485
9167,301aa69491c46901bab688812f365d4759de70d2458d36ce74c0243855eb43ca,spyware,361490,1540,2911,2994,4534,2911
9168,3025e1bc58737fc43f4aab0f34b3e5bb65620dd618272689f247297cd0bf3a1f,spyware,397738,1617,3184,3078,4695,3184
9169,30ad5536889d0735e787c4a638c62d5451693184dd38a9296ba74036c552fb5a,spyware,345409,1376,2688,2710,4086,2688
9170,30ec192f4b202b46d20afe5ef79069ede83e318b77ab971c942e1c63b3e2248e,spyware,436850,1780,3500,3548,5328,3500
9171,310e2ddd61b2613a410201114abfeb7711df14c78e64cac525c7db804bccc72c,spyware,328703,1313,2630,2585,3898,2630
9172,31605eefd6c66df4ab7d48797a8ba0780afff66502470fa62765858da7c3aed3,spyware,345906,1372,2761,2816,4188,2761
9173,319f27ffff1dcffe3484e73ac71f6670c085b696baa271cf99700df4f8018997,spyware,68819,280,566,563,843,566
9174,31c6eff595f4b089e84947242e50ceb0e1c284fdb7958feefc198946e901dace,spyware,72228,324,552,613,937,552
9175,31d08e1422770c603b7e9499a39e4b7bedbc4ac5fe5d1b5c306326820862ef15,spyware,346077,1417,2711,2808,4225,2711
9176,31f1bea347623dbcf2445b45e57c939e196a74b26e0930fc8af2735544e190ee,spyware,72386,392,599,586,978,599
9177,326df0837b7649187abe0179f138fbfc8c5d79be309e065e384ba65f894f68b9,spyware,355665,1338,2886,2886,4224,2886
9178,32e38a31f065755ca0b5ff7c6deb0b681b2992707a16c908f93a36bb432e7c20,spyware,345841,1381,2804,2780,4161,2804
9179,3326fa88101c69c07dc32e9a0df899604e73079546cc9be16be3239265af0407,spyware,345639,1385,2785,2758,4143,2785
9180,33fb8cde32a0e6a32a5a103c5ab648b660e6de43fa7233b607ad8e7616804bea,spyware,347140,1399,2814,2809,4208,2814
9181,3446a50d4e585eca715ed2ff545ba9e87d5a9954516898cce15e1f7d1743dff7,spyware,1234833,4819,9732,9884,14703,9732
9182,34f744ab835f23c3d8416b403b362adf8f978f7dce1cf5f4d1c03a52792cbad7,spyware,57205,221,451,496,717,451
9183,351b3e2b697831f6251f07c28112475d6e315f20363c3f6460e7650a84667882,spyware,320933,1270,2533,2613,3883,2533
9184,3539f1c322fa5d87d557103fe8a187c72607b8d6ef6a974aca20e403b6b4c474,spyware,345627,1353,2785,2750,4103,2785
9185,3554ec0633caff1b41788daca322be993bf3e6f72f58d0247ea86b1c3629d53a,spyware,368220,1484,2957,3066,4550,2957
9186,3566470e271fcfbf23090d7376e35a2ce1043bfdb74d59146e159d031ca3740d,spyware,47054,234,361,395,629,361
9187,356d2ace44d645a7f920fd287b918d56b8dc14b9d37ea5c7414be98e1dfcf9f3,spyware,333018,1334,2609,2672,4006,2609
9188,35800715fa1815c9f7a8460df0803ab65dbe468092bc5e8479fa7809319d5b52,spyware,74030,336,543,568,904,543
9189,35f7a5e8d444efe79a18f45798d2f253bbda000ecd2d27cd0432507a751ed477,spyware,353509,1366,2858,2844,4210,2858
9190,3674673123e1c1a9eeb51d9106d0a4b086ea4d120c5b99208d600e0d8d91a820,spyware,347989,1349,2793,2757,4106,2793
9191,369570f0aaf8c019bbd41f0a3767c0b76c5e5e88661c9b6e3d46dad8dd6ea2f3,spyware,75162,311,532,644,955,532
9192,36dce595c85c9023d3b0b11b87ab39aee76c2c8b9c1a5ae8feeab5d458e59822,spyware,41952,189,344,313,502,344
9193,36f56c02c5e06c1530a2bc4b3556eb8b1a6ad735641a684c696df4e9889fa66a,spyware,397744,1479,3132,3247,4726,3132
9194,36fcf67a7734fa56eb673172dc148577ad35de63037724116fb92f1a9910a709,spyware,62741,301,569,546,847,569
9195,37c08c4c77886c4e27d73fcc303a5f57bfef45b9e73439c27ecb728f59b0645f,spyware,31151,122,254,242,364,254
9196,37c165b4104aaa89cf15185129d3e2bf2b656290fd5c0e3403aaf9542789f30e,spyware,366422,1389,2933,3049,4438,2933
9197,38997165258bbccb4cec2bf88a6d1e92a0431bf28e6d0fadfcba8fc2ddff7ce8,spyware,49815,258,414,411,669,414
9198,389a4ff3a2829aac1e53b45662b7e0ce8f4c91cb809283186ad6b5bb07dd7c5e,spyware,3043743,11926,24024,24434,36360,24024
9199,38d3f23f2a1fd39e6e354cfd4fe6bb8da10f12002ae178d827203855c00a95d1,spyware,347321,1370,2743,2808,4178,2743
9200,38dcc609a06f93a0401bf00b38d5c3c3d56678c8bd57943f40a4ca0723c60c8f,spyware,772372,2985,6146,6157,9142,6146
9201,391e0bdd86461c181f3d1eb07bae8ca4ce6443b71ff9e1125f97bb0696877ee8,spyware,73129,328,527,588,916,527
9202,3922951615b4f76dc8016e827d3aca3e57d818c67766d96e28a10112627cde95,spyware,26365,84,181,245,329,181
9203,393dac56a7753ac93b0f11dcfe6ef8dae5d9b7b9eb3defc1da65fac93e122b8a,spyware,345414,1406,2762,2726,4132,2762
9204,395cbaf323679b2aa028f44a7ccb1b17e5fa7265aa50e68708dd34fad47eb84c,spyware,345541,1345,2762,2809,4154,2762
9205,3964a40984e56a810c42ea04c3ff4a4f91392f7269e3cd9b60e9d72ad97e1e14,spyware,73133,326,548,594,920,548
9206,3981561fa28ca08a1d0500c25552f54038bf8aa8e680e89b9724a60995d3b9d2,spyware,345540,1379,2795,2773,4152,2795
9207,39b8f365118eb9835e0f77b34291f959116680a96c773daf33b65ad6356ee8d8,spyware,386935,1516,3019,3145,4661,3019
9208,3a10cae9411c2a03139a741da2b79e10c0b0216b7f845fb68bb0ac4ddf5e657d,spyware,73127,342,545,581,923,545
9209,3a8735ff8aea01640bf5e9c6fe614cb390f274a153de3405aed908d4c0bffbb8,spyware,328082,1247,2623,2664,3911,2623
9210,3ad68c10fb379a53cc6a543d87c998c7f8b9f50b6ad1929906987cf2cb3184c7,spyware,345573,1327,2788,2772,4099,2788
9211,3af9d2ca8fb0d6eba97bde4d4188784a991e39f56e66f8cee43929ef0f485ba4,spyware,328725,1285,2568,2595,3880,2568
9212,3bb618765f2cc723d7f039a7b589106356782d788a52aab25ec8d23cc6cd5ba3,spyware,409823,1614,3304,3281,4895,3304
9213,3bfe08f664b1c4d51877dc5675c246b42f4a46f3be8f4cb9b8b57d2bead568ee,spyware,365923,1554,2942,2957,4511,2942
9214,3c047b0e3223971134eeff711a4f0d0e47a6e9e48bb56fd3afa8802d573c4538,spyware,73128,337,556,578,915,556
9215,3c91dbc6b1cde2753d6655531984f4224e79aff4c69a0bdedaa8a6803989af49,spyware,1289477,5088,10227,10273,15361,10227
9216,3cf19b61edba75b8634205f2b6386647bf5cadb6ae686f9b168d4d4c274945cd,spyware,360783,1401,2824,2957,4358,2824
9217,3d044c23c572e7f4eb283a5dcc6eb34ac323eeb5581ef0fc1a48047d1e060f29,spyware,73133,316,547,569,885,547
9218,3d0fdad85be3f94071756345aa7c90873ef4f98de277523263851dbac8713ff0,spyware,345724,1347,2773,2795,4142,2773
9219,3d1bfeb21b18459a9cd760186ade0951367b8c60fa96158ecaabb380b499ecbc,spyware,72336,287,528,581,868,528
9220,3d58884a586b6c9a54b1561bba039b382aaa80b84d11111155ee36498f993c2e,spyware,355359,1385,2855,2817,4202,2855
9221,3d9c2e338bfc648ef1d5faea0fdc37d017dccb4035b566aa9fc7d367a76f5be7,spyware,73133,338,564,565,903,564
9222,3e5a718f24c7ab80a9687d997e24da3cfbe126603b245a419455c0c7cb985e67,spyware,46761,165,381,367,532,381
9223,3e5fb5c237a3cbb473b01e85ca9b8b74f6bbda4fd3da4023653ad2d76c7d419a,spyware,37096,131,300,336,467,300
9224,3e73e2f1b32be54a39c0f51b526503c09e6d4bfc91d9b649aac38ba5513008fc,spyware,70480,288,532,576,864,532
9225,3e8511c7533011b905bb9db564fbc1627416e817a754d152cce9a48c82a93771,spyware,50659,241,427,434,675,427
9226,3f0716e958442571d692a861da153e0afc513e7c20eb8da2d72823a55c660af6,spyware,55547,306,492,468,774,492
9227,3faac6998f03e727e9d011552ad49f3f745b9661afc3d14d95f12dd8552acf59,spyware,71855,357,545,570,927,545
9228,3fddcd3413cd8567c2210d9ffe3bcaf4ebcdf2de02dabdd0ce859aa1bce35ef6,spyware,74042,358,547,563,921,547
9229,4058fe5809c42107bc89fe78af4f255715e04370770b0fe2ba4e0fe813472a5a,spyware,398211,1565,3163,3204,4769,3163
9230,40a09bc4a88186f8506ee534475a2c3e711d480c018fd5a0b950c98268e8913a,spyware,603094,2327,4804,4831,7158,4804
9231,40cceb88f696996f4f0883c2306bc94b7ed91ed7a737d31b6ad2049ab31be936,spyware,345289,1377,2758,2803,4180,2758
9232,41194c5d1f1f92509c6222958fe90a5c8b072afc28d57074e5d3bf47fd09a409,spyware,73130,317,551,600,917,551
9233,414eea187defcdf9fd5b237d727a09add5456aecc6988bb1bcd5c4afb13ea7cc,spyware,16000,40,132,141,181,132
9234,419b655e4e5cbb4fa890874a600ce52dc6ccec76e0d6463c05da8ee4c99b2d7c,spyware,20406,65,187,162,227,187
9235,43125eea248f0e6370355a28a434987c622227b7722c4b7f228af5c030fe9bf9,spyware,73140,338,533,557,895,533
9236,43592d80056bca1ddd472937495308e90d49ebbf49df261f88224ff263deea33,spyware,345629,1349,2792,2760,4109,2792
9237,4361f37220fabfe6a0b776ce3b2fa4cd3d73750e3a1eb412011279e0b818d107,spyware,398228,1568,3147,3151,4719,3147
9238,43ae2ae6cc617e7bcddb3a8c7f0503bfb90229b5addcc9c2d7bfefa5e36d1d1f,spyware,345589,1323,2773,2751,4074,2773
9239,43b9c7457cd63babc4780b89b5471c572658eee5618022ac3a17eb6783519fd2,spyware,36577,141,263,265,406,263
9240,43ee2585fb5d940ed0c2c0771a8d881b4e16ec752be6cfc943be47c52806716b,spyware,48002,179,353,382,561,353
9241,4419c77967be9ec2df89dc1fad306dd498a5c3c2d24dd267d815eaa89fd43256,spyware,3708206,14373,29535,29054,43427,29535
9242,4440571ae65283fbb4506ebace38099bb1be1f61137bdf587f511570faf0f030,spyware,73128,331,577,583,914,577
9243,44a9932071ea9ae5ab8d65fac6c06d74406bba952010195c51e677b0c0121ae7,spyware,62476,287,495,575,862,495
9244,453116c55495430e4d7f7278caff4731dd52251cba7cec45cda3fc8c568e99e3,spyware,73133,348,545,613,961,545
9245,455ebeec788242d796a29c16880cef3458794cedef2b34fb1a3cbb035db51e61,spyware,345733,1337,2770,2715,4052,2770
9246,4570a18a49c9a442d50ebb7b758c64c45d672641e81e167c136e9b73338ad628,spyware,41933,281,331,348,629,331
9247,458ead60a4c1e4b705640eadb775896efbe25fef48a0272177ad4f85c70230a2,spyware,73126,354,571,574,928,571
9248,4594371c040efec0b6b9a736484b58a09d7684efa58281a4715d853b1469f915,spyware,46102,173,382,411,584,382
9249,45cb2e974070bb23c57904690c271827fd69e69902fca229820e589b8635020f,spyware,397724,1498,3165,3284,4782,3165
9250,461cec7618cdee745d21bbce1bbdd0e9d57ae66a129f2fe8aa682974d0cda8b7,spyware,422408,1615,3397,3441,5056,3397
9251,46323279e20fd2a04bd9c0927173e754068fb6e0e055d876b60a5f118368d32b,spyware,74036,338,551,585,923,551
9252,469601ac9a3958d03f2ed0356edce9b079f1fef4c23bc5bc03dee3afbcff5f7b,spyware,73129,316,570,608,924,570
9253,46ca6bf7e7323dda3156df059f07f2c67b1791ce6fcf594a593ea17ac8cf32e3,spyware,11418,42,87,70,112,87
9254,474cf7163389ef2770c873500fede82fb07f163b616d83f75501077f02c0a446,spyware,353635,1387,2859,2816,4203,2859
9255,47769733d67593f0fa6acff799fd34f00e234061a644ad63206e9921cffe4ac1,spyware,346730,1392,2771,2725,4117,2771
9256,47f2b531e5f293856ca0145ebe0c80777a901f4465d2d99d3e70627bf76930f7,spyware,853033,3435,6870,6985,10420,6870
9257,47f72c94c492501e3ca024e5ae66037fcecccea8777739cf733fc45142ce4937,spyware,340460,1334,2700,2718,4052,2700
9258,488156199fbf8e14bf347af80524454d3faf17742aa737a5e004e901ca502252,spyware,395845,1457,3114,3286,4743,3114
9259,4892019b33334bd925782ebbbd43e58a11f6a7b62044d16b5d78ae4fdb3c09ed,spyware,506815,2072,4014,4139,6211,4014
9260,48ab1d7ca3083df5e3ad500a78d8ac210a8373832fb2869a94cb316d94e05b3b,spyware,72539,312,527,591,903,527
9261,4960a012816655da9442b2d0fb1028da02a838ec1a7e571199e3cc5843b21cbb,spyware,397741,1551,3122,3241,4792,3122
9262,49971003de1e4f1bc2ea7b33c6eb5eebfff4da3ec405b824db56dea728721a31,spyware,20871,88,144,178,266,144
9263,49a887177a9aed885969532aaba5da655ff4d5d354ed7121cf2347d3947e54fa,spyware,45082,277,381,367,644,381
9264,49f9b452ba83b05aace7514540f2f88a4b85ee846cf658937df2428964bd9529,spyware,345414,1377,2699,2722,4099,2699
9265,4a28005a9fcd85b58f1481f053268f381e6cb92f4309f7063441d104ba342d8d,spyware,345739,1362,2755,2768,4130,2755
9266,4a39e0ab2fd6c784610047fcbc3341f00b35a9b3395d2fac0c21eaf799f32531,spyware,41518,163,323,350,513,323
9267,4a4ad854ab8911718b8c9abd47204bc0e98cac454ff1f8058da2b9d4de8d61a6,spyware,70713,332,531,533,865,531
9268,4a5a604f61d059547742fd14c16de0e2a48b69cd57f5bbdb80d95bb020370d2f,spyware,376802,1569,3014,3100,4669,3014
9269,4af81a04c73aed788ebd291322d582bed8b5c0532d721113b0924b5730c2f5d7,spyware,356106,1402,2886,2889,4291,2886
9270,4b46825a3c024913f0e2b1c32f4f74adbd057094f88d2c74043b17dceb97a5e9,spyware,429834,1699,3437,3466,5165,3437
9271,4bad21b330b5f25b8e94439edda57bfeb9e09e4cc1d08bcb5f72c4eae3166073,spyware,346187,1353,2773,2814,4167,2773
9272,4bc595cb17f44c3676e6e77c7dc8f2e021edce28fd5c0235105d95228015640f,spyware,345727,1382,2786,2779,4161,2786
9273,4c08918b1a4b2389440c6a5de61bd822c9b48b546b1bb15b5b119673ed401e18,spyware,398074,1538,3165,3126,4664,3165
9274,4c12bf882c70e69fb7447c7ed10a0c3a6d86b8d31b4b79cee165533542b090a3,spyware,345702,1331,2770,2814,4145,2770
9275,4c4ba5f1f5a7263dbcecbb75ef02cfec0945f543cc5e1699610c662612698288,spyware,49382,235,414,380,615,414
9276,4c56898e3dd923835ccc30a47743b48df46b3017497d842fbee9f53238e47bf0,spyware,74042,356,516,584,940,516
9277,4c714f4729d506bed438891bcbc366e310d54e8be20825a6de8588c946bba680,spyware,345469,1328,2772,2836,4164,2772
9278,4c975962a518ae960a02ab8b729771e73d2943494bf1bd61d69b41b6af0dfc40,spyware,345280,1351,2753,2744,4095,2753
9279,4ca8bcd831dd06134180cd30095c1a729faa86cd558013006ccb0bcd278fd680,spyware,327233,1335,2576,2569,3904,2576
9280,4d082d454b56dfbc054e2b94334e3bab9a28f54efa5c6fe6aa497725957e85f0,spyware,345553,1340,2779,2806,4146,2779
9281,4d0e16df42e1f38f541623d4813499f838333390dd23e3f914171e6db59b7a93,spyware,73132,316,544,592,908,544
9282,4d12f35a3c6e02c8f465e346a7f2c4be73f8c287c57c8d59df6d93df3b3b9695,spyware,74415,312,564,606,918,564
9283,4d3e0ef41f8c3c90d2dcc271ff128bb1e24e9c71f18310f54f179c96812a1fa8,spyware,18718,69,135,150,219,135
9284,4d90469fc09182912d6c7d9a8a0dcfeb30675e77ac1fb26fbc4485003654443e,spyware,84341,351,652,648,999,652
9285,4dbffb54cfac185740cc336d28e9e8607cc5f07952c26c7b1a94dfa1ece34cf6,spyware,74427,323,524,598,921,524
9286,4e123b09b6672047ebcf1f061af537e4d49d27a6406f88a9a7c335dd57d67e3f,spyware,53673,284,416,502,786,416
9287,4e50c1c8bfa142612c33d232ecfcccbfbe941dc465275d389bfe38173c42e22d,spyware,366156,1353,2884,3069,4422,2884
9288,4edf22d3efc76566bafb383747153b36d6bf12a1c1991e899a49ea9575f96ecd,spyware,345283,1382,2752,2780,4162,2752
9289,4f11cb7d6c6bf0df1302094e8cb1ecde8043346bfd12d1efc85ca4e0690db123,spyware,53859,220,429,455,675,429
9290,4f5409d596ace9b4a25e95a8990a65a4409cdcd5331f1b8fe666e1c4dd728cc3,spyware,67544,258,505,528,786,505
9291,500f98fd7e3ed7a79a9f0ac687633e8b827790e5449e2f039a66ae862ac108fa,spyware,345619,1346,2774,2796,4142,2774
9292,5025ec22277cd34e4d24bd18a8c86d20955bd56fcf58922f86876ab11dc67a9d,spyware,375662,1532,3074,3017,4549,3074
9293,50803fcd752ce21768647f8604d83efbf21259fbfb6c041c2c8322e5edf0e6d1,spyware,73133,327,534,581,908,534
9294,50837e4d02232b54d8b7f070783d4fbed0f8cc83da81ace67167db8d299ea270,spyware,73134,348,543,596,944,543
9295,50d9b08dbcde0574ea6f617492cde641bce8af788a16930e147cae4ce35ea691,spyware,73132,341,550,610,951,550
9296,5149a8d603c6e381cc29fe3bbe358904190b96be2e07d166ba0659f929d5bc92,spyware,6815463,26612,54876,54539,81151,54876
9297,519478e16a5dea22e26fb11a681d62890faaae7545e5a2ecf6a3de8a3deb93aa,spyware,73133,319,543,616,935,543
9298,51db1be312b1e1743fc548183376317c20833e2d5a586e54aef7448d10eb7c73,spyware,40381,177,338,328,505,338
9299,51f174aaf590db35e04871863341e50d32e2357cde58bc34ec6d96d8532c0715,spyware,379302,1477,3024,3077,4554,3024
9300,53b033a198915f500ffb0164da20b3a033e288ea7f0f54200a3c14ca2eb48003,spyware,73130,332,566,613,945,566
9301,5405be8db1b5f5ad87df04f03243b407098de703a34a1fae76e190948c853fc7,spyware,73127,343,552,563,906,552
9302,540b7280f20d2a37a2d91d7020d767be556f9d5682b8cdce226fbf3d896e5575,spyware,383075,1486,3012,3163,4649,3012
9303,542b37f36f255ee5b1f8e2a5b7139f491eb37fd56fa7070cc2267f209145236b,spyware,73127,342,545,580,922,545
9304,546f63dbf60e20170193a6d9da2b690e94e37dcdeb82f6e4b1105b0bd4d30d90,spyware,73128,313,566,601,914,566
9305,5473d78d03c79bfdaeef5b26d64d37c1b15314efe014cf0c4478531f84ff671b,spyware,345410,1405,2754,2718,4123,2754
9306,5572d899b2adf2230a5bdc7b696f7d9ec4bd09a395e4ee6fb4b408eaac2802d2,spyware,73129,320,553,563,883,553
9307,55f80e12253b1e8fa452def1b772025f00f316e13f90741b92ac2bc59802911f,spyware,345366,1335,2830,2750,4085,2830
9308,560d145d8a54066ab31e27b5cf923c0759ac5e9cb7f65a442103879c8bb41539,spyware,355432,1405,2849,2838,4243,2849
9309,56134c8d53af3d80f6e823bd9f689e9eaaf1dd3482437174705901fca188c5c4,spyware,73139,335,544,559,894,544
9310,573f8108e4476e62899a8de52bbbfb45715c2db2ce336e7c4b09fef3f8789655,spyware,73128,320,586,574,894,586
9311,574aa974b41e5f9a704272992c869de618a963f0b7f42641777372bfc6973c10,spyware,389866,1513,3123,3200,4713,3123
9312,5778a5b84bcbca3904eb4d0a2818614634ac1c44cdf690ce790140dd5d508429,spyware,73136,372,558,575,947,558
9313,58b0b8339de6da2d9f7377fbf9771f246859b229d327f89c0a21f468940583a0,spyware,73127,312,564,582,894,564
9314,58e85e66990143ea1635a5b770c17cf937e60777f4980700706f2d4a95be3369,spyware,74045,324,545,596,920,545
9315,5901ee949c6910d5e608911bd11c5becf9a1d7b5722791f15ea0e9a649e7c44f,spyware,345413,1382,2796,2783,4165,2796
9316,59c95ba8ab49f0af22828172edda986d30c70420ffedf9d8b0e5e9db874e5e37,spyware,70485,303,580,548,851,580
9317,59e9e87194c2072152855ad031b5c1fbc46732b79d85643cc056aceca9b8f803,spyware,346070,1327,2771,2752,4079,2771
9318,5a7c5cfac4db86d2b1ab114084638c521dc4811a6cb500339b10fdd67bac4ba9,spyware,716727,2814,5760,5897,8711,5760
9319,5a802a711e160d1dbc27c2ca83a7194ae377327a17b6f72a0ea14e7c1eb16f13,spyware,43546,192,359,366,558,359
9320,5ad20d8c7da311a32e14a260b28da227fca6eeb84409958f17eb3a3cd611f99f,spyware,73128,327,532,615,942,532
9321,5af5ca1fd8894302219b7e158aa3437dd24fe95345cea0c3cda66f0661c0eb13,spyware,358093,1376,2875,2869,4245,2875
9322,5afb2c3f7bea34417042199714f7d33342d4c6475af7f4b7e640d4e45179b0d6,spyware,43111,236,349,391,627,349
9323,5b193e063cf244f6c59efca2da6ae60a71bb517d1804c4b0a6e1f15b93ec2ada,spyware,346708,1326,2783,2828,4154,2783
9324,5b9198ad073010e2a3a8b79e85eae401a409b9f278853d3fbcf0f741e2e5e44f,spyware,345276,1350,2779,2772,4122,2779
9325,5bb13904fc6f9e166426f7440e72c073cee50faa96f7e897d63e96bbb0e4db0f,spyware,365152,1497,2957,2997,4494,2957
9326,5bcfc36e2e0571d533b6ad89f537fcafc42bb927f9e6dd77d939e42beb76e660,spyware,345852,1300,2796,2754,4054,2796
9327,5bd58db4aba6cef5b3c15aa9eeb9cf6da117863fcfaee115a171ac5e4d61eb1c,spyware,19301,63,129,177,240,129
9328,5be52fb9a207813304fe30124ca1af81e1f3e788eb9576966104b97c5e829e62,spyware,345958,1371,2773,2829,4200,2773
9329,5bf6293462026398eb4c9b3478c7f637637f521dd189bd9df3347de51cf78f46,spyware,19070,78,164,142,220,164
9330,5c0a14746ce5d5c172ff3ff8651f22c25407c0832b629730684ecccbeed52412,spyware,54683,236,465,495,731,465
9331,5c84fe7f706a99b337a10f11390c3616682fd5531d4a9970d678b15f41b119b8,spyware,345401,1326,2784,2742,4068,2784
9332,5c9796089653f6d0298a37d0e2243be3b640a7b338b925ae3f03fd2c6acf91b6,spyware,82404,301,699,671,972,699
9333,5cef13fe5ff5a9ca5958f797f985e5b127e3a9c68fae97b48395c1141c7e6938,spyware,72383,322,575,613,935,575
9334,5d219ee959eb0810740ebc50fe267bef62349ed041dc98072456c34407526e21,spyware,6449994,24882,51271,50210,75092,51271
9335,5d36dc7f8fb005df4855d0fd98ae5727b40c76520dcfdac109446c5c508e23a4,spyware,355659,1344,2864,2883,4227,2864
9336,5d4fb19044addad07ac229daaeaf4f742f565219c92d2a205d70c631e355d878,spyware,69025,308,521,557,865,521
9337,5dcc6801592c2ec0943158962841cc8eab6f703a34ba1f512b32eecbfc818603,spyware,355515,1351,2862,2880,4231,2862
9338,5de002e5bb30925ce5b6a20d7b65553aaa24483c157416eab1f017a3d79a654e,spyware,361279,1420,2887,3003,4423,2887
9339,5df5375e363538bf654a3557351ea70725b3c8e58d984f66a7bc107c3ccd67cb,spyware,345422,1410,2746,2706,4116,2746
9340,5e283a6296424670af75c49bb0187c59160ef9cca2e25dc9528f0e7c4eb69b2c,spyware,366604,1519,2980,3019,4538,2980
9341,5e585e99eafea6b4f02d156749443aee26179c0acb1cf1eb7c0f195c6a5ee276,spyware,355205,1414,2872,2808,4222,2872
9342,5f4a889689d95f940f09372a161630f81b306671b834ac0a347393618bc6cc69,spyware,73132,315,582,611,926,582
9343,5f4f40b8faae9d0df9b6558efe8d895fabec0425d07471af867098c1f5a663de,spyware,73129,345,545,582,927,545
9344,5fa8f2a34e832a46f07d744f3f7b1632cdc0c76064b220ad5cb69553aadbbfd5,spyware,48800,210,377,417,627,377
9345,60326de561110f612c61cd3f9029b267bcff69b1edb7f93fcb8c127e0c978de8,spyware,346018,1335,2783,2814,4149,2783
9346,6166963fb6f7b723e711612ff155824f808cdb79607aaf1e26b38f8a8b0f52bc,spyware,41245,176,342,313,489,342
9347,61707f2759e3b4715bebad5ced7cec52411859eb65427c041638f69da0f70da5,spyware,70515,313,493,555,868,493
9348,61836869dd4f1d97b15e305f8ebb5ac965d6666148216645372966e703963f63,spyware,357394,1464,2856,2960,4424,2856
9349,61965252f4159c722f35e7dd51e5be3ffa5d858de9055dd9ca5c4fa25d0a3f56,spyware,333162,1315,2702,2601,3916,2702
9350,619658f2baeb5f39a84f8b30a417d717ecc9bef352cc52f37fe893c4c764a8d3,spyware,384300,1494,3050,3080,4574,3050
9351,61afa03a8849b84713627c491382c42555481ff00850ee93a20e25bd0b7ee11e,spyware,49607,252,399,390,642,399
9352,61da224f891ca97d1eb7d3856f360f6d30d07cfa1f7164587a9c50c9f3a8f500,spyware,345270,1375,2751,2810,4185,2751
9353,62034581741a5b458c27e29671be91c083ab655c5308652bc3b4c8cffbfc28d2,spyware,361498,1395,2884,2980,4375,2884
9354,6289a300d4920ba7e4ba3beeb5122a96a615032452ed1307a234f889de3deb26,spyware,345599,1317,2795,2768,4085,2795
9355,630f92f83f94d9d9a15e020b48ad0bd8c7662736f0c656ac9f0c8ca145270aa4,spyware,345553,1336,2724,2808,4144,2724
9356,6329f9b41d595a7b992c8df43eb2b9a9be7df0c4afba4653f5ab7ba5290aebee,spyware,345288,1330,2689,2747,4077,2689
9357,644bd87eb35ecc7bfe44f2457bff001f38436101b14a36eebc7c6d4c519981da,spyware,11359,42,90,94,136,90
9358,645a6ba5479b989a600bfb796ee906cff3c74f55f26c7ec693b6c189470e719b,spyware,368191,1416,2905,3073,4489,2905
9359,645df0321ae3b96a3bbc541e272f2027ca08960a78dc6b53c2e493b9c56658da,spyware,345283,1380,2739,2791,4171,2739
9360,647103cd5e7f0531920a6c502e7fb07b0888a25397ac5a2c8dd8f8a99c8ddef3,spyware,345818,1363,2808,2748,4111,2808
9361,64727a3819862b4b8a6e3617a8cf7ca63daccb07363802895e6c9fb0ea349716,spyware,73133,331,555,604,935,555
9362,6484206b94fb89d0b692c633c6aabfa9675522f1715b2c17782be437a204fc63,spyware,49922,155,471,439,594,471
9363,6504119796fd88d0b1ed3b7c4d58cf6616572e9af5b5a7a802fe34b03dc69d29,spyware,361551,1406,2856,2925,4331,2856
9364,65451bc34139cbb617b9319e5cdf796fd112bc91f427847b3e09096a4a2803e4,spyware,345755,1322,2813,2764,4086,2813
9365,655a6b420a4750ab4acb0354d8d411f718bbaed148838a068cbea3ea9ef8c13d,spyware,340479,1284,2823,2742,4026,2823
9366,655b2fe4e7725a1b225f7e2a3db9ad0c3c5ecdf41a48edcb4fa92176d523f56c,spyware,62408,328,522,513,841,522
9367,6575aeeb528ce5ee7ae51b41d8f215fcc9c2ef1db0d9c809093e047612345e62,spyware,345279,1373,2739,2838,4211,2739
9368,65c872d0cf273f00c8267be3f16b6adb988f5c4038b863a7a8b9d215017f819a,spyware,443128,1769,3594,3623,5392,3594
9369,65f4ec70594dfec4117046e2212cb43f32247985d7c3c8b230e7d5add8e6abdb,spyware,345275,1375,2746,2789,4164,2746
9370,66853b82a184ba0569f294e91eb513422c16be00e5f7f7a68364b8fe51ce3938,spyware,345849,1335,2782,2742,4077,2782
9371,6698075b1ff5c327eb2d049791cbff848c7f77b412a93f70d8afd05cca9ae48f,spyware,70682,289,551,551,840,551
9372,66c20fcc38deb3c0d6c80eb8ff737735a7a8511bdc48014f0542520373a88f34,spyware,56552,227,394,460,687,394
9373,6748ed8c5ec7d1c0743e0d75a98074b95e94330ed5b20cd602374042fde6dbe2,spyware,345270,1290,2785,2795,4085,2785
9374,675209e3d588de746df6be53cfe9304dbbbd9d1ef7911a695b9f3183043860ea,spyware,345576,1320,2780,2758,4078,2780
9375,6797bc811da558943484fc2e904002f12a2403046808209068f8d75cb67c72bd,spyware,398042,1573,3177,3201,4774,3177
9376,67b6d0d3541c860775611aebdb47eab205833793a56b60fe0ac73deebfae6c89,spyware,40139,142,330,393,535,330
9377,67e068ba0b9924a443af723ade3fac718df4a96e9406ce4ddb8f4929c56c46f2,spyware,53871,319,431,430,749,431
9378,6802aba77ba7c8b52a357c90765d6c0cec1769ce0598681a46981df4d4c6dd85,spyware,345601,1369,2753,2767,4136,2753
9379,682e932a5a92104c6ca52f7a7b0073ec8fe83bb37508f765c586d0ef5ff0495c,spyware,493036,1904,3978,3991,5895,3978
9380,684c497c477cc6a418b00cebb20f334179c55642f62bba7d3eb6cd05a3b75799,spyware,345297,1364,2766,2757,4121,2766
9381,687193ee17f1ab15c018ceb23d689a113c7d5a98e43a05be340df3566f39def1,spyware,345593,1330,2773,2751,4081,2773
9382,68ad8a13c4d0071e7d607bdf6c7f23c75136647b1b8cf40b38aad88c9b94dc82,spyware,368703,1534,2975,3030,4564,2975
9383,69166d7bcbec57ab93551ee4c79d6167e6812fa37f2e193d5af39a4905f36bcd,spyware,407711,1599,3395,3252,4851,3395
9384,694993c88ab4f44323b02c3dd9961bcf4c5af6938c7452a6b46479e40dc58582,spyware,36999,231,318,293,524,318
9385,694db2385aea97adbc7361247d97d72ffa33b515bd26eb51f3d3fc67775c85c5,spyware,74047,319,549,593,912,549
9386,69652c526d1c3712ba9540156df5fbbf77e94a34910aabb1f97a2f202b4bf673,spyware,46872,170,414,419,589,414
9387,69c9e8e761de7cd1c3e77b7c1d2cabc97c24d439c16d084489efc97886df430c,spyware,346327,1374,2716,2779,4153,2716
9388,6a0871f342968062b3a58662f873a94602755985b8234ad624edfe4dc7ebc370,spyware,345368,1358,2770,2752,4110,2770
9389,6a37d7a34f83ba6746bd64c7342caad498114e83ede21938bc5b18831f6d58d0,spyware,73127,354,555,619,973,555
9390,6abdeac4f669a700cf437584d056a7058800dbe2cdcd0de8b337baf7d830cf26,spyware,344166,1341,2679,2815,4156,2679
9391,6b26a44504d5f15139bbb3f42a7f361963057c7baf32fe7c088a92e82b5b85cb,spyware,48177,195,417,417,612,417
9392,6b3fd414facd9eb43c2bf03314d5481af23cad6e9bbf16968318ab9bd2d2231a,spyware,73132,336,544,565,901,544
9393,6b606116f0944e9d877738d969dca98ddf9a798c08e8ca9013f8ac84b35e6964,spyware,352913,1336,2838,2833,4169,2838
9394,6b7b3b3a7194bfdebef93dc55e84e814cd9db6b1599964a1848e21829b9640e2,spyware,345593,1386,2798,2772,4158,2798
9395,6bfab6a611ebcb56533030eeb5ad72b4825c950f95095509c5f541647a1ddb92,spyware,45330,196,405,375,571,405
9396,6ca2b8720ccfb3d70288d1670deba30bdb40068d113eb225b92725be3a30db57,spyware,345414,1380,2688,2724,4104,2688
9397,6d0b3e924f0e3ff43e02ca408a7b49b7d773a2258720b1199288f16dddb730fa,spyware,73129,310,564,583,893,564
9398,6d13ca35e5270d923d6572a8f03f2493584d6fe74dc4163d242456dfa1d7a71d,spyware,74045,324,545,596,920,545
9399,6d30d2e9013fd4b5987f434fc718bd44c2f2738ffbc2e7f7365eb56a86c01f52,spyware,355543,1448,2861,2856,4304,2861
9400,6d37d3873313f306581155902020a653e652e30f41a9fa517ae1cf5b87e402b6,spyware,345558,1341,2868,2781,4122,2868
9401,6d5d623e34ba8d5a30ed5f5833c1fd011abcc1f36ca32409cff79a633362c087,spyware,432142,1708,3356,3453,5161,3356
9402,6d5f5f0a75055307dd66b3011e8d77bd039a216d78c4e9814c73fec2d2cf28e4,spyware,711303,2799,5667,5830,8629,5667
9403,6e19f280d406aeaff3b09bc459443835d3c9c28eca01ac7ce8746931de7cd9e7,spyware,868292,3451,6999,7171,10622,6999
9404,6e28ab7b1ca213adf036f364bce46e487b88e7b8fc73ec85017d551313eeee58,spyware,355329,1385,2833,2844,4229,2833
9405,6e2c15fcbbada2a26ca979071142ced94d3ea057c7ff72e084fce47169a3cb6e,spyware,346002,1325,2771,2749,4074,2771
9406,6eed480982ee2b0272283f755978c316ccc6131e159094e53706a65bf79a8f60,spyware,73132,329,538,612,941,538
9407,6f827e7ba25fe6cf2268474f0afcc2784c044be258517445b757bf5515e00578,spyware,355795,1324,2864,2833,4157,2864
9408,6ff0c4542e607cae99fe76a22dfb5fb7a1eb1fd1cccb5968998f614c42ad49d0,spyware,345239,1372,2764,2752,4124,2764
9409,7020a474d6b015060a2e7b23acc5aea104605283668d9bcaaca8d610d02b38a0,spyware,345449,1391,2788,2785,4176,2788
9410,704667d4cc060832213d10e7ff4c0bbda46fff19f1487a786cc8995128f2a790,spyware,73133,338,549,586,924,549
9411,709fdc684c1bbf3243fd27924d1c9b4f6f38f26093ae1a2af50a1809e3dcbdf9,spyware,368638,1412,2955,2951,4363,2955
9412,70ea2783ef6492a563d2ab3d0f8f2763d1cd94c9ecf3abe8b85bac2a8ac5deda,spyware,379022,1523,3106,2979,4502,3106
9413,711ef7cf2386741d2b62c7822dbf12dcf25f72c4e37c579206539b7aca9db61e,spyware,50586,189,406,463,652,406
9414,71388fe4c7c288d7aaf0a6d899cfa24889059af15ae33371e4d70177f4f4904e,spyware,43798,221,329,333,554,329
9415,717a62ea69b564715c13657531a5a6abb6de1f77e14385a0f12a7df78d79f36e,spyware,73129,347,567,589,936,567
9416,717c49e1d4e69bc6daae1fd9b707a4177a8862e5cd6d30296ae8dd38b4ab71f5,spyware,75660,362,628,575,937,628
9417,718b115ebdc6cfaf9eddf1bd3ecec26a125e3088545066359d3c973b12621c7d,spyware,350141,1349,2901,2816,4165,2901
9418,719e053d810ac92971aab52022fe2aae2889c707f282677ed7167d18bca83976,spyware,345411,1371,2692,2719,4090,2692
9419,71c6e603de6b1ddf3a30bc9357ff7c3c97188761f45c5472cb7fe85496687824,spyware,62691,285,525,517,802,525
9420,71defa74fb4cf69b066d81d38628da9fa6371218a037f8a816813933f09f39ef,spyware,366726,1413,2904,3018,4431,2904
9421,720a7460abdfebeee66c917c53c00292d10ecaba4ec3ae3413775c03880e181a,spyware,57840,251,510,481,732,510
9422,7291b2fc4d2fc3bf5b578437f2b9e0665ab9cf72f00a87488e5c8aae93f587e5,spyware,47856,223,429,405,628,429
9423,72a051524051695b962cbda107adee2e6a59de57138f256be3060d05b9dfdab8,spyware,73131,332,535,577,909,535
9424,73a6249ca0684c5798114c13b7b24b1f626d46f365e63dae3bb265f61f307e94,spyware,72527,311,542,632,943,542
9425,73c1cc7c1f5e1693972b7866ef83fda57b91ed8fca1b3fdcd8a1b803b35ac3ac,spyware,388894,1482,3063,3134,4616,3063
9426,74e82c090be4e51cd3b9533b725eeccdd896d4011cbd43505a2419e43d44a993,spyware,358903,1477,2888,2950,4427,2888
9427,74f85186c61aa513d23cedbdbefe1e18178a8199671d497a1425b7199611f755,spyware,376793,1556,3004,3039,4595,3004
9428,7502337442cdf7c0a1a4ee85d050316e9c1819072ed584663fcd752743866fa6,spyware,345981,1364,2767,2831,4195,2767
9429,75618c7de3549cc722f38c0d1d4719e57723537a0d98293a7fb7f86a189fd40c,spyware,345269,1382,2736,2798,4180,2736
9430,75ce9de549f6cc01f4f13e965ab4621244295dca0ed2226564f59b69f9d7f14a,spyware,46812,203,355,404,607,355
9431,761fa4a06fdb858571a5f9cc9a99cfb88e270f2171a74893a5c5403f577c24a3,spyware,49963,241,356,390,631,356
9432,7624f3fa47b80ead68f8455ccb1802283fc3867c4882f4c7217a4efa34d1f2ae,spyware,6815719,26703,55136,54421,81124,55136
9433,7636406406b8554a8e5840e096bbe29a8b6c3f8fc93c88ee8b5566ba118bcfa0,spyware,345664,1384,2794,2766,4150,2794
9434,765b3ceb365ff5329d1a108636fd881b9fda71c3b436a144004d8801994b6bed,spyware,73129,333,523,603,936,523
9435,767c0cb2b52b0cbbdeda077f1f5fcf528f27bbdbe34d6bcebb6ac2573890e461,spyware,73129,320,552,563,883,552
9436,76b0e0dfc107507c54a6bc7a3bf4b16098b7c362e769e2d6610fd6cd1ac7f4b9,spyware,47048,177,380,361,538,380
9437,770cc57ca622403d879d8b118932c68944ea4b85048c5594d3105fac3e19ee46,spyware,345739,1383,2794,2782,4165,2794
9438,773fbbb9b7126838b69c16859ffe50a995fface6eef1bd42ca1f472488d975ce,spyware,593780,2252,4650,4639,6891,4650
9439,775690573d871927c37c724dfe06bacbafc741543eb2ec6d322393bd38796154,spyware,49612,168,425,442,610,425
9440,779047e44c246c25cb1e42ecb08c3df4c8fc2a3f5e30e566696253e6a424a85c,spyware,48538,295,392,330,625,392
9441,77c313423ef88a5125888ec71036455ca87e2b982f6643cc80d0cab8e7e5bcbc,spyware,345750,1343,2729,2803,4146,2729
9442,780f200f12d3f4587b092d2a90cc0f29a9104898723c653fda975cdf99bbf748,spyware,45367,199,338,382,581,338
9443,783c72a8bec118660064c5912efabf9b1764072bb03cb3170d64fdb0f09b6a37,spyware,1778735,6692,13608,14516,21208,13608
9444,7864b6773f0e4854d5b8992f6c03ab310b65b943539cad56bfb71115f2bdb569,spyware,397995,1599,3187,3138,4737,3187
9445,792db329f26f0fb2541483dc7bdbae3c292f8b382801f57f95b35d7e8dec7223,spyware,345406,1310,2796,2749,4059,2796
9446,79936629be47c944a5ba1de88425112b7eaf09cf4655a8e1a410862e4fa35cef,spyware,320744,1291,2548,2600,3891,2548
9447,7a05f7447bff1f4be7c7fb0a252c50577b5ab25013f41b246742cf1f31b919ba,spyware,73128,349,534,611,960,534
9448,7a5fbc8881b62f94f2e39d13f24150df49105a34809b0b532b6b066d1c69aaae,spyware,355384,1406,2844,2831,4237,2844
9449,7abfe63f2fb7a95966d6ecc75479175d6cd40cf88ddbaa37141386a4c878cc7b,spyware,9715,44,72,93,137,72
9450,7af067023154beaa351905285a3e435f2d8d5ddd81d753d261eed8a6943a3d4b,spyware,71779,320,573,535,855,573
9451,7afbaeabadd418c2637108038157bda422ad1925929000794177d61eb1a857a3,spyware,329190,1304,2624,2602,3906,2624
9452,7b5e24cee66acc18db50ab03cf3529eb768b8ec4eee15461c40c889ee6f94b3e,spyware,383943,1521,3058,3085,4606,3058
9453,7b6cbf6e8b7445dacd31bd1ac45a2ee4f0ee3e1ad67f86cf010d3b712dd1068b,spyware,345410,1331,2777,2738,4069,2777
9454,7badb7bca35e6bbc3d322a1bf95a60185cd54dce2e81d701b5b941368f21ab61,spyware,73133,331,550,575,906,550
9455,7baea8652680e44060ecd1a83d58696a1934ee571a7a6d79c808e5bb6c008ab3,spyware,346096,1385,2791,2774,4159,2791
9456,7c1052d944fb1a7d40ef27fa62ffd3a2e656aa16dae5006e4eda4ad41567a179,spyware,74036,333,593,612,945,593
9457,7c1b8175ec2cef94ce3f39736e5dc1aea72487d470fa50599562c9a81d7378b4,spyware,75152,307,559,634,941,559
9458,7c1e4394ed0b8e984e6f62f8a84bcfe7512f024e7bf5bdceaf864312f5365c45,spyware,48036,186,414,426,612,414
9459,7c65dbd6bb70b187be9a88b89eab702c368bf03a8d38891ab1eb2684f172b260,spyware,46804,156,374,382,538,374
9460,7cd65bd852e06f9f33c82b7d3a462e97cd0ba8597b35c934878ce6a398fe31f2,spyware,378067,1461,3033,3098,4559,3033
9461,7dee630380015cd738ac2be1d17cc4210dd4df8ecc505fafd9bbc4bbbd48b869,spyware,345412,1375,2791,2780,4155,2791
9462,7e290c55cb7ea0074af9e52617ecac394c2d0792adc4ae755fe0b82870231697,spyware,73136,340,550,595,935,550
9463,7e2e31fff5c2bb830ea589671c8c74cb229542b1bf89d40f53ebb211e7e14738,spyware,355834,1340,2863,2833,4173,2863
9464,7e521a355067fabc527dd384316162c9ad192a17b85f74c63437b63472bbce72,spyware,410524,1523,3134,3234,4757,3134
9465,7e8a466083ab813e2c9eef09eb17b2ecc23ecd58b411811f925f7ea8ca7b9c4b,spyware,73130,323,559,588,911,559
9466,7ee2df8f51bda3434472697413871e50297b8a9f735f81e3891d7cb43d25d9b5,spyware,73129,320,554,553,873,554
9467,7f314f39fdf9b05340154fd0a7cacbdde3f939e6be6a9c738b5eff09142ce897,spyware,355231,1392,2823,2813,4205,2823
9468,7f82917053376adf3cff090e5852fea75ee46f4bd8c7e0911f8f3ab9170da78c,spyware,56376,230,516,449,679,516
9469,7fd1df391e4f44947ea3d01e0513dc04f03b5a6a23a8049bc3c29fa93990b5a3,spyware,345603,1376,2784,2769,4145,2784
9470,7fdaf427557aa4917180b1a77c692282a3ec952a8050d53767e3205ed525b9f6,spyware,72252,318,533,580,898,533
9471,7ff3acdfa7bbe53761e66842fc29df9afdfc5669c232001f20ddeadf51651ee5,spyware,73135,328,573,594,922,573
9472,8013b993dfb7a8eb5b7bbc166aeb15287bddda9880e800cc61fa57ef81bfdfcc,spyware,39412,162,360,376,538,360
9473,8042ceb61eb29efbb604bbf752a7bddbcdd2381a250172820efdd7791eafe1d3,spyware,565006,2280,4428,4531,6811,4428
9474,80667370db003bc976415734900f2ab98566d77c348b9dcdbac4957d202ad493,spyware,388815,1519,3155,3137,4656,3155
9475,81500399eec635eb3241df7c7290c19e4a2adeaadf652525f195d7dce5519394,spyware,73128,327,546,598,925,546
9476,81775eea56b2006786e66a2eecbbb5037871024036c65d68a9bbbae399f49669,spyware,69017,254,543,561,815,543
9477,81ea3238c4f37c71108c8da37e0a1a7147f7a2423bb3c5c077bdce23305bbfcd,spyware,320897,1197,2597,2494,3691,2597
9478,8240bd1802c7a9096e249309e8fef1bc29c2bc54a70759612b6f1a1166ed3c5b,spyware,70682,327,508,583,910,508
9479,82925825260af01ebe9b4d31766edd0832dda0db54be70d12461785e3f3f71f1,spyware,356360,1389,2906,2847,4236,2906
9480,82bed888a2af5e666b7b09c4e1128b4794d3139ba0beb0ac68286b616df6280e,spyware,73131,326,539,590,916,539
9481,82c721eb62b6c042fee520f0ed222e9e1b5137298ced197a149eb18bb0531809,spyware,345129,1330,2832,2798,4128,2832
9482,82d05505129d797ea28a1cae8861e253d8f9739cff80365ef114926725b634ad,spyware,345640,1357,2775,2880,4237,2775
9483,82d8f14480a419e72fc951b02e86dc07ae56b4210d32a282ef52ffc3afe016f9,spyware,74399,318,576,573,891,576
9484,8320160462859fd8584de30a677b6b4fd5feae1288e2046ad77fbcc4e2d02c38,spyware,321072,1270,2505,2590,3860,2505
9485,83bad9115d42e50864c592cf336957ce32b31f38bdcd5b309cf93544738d9148,spyware,4878596,19596,38267,39175,58771,38267
9486,8481a95b190c26098c27e6074a74fa151f44ff264b6f5077c64ba2b54959dbc0,spyware,345723,1378,2784,2786,4164,2784
9487,84c20902cbdf4e1d660270acba93a65d74fb5080abc2e977566d549c7c683e8e,spyware,345653,1345,2778,2797,4142,2778
9488,85259dd697bf4a0398869bdc45594f4d8efecaf3f332e5a8b537e0f22ac6c3b9,spyware,44582,199,356,358,557,356
9489,8534e101418b53f5ef6d1b4fbc63ad6cae04bc29210383485912c93f23728d30,spyware,46802,192,400,364,556,400
9490,858110cddea3a0302df33d1dc42eee2b824bbdccb08c8ef4a3385a45dbf19da1,spyware,40202,130,337,314,444,337
9491,87241cc7df89c5cb1679ad0a387c065d73e1acfa2f327cd1c92676b31e4a3cf3,spyware,345592,1306,2806,2776,4082,2806
9492,872f97d24f7990e7d8b4cf2e7e773f2409ac7e94648857507b5244b894e035ba,spyware,379690,1435,3113,3017,4452,3113
9493,8746e493e0da073f990d2c5a8059fb72711ac8e6fc6692f57df1346bd67e80d2,spyware,1219155,4873,9727,9982,14855,9727
9494,885afa7198df0e5b81fc413d53d38719432fcc1c4d0e4c2be8fbc03f8facea6c,spyware,50030,210,426,459,669,426
9495,8877d7d007933144b415145e857f22e64576f72b40dc72ff21f3eff4b09a86f4,spyware,355488,1413,2797,2889,4302,2797
9496,88a4de0be821d4961ed0786f4e18e0651ffb03a1e3e6e86a7194202e7e6f81d5,spyware,56331,313,417,465,778,417
9497,8948ebfd7d99b503b1dcf0adf6ba49ac4fc3978a3a18670b20b3bc751127c21c,spyware,359324,1469,2919,2892,4361,2919
9498,89b141aa860cddf3c6b0bec91bfca679ff5d8614135a0677e4c1caa7d37a9c89,spyware,345669,1339,2777,2744,4083,2777
9499,8a0624263437fd5b0a1d363e55ccfa683bb0b54a64e25b13260113f90f4b3090,spyware,887590,3515,6965,7237,10752,6965
9500,8a17d092bc5bad32346d40d95afc909403ad266729ffa281f6764f6052175080,spyware,345527,1388,2794,2765,4153,2794
9501,8a6de8d253e965ad9f3195462647c85b5010079d7d2eb48a1b4d77fc4b354629,spyware,54479,280,399,453,733,399
9502,8a9c232078227e941b4fc1d6d75cbd2f4fa6dbae77a3f2c9dc0c5c11f11d3c62,spyware,72339,322,534,579,901,534
9503,8ac27de3c7f52345f1df319dff56272d74b5d05fef642646ba92e23f8313afd4,spyware,72259,329,566,612,941,566
9504,8afcb2c328f8153e56a5610450c1c3a9d2097ccd03495845210ba24e13d0a604,spyware,345267,1359,2781,2723,4082,2781
9505,8b3f9907920945d6abf18453075c16022a7cb42b3a236c34228409b49f8744f0,spyware,542177,2162,4387,4427,6589,4387
9506,8bf3df93aa57b7231aa023f69e656611594845e2e292b352fcd776cd87385c69,spyware,74065,356,575,546,902,575
9507,8c1e15c9efcf65291ff36742cceba55d05f05d7de99a39634e281310d2bb1667,spyware,74057,318,554,561,879,554
9508,8c33d3455a9b205d1710627ae980cf1a6bea7fc616d72c5bbf1754df2c7d148a,spyware,370938,1553,2955,3011,4564,2955
9509,8c46fc5796087cd8beb0878ea9468b12b58fa324eb69c211623029d0f2ff8ec0,spyware,345401,1367,2899,2734,4101,2899
9510,8cc88bc6e6f477b7f05ea7d0216c305d0dd62f333aea093734d50d7c23c80d3d,spyware,345418,1363,2762,2806,4169,2762
9511,8ceb27b7fa44cc0433eb9a578f111125fc17b62ba616fa1e8325951fecae263f,spyware,345408,1338,2780,2751,4089,2780
9512,8d0c92bddb973d6e33caa3f244af907f4f3786f3787719047ef7a555e4d676bc,spyware,345415,1404,2777,2804,4208,2777
9513,8dbe279f0e20ba03b407fcc255985f879c9beea1cd8985da3aa39e9863f7597c,spyware,353280,1354,2878,2875,4229,2878
9514,8e826b4d92ed6fc169f81b4f0e8f22cf8cdec6850894a862dd10537d9d1be426,spyware,1998034,7759,15787,16078,23837,15787
9515,8eb4590ce2a0d98bd30435e9589badace2b1ea0b8e30930137c56888f18ffc66,spyware,73128,343,565,545,888,565
9516,8ef71e5be35f4c9fa7ff3caa4f6f1f0dc6c3f519ef716bb60717139c048645e9,spyware,544983,2318,4250,4532,6850,4250
9517,8f08ea4a455399a116c0914f64705401fd80e89ca82bb823fb2dd7d574dc6a8b,spyware,334615,1240,2674,2618,3858,2674
9518,8f0c932186ce2862860222b2cdf82f6855caeac087efb1b59ed1ceabf1fc10bc,spyware,368601,1427,2866,2958,4385,2866
9519,8f375074fc1db69a735b2aaa2400a93904e1e8d6a4a2d1eaf5f51f1a9e46625f,spyware,45647,188,391,363,551,391
9520,8f37ccaa1c54364adf0b4d54efde5355d26830152ff28a2392ea777da88c9aa7,spyware,345572,1344,2776,2805,4149,2776
9521,8f74da423b434da3dd496174debf09a0c0c9df93b5c2cc65d0bd708a5413be97,spyware,48871,241,408,448,689,408
9522,8f8c39aec7b9a4e22f7b345a171fb0d5a416580271fe16e78f7ec1cd9dbe6326,spyware,73129,337,532,594,931,532
9523,8fc93fd1fb598b00c2705c831081466285cd75ac7a63b9001928e1d065a19d42,spyware,334019,1288,2700,2628,3916,2700
9524,9032db1daa8773ccf508c734891b4d27588cf885bc104571434b3f941c45ae9a,spyware,82404,306,634,713,1019,634
9525,90a1f717b1da48169341693e9a7ef164f6918b06dd7f9c5b2266a80b6962cf9b,spyware,355813,1351,2769,2859,4210,2769
9526,90c55a8090eb31e3cdd5202248341ca11a83cd34587d4d9eb04c35e6b531fc00,spyware,346177,1440,2821,2723,4163,2821
9527,915392a7006ae55d340467e58f32db396a9c3399c7ab938f9c101d6a32cbcfe6,spyware,70515,310,491,567,877,491
9528,915af0ac27fd1061425ac7403730f825ebe832385ba6dd172a7d6e8d3446dbbd,spyware,396838,1556,3127,3194,4750,3127
9529,918fbbac8809b34f6ff6c8f10679c7abbf04879b7048a2cf0e07d29843f15d64,spyware,343550,1342,2717,2748,4090,2717
9530,91a98c9a89f560e4f90e377503df7a768f51aa688407bdc444e2c09081a5fb07,spyware,409076,1578,3217,3348,4926,3217
9531,9220864e2b0b628c6fb18f0795a9bc5562a249e3ea5f8cc62db5b70ae319d5b7,spyware,355466,1375,2831,2885,4260,2831
9532,92a3b8810e37bdf28a4792fee6ffee5a9a73035a5dbdd98d91b4a54de277b25a,spyware,31313,159,209,256,415,209
9533,92b1f64c3cf5e74c719d7e80f23df71408aecc807dc331c95d406dc19bd4507f,spyware,48719,196,376,437,633,376
9534,92c03b7d4c62cba249a7e07f2a2a6ac3dfa25087eb37a075107c6c8a9faf6787,spyware,445974,1796,3612,3750,5546,3612
9535,92ccee262f51a1623472a6a0991964edca3068631bdfa7129e78fb9d18792557,spyware,858596,3462,6674,6836,10298,6674
9536,92f1e68c2fe500e5a26157082efeb78f2195795502286f33341d2a21f34ebac0,spyware,73127,342,545,580,922,545
9537,93861880ff26fb801d99c6c73d872bbaa08710eb0a056a64de7c511b30565401,spyware,345596,1384,2787,2776,4160,2787
9538,93fe73c82d040ddf3b3ee6ee4139a030cb9a226403a6475331e080b248c622d2,spyware,357631,1415,2809,2877,4292,2809
9539,941e1868679e3b3a592db3bca63197d498c7d7a119646a4744ee27b12cac8a6b,spyware,74401,352,528,596,948,528
9540,943745bd48abd23f531b20cd7db85bf1213c3cff66e37c8f597cbabf81942c04,spyware,61968,320,520,520,840,520
9541,94db725328555af6c39d8ecb3336b57a6968a15be1bd9ddbc1fca1edf4d164d2,spyware,385277,1472,3085,3127,4599,3085
9542,95989ec402f7b26ceaec63439c7dc97634c0939f1f703467e51bd74ee7a786da,spyware,75151,329,593,605,934,593
9543,95b00a7257b3545d13923a185de17417330d268c562c64e5a64b440e9fbcbf8c,spyware,355291,1363,2867,2876,4239,2867
9544,95e3ba27bcb9071ce0c2c5e69ac372886ddc5e9f693ed8654e2b1703d635543f,spyware,73152,330,562,590,920,562
9545,95fab234d63389df32d619ad3fd7e37e13ac8528ec815f091974bba79150a14c,spyware,73128,347,570,570,917,570
9546,962d059c333acc61552a1603df46f5460e73bc4a570a17a88f95efee86ae2e67,spyware,73130,325,551,578,903,551
9547,963f238907e4bb72f925dcfaac18a54969af92f62812f11b03422ee869fdf431,spyware,44513,207,329,379,586,329
9548,96a3c6b2852787f3257584db098b330d42cfdc36a611c7b5997c3e5835b416bc,spyware,345420,1377,2801,2771,4148,2801
9549,96a7a696343875d3de5838807512269996fb61201de9d90d774947b727e1afce,spyware,19500,80,137,144,224,137
9550,96df8e650b5339aecac10f3c2369000112ea179d274d692269637a41f64ce78f,spyware,70481,286,513,531,817,513
9551,9783444607ff1852af13a25e69f208f4ca4e70fccbba2bd07267f2def13e4353,spyware,72254,321,541,605,926,541
9552,97aeb8797678361e11a218c6028fd168e9f9b5f4cc18dec2fd8c310ced7e29aa,spyware,73130,310,564,583,893,564
9553,984fd0fc28de5cd42b0869e9dbbdfa341cc26ec165bf0f7c3166c7bebba57242,spyware,43802,206,324,352,558,324
9554,988ace8970d9a6c84a1321edceb15ea1327a9cc095a2a968a67bd911764c075c,spyware,11634356,47723,85461,89122,136845,85461
9555,98a3f782ce6a93c740781a75906f4cbc041bb2214a9d1db4abbee48fb7b91de0,spyware,73125,325,546,579,904,546
9556,98fea6fc1aaeb288f70120a88f0af70e1e7d728e106a176433276547367f186c,spyware,73129,346,555,568,914,555
9557,9914982df7fad31b2aba3754e6c020ea7fb0c4e20970f66067defac051255773,spyware,73137,312,555,597,909,555
9558,99213eae09588fb59d2fe70168c45aa58a3dacf7955a52f73e181ffa5872ca4e,spyware,72217,326,562,610,936,562
9559,99318f84ace0a7e674d1239674c10978d1de88fa03950703e113b6b8d779550e,spyware,73132,338,567,575,913,567
9560,998f77c1a2901fd0d14dee05957db0d73eee6e40d9ec0c8451c7022cd8d2527e,spyware,352624,1351,2843,2849,4200,2843
9561,9a1d39b1058c829247af06b4573f0aa98d82362f4f02f694098a76ab4bb30146,spyware,368784,1532,2958,2993,4525,2958
9562,9a3615e0c8ecada422a514748378e5029bfc9e7c0c7dd87b65d70a85ccf9d75d,spyware,345609,1341,2761,2807,4148,2761
9563,9a4bbe0b2564f5f780249ec1273dd4437161640f9efc9714cd8c28f4adec9998,spyware,48782,211,375,400,611,375
9564,9a603c4d91cd53028886d817aa94669b462b2cae74b7be38e43e087ce2efbe12,spyware,346046,1341,2787,2808,4149,2787
9565,9a83e2d74446bcaa18940e08df06e0f2bad9641d5fcf1fc4128ecc777d618bba,spyware,14255,50,117,110,160,117
9566,9abe04571ad9ca542336318781ba96d080a46de04de4570d2afe88c03124f14d,spyware,46802,169,375,380,549,375
9567,9b09d50df1bbc98351f46325af68ceb2e27f11969bd674ee3f7b49e8f70bad21,spyware,561137,2128,4531,4490,6618,4531
9568,9b10a4b66cfa02b49b13f62290200771af2ad2bb35cbfcb024aa1623baa3fc78,spyware,66750,314,515,594,908,515
9569,9ba2a13c98a660bdd75b66d3ee40115f64b80693fcd43f5ec824d5f4cea6f5fb,spyware,49854,227,409,420,647,409
9570,9bbc9438b43ceb5d7c14e1423c8a80f3831d4d95d25fd6833ee4e6ee44577ce3,spyware,72527,287,489,609,896,489
9571,9c65d3b3b648e84ad8c86929a8a2532d9de8df7c372974f5c922c3bff698456e,spyware,69051,271,552,539,810,552
9572,9cb27b10dc1d5201c3e2509f69ebc84d36b0a2d6fdc722d4213b0d7bec7465f9,spyware,345271,1379,2738,2804,4183,2738
9573,9cb36d3a173b333d7a374cf7335a549a68b96c024f791fcee1f5e95d04cae5fb,spyware,355860,1392,2829,2902,4294,2829
9574,9cecca7f94ed16edd5692b7e501c6f3015d3aa17b0c3ee28b181332972923d2b,spyware,379233,1571,3051,3052,4623,3051
9575,9d2a5926c454bee7f4fe8851c47d984a24d5c49d4eaa30deeb0c5247132ad6f2,spyware,477510,1754,3789,3949,5703,3789
9576,9d2ea01ad03a0ac6408ad35decc3d17dbb587cc5a4fe10016fe48cc73e06b465,spyware,345728,1378,2791,2771,4149,2791
9577,9d3e031e823435b5a0511837545a41d868d17bb14eb6de7eda65ab9d303f30e1,spyware,336400,1311,2708,2674,3985,2708
9578,9d929629bea4910cd046e16ad323fbea5626a295e0a613501d973ec5827b5acf,spyware,366347,1509,2907,3043,4552,2907
9579,9d9c54a41b0bae381f22ab84c8f3fc8b9c05d4d62005d507791f8ef6d0ab0cae,spyware,73131,323,534,595,918,534
9580,9dc049ef2af5cda3e43652fb7904921edd6a1c9261627b0908a057a687ff7e86,spyware,74060,313,593,592,905,593
9581,9dc3408e31de9977de7851319e75161d345c32becb23502e62b0a5eff25ce29c,spyware,73131,328,560,552,880,560
9582,9de2108ef3b30fd12fe652777923e077cd9d2b6624463a0cdf21ecc90d251267,spyware,361689,1522,2921,2938,4460,2921
9583,9eaaecade866df6c07cd405a77d783e8084633ca911bac3cedfb8aa081b170d6,spyware,53727,233,419,454,687,419
9584,9f70a3e450af56d3e6942123a424219aff20a47f36301ca41fa052b83d822384,spyware,71823,323,527,574,897,527
9585,9f9c5878a4f540d455eac355757a54c3ebaa2ed704d3e3d92a28c79458fee808,spyware,54653,282,446,489,771,446
9586,9f9e75ad02088e0b52da509a6a8c43e060c7a2f2d1367701023d86bb4ae2dd30,spyware,6772550,26280,54472,54399,80679,54472
9587,9fb1d513532b85ed2a3253178464e62a0c555b99639405bf1a1fbc212c0c915c,spyware,12033,50,96,90,140,96
9588,9fd7f0eff8e81df62cd950332944b4ecf4cfc40ed8b607f6dd450d3b675a1d18,spyware,328991,1287,2603,2611,3898,2603
9589,a0a2bd20d729a61e7d5c8997214ce6573187af9516ec7160cc506a4dfb7ad945,spyware,51653,246,435,414,660,435
9590,a0bd7195edbffca05f0c5b1a76a1b089f741276cacd96f4bc2b7c6ad52041805,spyware,345411,1368,2694,2729,4097,2694
9591,a1019a3586356251bee1e9ed21e4c6038199b6d3847da51bc33dcd91fe577c27,spyware,398266,1515,3091,3280,4795,3091
9592,a129b2270a7288d0f21b77497ab7d2fcf1506099e321d41f83e919cda1b7392a,spyware,58907,259,503,479,738,503
9593,a16ab194694af26a6314e7085b56f4bbe64ba4a275b88988e1672557f0e54903,spyware,73134,280,566,604,884,566
9594,a1a5f9de65156cb628cb2f9a908f53b109eb5ed9e7d02eaee8501deb8182f2ae,spyware,345708,1373,2866,2731,4104,2866
9595,a1c28637e84be66ecf0ba75b44e315b1d82226f3f31f19304b5cc95983a9a685,spyware,17064,70,134,123,193,134
9596,a1e0f9ab5481ac35bb163fd22d06e69104ae60edf10221bdccbc70a8fe66c9db,spyware,369351,1510,2917,2991,4501,2917
9597,a26e2bafd6ae72d09b8ecf9f886e1252e812a2b6ce21a98190b8d8437082b08d,spyware,395688,1559,3132,3234,4793,3132
9598,a28affcd30ab8f37e52b3292338283356d29695566cc78b7576bda6ec007e8dc,spyware,74042,324,540,616,940,540
9599,a31387e3d6ece2e3af93830348ff83278bb62c3b1f0f45959cfd44190f72e1b3,spyware,345370,1375,2767,2762,4137,2767
9600,a318d0f4b70d030d76b24d9f76a61be28a010c9b00637c0774edcfee627a8fc0,spyware,321552,1307,2592,2622,3929,2592
9601,a41f3407db410a28e793f4c0efd58e73955f904984c020bac3d41ffb2d99d509,spyware,397730,1522,3193,3153,4675,3193
9602,a442b8e31bfb8d7e8d9e5aa91e13e6bd300b95b9302bc5b76e730dc8f348ae07,spyware,345673,1338,2771,2751,4089,2771
9603,a47d26a5ef4739cf8912d348852d09618ab2e9fcd6ea3e349752a17b83a1ba28,spyware,73129,325,546,573,898,546
9604,a49660c2770b33c6b15772ab13dec7e39e073f2d9450e824fb831bb0a32e9b32,spyware,345409,1379,2699,2707,4086,2699
9605,a4a1b6af367e16e1d57a0f94cada9b53c9bb85331ad1890ab9b1f97a2b38ce53,spyware,355516,1342,2873,2893,4235,2873
9606,a53a40c94d4d0d84847188eaf8701225e27148485abdf69dada7b8a99d318d1a,spyware,345800,1343,2779,2800,4143,2779
9607,a5810b66e1b3f7f752461829af55ff5c3a7e76468fbef7e15b6caa9693d73462,spyware,44001,198,353,388,586,353
9608,a5def8d3be5d51d51e4412762cc7c40b1a2eecfdf0d71ffe4f18087e4465a725,spyware,50660,221,400,400,621,400
9609,a63a70649464f1ba188081f4f18304a63575ae2365c2ca47b206452fbcee952f,spyware,345607,1307,2798,2774,4081,2798
9610,a7295c2964697696b7033353ba1d2d7ba2ff4b0ad9a9fdabd2e3abebb8e11111,spyware,9533,42,88,81,123,88
9611,a7347b5821a10e74c412e451e0dc14f86138fa927643bb40c663a6ec348bc74d,spyware,345734,1348,2767,2805,4153,2767
9612,a78bcf3b7bdf346920d1393e2720d0537d0fe4daa463585a56207ab39481c332,spyware,73132,346,534,599,945,534
9613,a7d891d6c75e594c697032ab3b3334aa0257fd6b7cadf3ef6bb41b60fdf371af,spyware,73136,334,521,611,945,521
9614,a82d32ca9795af0653dface01ee6c3d799df011e2fab5ec18ac0d3d10f5248da,spyware,82400,309,686,653,962,686
9615,a845571c2c6cb6ee6e5e656eb6eb240478ec652f3787fed590ab18c056ee190d,spyware,372099,1437,2945,2945,4382,2945
9616,a85000bbfbee35dadff4cb87b61b667406c13bd7c24d5dd37c4b1dfb6d7e21cf,spyware,377349,1481,3050,2973,4454,3050
9617,a89a60f4e7498fdb1e68e312afc82df129effd002fde966625bad4aad1d5e332,spyware,45631,197,375,385,582,375
9618,a910249e4e471fab054fff7f7a95f11a8e98334dd4a9d02c30cb5bb89d11f4c0,spyware,360397,1315,2876,2934,4249,2876
9619,a912d91084475fa8cfc1c11a1845f7d51616a2c4ad5c0974d61a1594d32cfaad,spyware,361853,1414,2865,2948,4362,2865
9620,a91a620ce350d7e864599061e35606adeb59598f44ccf79386cd0d3388b8686d,spyware,345409,1372,2697,2708,4080,2697
9621,a921c27f408daa99fd7768f9521366981c892d1b4ac5dac331f1809c2c030976,spyware,73137,285,552,619,904,552
9622,a92e101655fd0f1eaaafc29d8dae5cd695af8cf6ff442b4102b4428d3b9a4003,spyware,352635,1404,2814,2781,4185,2814
9623,a94898c7b98d780841d3c468f183e54204196f880d4b3e25afa54874d7c3c1e3,spyware,59340,261,508,528,789,508
9624,a9b69457f1c7568d7f4420bad1a390704bfb0a7b13a651d1dfede8d30643121b,spyware,45631,185,387,346,531,387
9625,a9f46f59ea55a0180717c68bba29a0f183b41c35a36aa9db5eed3e6cee64570e,spyware,342187,1337,2757,2776,4113,2757
9626,aa111bceb27167e32ad92daec2d9f8427d94cbfe9b8ed2d533fe06a1ae89971c,spyware,429830,1694,3444,3467,5161,3444
9627,aa11346fc1244ec7e96b4904386071c696136ed5b899df9bc379b4187eae6026,spyware,73129,324,533,592,916,533
9628,aa4fcba879ec2849e28944b97fc403f3d49970c8bec991adc5a3da8c330dfb3f,spyware,41331,163,396,344,507,396
9629,aaa63b13b673b9755e255433436214981db70366332b28e84e13580c0a262ea1,spyware,374489,1536,3025,2965,4501,3025
9630,ab4e185c2f9a96564fcfe5c3da4c00902c56e7336da7e0ef4b66efa69e27b624,spyware,73136,344,563,586,930,563
9631,ab702b1eb2bd42d2f15592c6c77cc28f32d8a656b553729edee270976b92b4e9,spyware,41954,180,314,361,541,314
9632,ab939006bb1c7ae668b8baf01d465b24341caa3eb78ed594cf6a0542a42ec737,spyware,374204,1483,2942,3016,4499,2942
9633,ab93c9e289875dd5290a55797f4f72170ee7342850ccabac26d1792f1c3e9504,spyware,12135,59,102,94,153,102
9634,aba557de5eafe064a8b7cefa84d7c0fca9a7ee28a66dac1bf5119a56e6fcf9f6,spyware,346094,1327,2785,2841,4168,2785
9635,abf4e8e2f8f4953b120e2ffe6bade477640a3493ec6072a56a2854ae99064108,spyware,82399,306,631,677,983,631
9636,ac3184e706d3745004204a8c0c47b2fcdf45b4744bfe6f115005bdc03b63b026,spyware,14625,67,116,128,195,116
9637,ac7c90a7ac283e786711700271c841b877a0fe7af29b18e28e503682cfaac66a,spyware,73137,315,580,593,908,580
9638,ac8dff0faa1539c30bfb0a5f7843eaf516e0bdf819e5f95afec309abd0f11cc6,spyware,327230,1336,2568,2571,3907,2568
9639,acd8d7440bea3a8640f246b372c515d22fa85d5ea3e0199efef7d6d0f55540bd,spyware,345377,1333,2756,2752,4085,2756
9640,ace0755f85cc3746e3f638a2176901fac8c7907704936697bb62b665279185da,spyware,51235,187,456,447,634,456
9641,acec7aa316759e1e95da83f701d7ee9e4259ed3c5417f32edd27830e639e806e,spyware,50562,267,397,435,702,397
9642,acf7f0e1c6918db9d669804f4feb5dffb99d983246086f2aac0fd0274713e6c4,spyware,345554,1351,2758,2797,4148,2758
9643,ada4d35a1563f74b99cbcd2ef238d68f3b1f2b1de928017bd384bedb135110f3,spyware,355697,1403,2858,2785,4188,2858
9644,ada6d91b6a74c164219f59d3e02b3bff3c89ad3f5dfe0e33a4d2f834e04c8b15,spyware,73130,336,528,593,929,528
9645,addcac9bfb1d6a035dd4bdaf95537f4d2b735a01ffdbcfc43c9a40f3d0da80b3,spyware,48764,186,400,410,596,400
9646,adfc580d4d1bfdc89dd05f8155533080f5d56a536101ab8ef633978e72b101a2,spyware,366276,1510,2943,2983,4493,2943
9647,ae38228e7b19ee087e020ccff360cd5811d2f7b56d94707f731028266c9e6d90,spyware,38574,159,321,315,474,321
9648,ae85efc8feaa8a9b5970e23bc8c6c2fd110e2720a02b3b017148ea14f21e7c1e,spyware,345687,1339,2788,2814,4153,2788
9649,ae898a0375b1a676eb1e66f3e159020718d9b63fa5beb6c0500ef43d3f857fc9,spyware,380880,1459,2993,3159,4618,2993
9650,aea2c08345ba5174d8f1305337edfe25ea1f463d3d2471dc91a2966f74617725,spyware,73133,317,571,572,889,571
9651,aed7a0c9225050c9735ff3bd82f98d2fcfd32d6e64170bfac009fd948ee369a3,spyware,345411,1380,2802,2773,4153,2802
9652,aedad757598a97263599519339b1032f430dc8f194bfee98d6a896add8ed94a9,spyware,68825,298,514,575,873,514
9653,aee5cacd878036671fac7ddba31c8a19c92c0a44397568feca1036fafd3930b2,spyware,42716,162,406,392,554,406
9654,af69b2df758b8d6ada378028cfd1ae569671b7cad895cba6db1b55b6d697846f,spyware,355528,1412,2852,2772,4184,2852
9655,af8e46772ce394df5a1e6a414901b0af05c658c991c118060079ff9f1f0672dc,spyware,372254,1401,2911,3016,4417,2911
9656,b07c1b73e7c65ded1d771f73c09508ef26140370d3d94cbc7981baf66ca351cc,spyware,339349,1263,2850,2732,3995,2850
9657,b09bae84cb79ce942c884f9aeaacf833ee68735b5c037e5726aa007e4d445a91,spyware,389114,1598,3173,3253,4851,3173
9658,b0ab0d0e8cd71c3df49ff230337ee35741536b104acd2c0d8f35d26d68d6ea34,spyware,73133,338,564,565,903,564
9659,b0f9b241699fa3ba9cb0fd07abacc144f986190799eccd53d52bb921cccf55eb,spyware,46644,172,382,412,584,382
9660,b1f208b63dd4da5a1a42ad665f17af9f4911bba7cc7413a7870ccdd35078e6ed,spyware,355510,1335,2871,2902,4237,2871
9661,b270412b8c7222129daf4d11db48155b4bc96b6692b925d50caa40ec44f9867e,spyware,75154,315,557,642,957,557
9662,b2ab172b203a3898ca0af2d416cb7a41441f7918d10e95e4591fe342d373f7a4,spyware,379304,1552,3097,3134,4686,3097
9663,b2d8823e4e966b478741bfa22eb3580192f7ce91a171ed3b7a363482ec2a5ff2,spyware,15456,71,106,127,198,106
9664,b2e68ef5a2ab3ff142fddba8f6bcc01532d82a35686eefb8b3c9710b5f06f907,spyware,345411,1378,2795,2788,4166,2795
9665,b2f4534a2a880787644a3f91d017740e77315f1c44fd84f66857e97fc57d8973,spyware,531502,2053,4269,4204,6257,4269
9666,b3c5ddde7a82880f62420f1ec2c2dba2789e0bb2f302310d75eb99793df63df0,spyware,345294,1360,2755,2740,4100,2755
9667,b3d9341fa82ddb0ea0c73dabe947f6e52f31c9a515b2cc38d26f067b60b30e6b,spyware,329151,1311,2647,2583,3894,2647
9668,b40efb9fe96eca68b045f3527244e97390afce8f48f4beca08119512c8478f94,spyware,345591,1330,2772,2748,4078,2772
9669,b45548276584a9bd37e9fee4f43107ec396108bd71be1ef6fd4607f1c5290562,spyware,73132,352,566,604,956,566
9670,b4a5bc1de13e8f930474682ed813b16a9d67ec15203a973b7efaed95ad9872bc,spyware,379984,1403,2932,3140,4543,2932
9671,b526d1c3eb0ba514a02cae48d4c23b735017680f0573c688284762d280c036b4,spyware,73129,324,533,592,916,533
9672,b55caa22d5d47bf070d53b3c0d7d7ea2a4bc9df36349b9f952966f16ba94396d,spyware,38486,197,299,293,490,299
9673,b5dfc21f43f0b43af82481ca1c73c8e63c9787c143a009744e0dde241e267f19,spyware,353128,1353,2840,2805,4158,2840
9674,b658de0341cd5c9468c2f2b3eeaa3d182739b242356a002fa256d4ebfdd40374,spyware,371828,1441,2974,2972,4413,2974
9675,b75b942874838d041d92ce4c6a34cb0f7a44fedb1dcd8974af7771709302e5da,spyware,73130,343,568,593,936,568
9676,b79fb7942ddf6349ea5b49fcb1900d0f51bb0d54d14c65bcc6ee89df451e2158,spyware,9978,53,64,72,125,64
9677,b7cb22db00b02751f42c692f0910c1cf98ffd36daa73033af9f4773489dd4c51,spyware,75140,308,558,608,916,558
9678,b819fde36490ba3a528abb4b00187c19cb98c0e37f045aaea976189e024c9f99,spyware,73128,332,522,602,934,522
9679,b81cbe14dc4206310d55cf063fb25d4c6dd93550658acdc8159282aa9d69a3b1,spyware,345599,1380,2796,2779,4159,2796
9680,b87efdc82d3596b3120c477651c655984c10ebb52524a7e2686929ece022b464,spyware,345409,1397,2757,2712,4109,2757
9681,b8aa39a399ac681cfed8e9c9754696aed9c5e89b4535ca18c5c2ddfb3ed3dc8e,spyware,448168,1708,3567,3648,5356,3567
9682,b8fb1719c92d5171f128228ada74d61835a6a21639b890fe71af32afe55db17f,spyware,345464,1382,2790,2777,4159,2790
9683,b90773c1711bca42777224cbcd9d19eed861dc2bec8fc5cabcb77a12d0ac0d51,spyware,345740,1382,2793,2770,4152,2793
9684,b9efafd5c6461530fdec15632d2e11bf9adf9dbf41885991695163bd1e51cbd6,spyware,73128,321,551,584,905,551
9685,b9fd0c5b2ccbf7c42c2cc6abefb16dbd4ad115102708d2613d2ef2201a5c6112,spyware,43710,210,341,316,526,341
9686,ba3cd33e09d4298917fae30260f62d896e6ea51af4e3d21bc181b6b1a631b820,spyware,61502,267,530,479,746,530
9687,ba843bcc7c821eb05ad88488cc727bd3d99b5c1b3ffacac9e798c10e4f68826f,spyware,364896,1426,2915,2979,4405,2915
9688,ba9c677617482bf73ea69cdc57f4947d4b4dee082bea99384731a540e78e97e9,spyware,37176,209,283,307,516,283
9689,bb10398b21c6261080f6fff10c9d0dcbcd5bf0e90dc2386de0acd61665220417,spyware,345562,1378,2802,2770,4148,2802
9690,bb3dc8a55f9bb5a502d962a8768848a564716c2fe12e55106e74d011ecc7c1bb,spyware,54440,214,499,451,665,499
9691,bb511d7cbf404796c08bff56017913b628e76f33543d035dc90270ae34b94e0f,spyware,15106,31,109,117,148,109
9692,bb8eabc3e067999b637ce620ac1bd580794fcfa097301555ee7d23471e803839,spyware,345635,1352,2759,2851,4203,2759
9693,bb8f67863f8e00678134ed1ddee6231cd885eaaf17a1c09c319e94d2e399fcaa,spyware,1487628,5904,11727,12018,17922,11727
9694,bc356ce1b302dc3b808aa25dd51a54fe281c13188405082499a5e657f18ad78e,spyware,367595,1434,2885,2985,4419,2885
9695,bc3cc5f01ea2cf841d5ba19c9b3b363b9bf7bab56a5ad3d4cd93cb4011d380f9,spyware,345823,1355,2775,2864,4219,2775
9696,bc46e40c8e2f1c61660118b9b884d8cbd0b20918d4f60eb14731e947039455dc,spyware,345408,1400,2760,2717,4117,2760
9697,bcc12ab95b4221f1372292c9ffca130c27aab3ecfd3b17ead00af483e2f32e8b,spyware,345959,1337,2778,2739,4076,2778
9698,bcfdc2a1e9bbbcbe74766b460e87a58ec35c61c500659ad95da547125f754016,spyware,51589,237,420,421,658,420
9699,bd11fdaaaed9fd9a1c370b66f648254eec6b8ebbed2f2923c9b5a859138cb939,spyware,340200,1369,2744,2776,4145,2744
9700,bda263c3ac0eb9c46981840e1c44df60e3f939ac1662d3b5d3ad9c4ae0afaab5,spyware,45217,179,360,367,546,360
9701,bddaef43b732d3d0ecf3782e2cd1409f9bdbb6323c0434fd09f20e6c2c2067e8,spyware,103229,426,835,869,1295,835
9702,be127fa229094f0eaed9e1cecb8448609e52bf2bd62f848a2137a753cf48b9c6,spyware,345659,1380,2786,2761,4141,2786
9703,be1943b37e329e49555033a0d98d52440b9fffdb7005e9e805ef46ad369fe4cf,spyware,345618,1404,2739,2726,4130,2739
9704,beedac87d275545b6f58928257f973a732013bce23710c069f831bddf3786579,spyware,355662,1413,2845,2766,4179,2845
9705,befe4fc27ffc6c54cc4aeb306301216e27818b8c2db2203c3c54963231432df5,spyware,64880,267,495,513,780,495
9706,bf44db5d135cf76ed96288c002ad2c50ebd3c4837077d963760de20a52de6381,spyware,20177,70,170,136,206,170
9707,bf4d03e0c1b61c599ef4fd3586ea2d83901c3f914fa2ee2c1fa0b7a88be9d136,spyware,347694,1317,2818,2843,4160,2818
9708,c017832b0b4e5b786396cfb2dcc21e17eaf7df6da59601dc207d7a59a50120b7,spyware,73129,345,562,581,926,562
9709,c04d4b281be5a2aacf4546d962e25573b3cd5cc7578cfa3f07b2343679d1db60,spyware,59531,291,470,500,791,470
9710,c09efd85b82d5a9a15e90c70eaf9654e2ad7978055abdce2002c6084b3106b75,spyware,73128,340,567,573,913,567
9711,c0f1cd4613de5278730cb6f383e96ec762ed0769c4e9ce940d4d714c09810dba,spyware,51653,243,421,433,676,421
9712,c13704686de55d841a547625c704e7cc365b2708ff911899707fd8b595e55cb0,spyware,345366,1325,2824,2738,4063,2824
9713,c17b2ffe191147e53a52e4e30c519a41889a3191c17e09651f9325bb9c126e7c,spyware,478472,1951,3842,3762,5713,3842
9714,c1e45a0ff38411a99ed48d91a9dd99f934cda45c4f1bc92ccb03a142efa351c5,spyware,394767,1573,3244,3157,4730,3244
9715,c2ac1ddf0db95a17ba77068405994e817c09145c5f1df6ad7a48a7b4642c1bdd,spyware,404997,1642,3174,3303,4945,3174
9716,c2b0a540d378aaa986331c0faef6f03237c95325cdc2bf99ce7170355aaccce0,spyware,73132,309,544,594,903,544
9717,c33d3bc8a619f18b2b4529246f17e62d5b0d17d01c22c6e8d1048de40f0028f1,spyware,3827372,14989,30063,30006,44995,30063
9718,c3eaf58cef7cc458b0f50bc68449d414d66f12882c871a45747dd63290d17a6d,spyware,526314,2081,4165,4328,6409,4165
9719,c4223baa36b2bc9a47f58f08655f8982b0fba98da85bb5ecb78c12a3a40a865a,spyware,43651,202,339,376,578,339
9720,c4897ff22642cdaa19296b9356f8df9fa42957b9526b77a95c5199e73e3a4ec2,spyware,42701,252,357,327,579,357
9721,c4ff293777d0f929a69219035ca3fad47bc66ed77b55d508f835591420b61e05,spyware,45076,176,383,322,498,383
9722,c57c78f28cf6bf97f2e9b80b138f2504d88fdd10162700f41bdad90b14f239ab,spyware,17364,64,115,133,197,115
9723,c68217328e407100e8e0cf6d5d7f8afa7b06eb5064ae3a9d60708e4ceb716fbf,spyware,320745,1207,2591,2551,3758,2591
9724,c71f4d364a2f381a9219bf1709ba20eef62847218c8867266a44fcf35fa494e8,spyware,73132,331,554,604,935,554
9725,c724b25df23ce5c8dcf6971c0a35895e6b3ecec769ea5e52d46672964dc96a42,spyware,73128,310,580,618,928,580
9726,c74019208efa128ddb5f8fcbd5d04f4d7352c37fb917c7f9f94a30c415f042a9,spyware,346083,1311,2766,2799,4110,2766
9727,c79125b74c0c4ed204b2672f6ada6e93d243463c3213f3487e98a91a70deb637,spyware,395657,1558,3169,3228,4786,3169
9728,c7bd42b53d2ce2f3294374976342b075e97d1c5c3f62c3c42c8c032c2b9fc941,spyware,48952,220,378,385,605,378
9729,c7dbb7fa5f653f0d804f9750c307a5079491ecbf5a21a3af8b0c0291dccf0ad9,spyware,52054,195,419,430,625,419
9730,c871bb76334d8e85963c8109b0dacd04993b84a18c2eb477f8e2e42e3efd79b5,spyware,345749,1338,2758,2806,4144,2758
9731,c87a0f1fad7d75e8325b486e1b407fdcdec2d3752c285abcedc57a1f8c553d05,spyware,345767,1330,2790,2742,4072,2790
9732,c8a70c683813ccaef477cebb023ea1468e23d9ccf159212a23da6801a6a5ea03,spyware,474854,1891,3742,3777,5668,3742
9733,c8ff2eb65078d7d377af2a57b52ce9e700ab3e707550c919e7d8f489e7dc30c3,spyware,424075,1656,3341,3503,5159,3341
9734,c96ded2c6f9148eb1e76d38a737513a4b3ebd67db413980efd130d9c67832103,spyware,42223,207,336,379,586,336
9735,c97e4a6779a13bf8c0efd1df4241d1e6de7ca500a37d5a42482b9ac06dfc2c45,spyware,372673,1499,2935,2919,4418,2935
9736,ca2bab1d2758b9d7f2e5a98ef8120669eebbbf59740c2eb1d81626f98aca8166,spyware,73131,323,534,595,918,534
9737,ca68420d54bf9388b830e19bd5ec59f252df6aef632f7393e21bf00931fe3605,spyware,73131,323,534,595,918,534
9738,cac4070b5d1ced7116c946bb40473355450105ed6ce1eab5fa51076ca8c3aaaf,spyware,73137,288,577,632,920,577
9739,cacb8da9cc80d96d801e2973d559bd469c7e393ae58c5895775c02281a9c869e,spyware,71855,322,529,597,919,529
9740,cae6deb7070b744d221cae499afb970a30d242831756f3683b56e76b246e8ad6,spyware,345678,1306,2792,2769,4075,2792
9741,cb1f5fd4179f795924a879739a1f36885b99003bda8e400688e2fabe61accee7,spyware,73133,330,552,564,894,552
9742,cb3f87c64106566c93be05212dffc3769c00defea57ae41f2426cfb55e06522f,spyware,577632,2295,4534,4701,6996,4534
9743,cb442bb37d177de0fcf9319e295feaeb020e49c57082355cbf4d93add0816e56,spyware,73136,342,541,596,938,541
9744,cb4fef43f944257ca06847caae769f0e818012891fa0ef8ad094079fd988d2f2,spyware,398229,1666,3154,3170,4836,3154
9745,cb8c861559261f1e0b6450b41cae4a6b593b2039ff191ad0b39a1636a9c8fc7e,spyware,72339,297,582,552,849,582
9746,cb9e5bbaeaa36fad151a558e142491def68065495733f966bf56b32b8a2c4118,spyware,36703,130,287,287,417,287
9747,cbdade8117e129d5ff056b9a02ad8e864301ec72c43c0bfadcad34fdaee22052,spyware,345850,1374,2783,2765,4139,2783
9748,cc511d8c8cbb5031dd03e90bc3fc49bf911cce446c715030fa038758a979f363,spyware,45477,229,380,346,575,380
9749,cc55bdb2f75095cb8dfd48ff5c2db9bc34d3cbd27ba0221e623fb202e10516c8,spyware,345931,1331,2725,2811,4142,2725
9750,cc70441e83048af25a27d51410d55cb9c6f82e45cc4258f1c9bf2045edddce25,spyware,345269,1376,2742,2791,4167,2742
9751,ccbe01cb0d904a8f4284b414f34792289c2d620bb4e8d225e8a50994b34087f9,spyware,70519,295,535,600,895,535
9752,cd24abc23084bfcf443f4c0ec33f63af99acfd599a2477f87827fa9e10110460,spyware,73131,319,585,576,895,585
9753,cd2ef797aad68ee977365a93c1af2748b916391a456e69282e573669410cdfe6,spyware,345552,1309,2796,2785,4094,2796
9754,cd3f5d62ec87509f178a01430b2090ed08095ad6c10ff1ace4187edc294ddfc6,spyware,431374,1772,3405,3497,5269,3405
9755,cd53f8fe12c01f5d5363a15990caf5b6c14ca1c3181196229380265735e78a51,spyware,45363,200,341,368,568,341
9756,cd72a8268b7808271ddb9b189439661eec01925a8d602555911af94195e5578c,spyware,72387,332,573,606,938,573
9757,cd73e9187298d8e3f9348fe144a61bb3a4b0ef645e416ba890e0f278dc8b7d3a,spyware,71779,322,560,590,912,560
9758,cd8d62a72e34e11e4b596b7d4a0ca97d3e644e12ee326b30f576cd9a79673a6b,spyware,43797,205,331,335,540,331
9759,cdeb9d681712305d8e517f52889d96a7a03718ad8dd8a9b1a87b40b15be3875b,spyware,345637,1386,2786,2786,4172,2786
9760,ce2e573aad7106bb6e54d1ccb6881adfa3c8d4277b5b130cb24afa135aeecfe1,spyware,533736,2061,4149,4369,6430,4149
9761,ce5049aaacc5ce91baf4e0038996346f6a4e600114eff73ed87cbb93798a110f,spyware,1027800,4012,8134,8262,12274,8134
9762,ce53452827676bf41d100984d3dc21f41d39ab4cb721c93993cf9d9d6a6d7bc7,spyware,356595,1407,2831,2875,4282,2831
9763,ce67d1c79e0bc55183b36d7ac5768e3b6bb1b36d399b538d079880e76e8cef2a,spyware,45331,195,341,367,562,341
9764,ced724b5441af23033c5d5e62d29b48990c36813baf2bf9ca30804a6340980e8,spyware,68195,292,545,618,910,545
9765,cee3a4f26e41119b02ee858de40a7a4e1a2bc21014c61c66580d8fc162ceacac,spyware,45325,176,387,328,504,387
9766,cf347b3bb94288ff19ca065f1f63915bc5f18f9cb0e3088b141affb2cea7dac8,spyware,51568,231,394,449,680,394
9767,cf914e94836f5e4d9afe85f5fd26fea2ce79be81b7c02a1e1262dc9793a35282,spyware,73127,352,552,599,951,552
9768,cfcc571063586096705eaa1b758373d346fd8638c3d38ef4fcd0be12c79299eb,spyware,345643,1354,2772,2879,4233,2772
9769,cff66e5b448183b9cb7703910c42ea1adafa4400269a16915450a5cdc4100e49,spyware,50180,198,418,437,635,418
9770,d0085d59a71261c141dc96901793e46a296a31d6b1cb8763658b77e1db1eb116,spyware,345554,1310,2812,2793,4103,2812
9771,d057e8732f8217eb3637471bb47e7ffa5996c61ac97542a6f98a3d9baa9009cd,spyware,82399,302,673,691,993,673
9772,d09f17d89a58295d2857535e0b557404e0d984709d6342b7cee12a41e0fc85db,spyware,438616,1781,3558,3584,5365,3558
9773,d0bcac3e074c5d4fb4364310104c0c72c13327e8d389f47b4d73cc06a4c43955,spyware,380207,1475,3047,3043,4518,3047
9774,d1042a292cc77d66f786f3f8ccc48ad98dae771f0faa95abddacd551f6ab085c,spyware,1172095,4740,9483,9480,14220,9483
9775,d138c3c875a7723a561ab44e15ebb64dbb856cd956610c5b139aecf1df417431,spyware,345276,1341,2767,2808,4149,2767
9776,d14ce1e05002a25c9d8ce5cf61f42bc4beefefceca9a0e2eaa933aa9438cb5bb,spyware,320889,1246,2609,2494,3740,2609
9777,d194ee9a5b871b039355670a3645286c57debfcf5f8d1c94c3e8d340d7ba67b4,spyware,355357,1395,2831,2866,4261,2831
9778,d1979a51c88d8bb84dc041ac14277f802dbf27716de2cbbc159058b5bddf8388,spyware,73133,328,539,579,907,539
9779,d2068fcab665ea1d6bb7e5f543b227f7e6321fe975822654f014191037985773,spyware,42663,206,313,345,551,313
9780,d20b9a72e473e0975fe9eac6fbb28caf57021a8c7fcb8a40f1acbb14362895ad,spyware,74404,326,592,576,902,592
9781,d2ce12f7318b4af1e2ae7a06a246dfca17d7349fd865cf8079169da935dae38a,spyware,74046,356,509,586,942,509
9782,d2d2f8b5c5cbe4b952355f791da47c571d3615d808916ccb080e3a8423f4fdb4,spyware,345461,1381,2819,2776,4157,2819
9783,d312252b7f68d57e97b61e168bfcf215bb578fea4ed62b58ff9ae0530830c19f,spyware,365405,1440,2919,2924,4364,2919
9784,d31f860ccb46536e0f0d3b8ad72d2456afb8a4f233758e91808a5a802ee8c069,spyware,345724,1379,2779,2794,4173,2779
9785,d3888e0164e5155d8e27d27e577bfa81f4dad899d28dab2131155f97138b5757,spyware,22145,93,170,201,294,170
9786,d3bb66d9213c562ed701e332e4f19af4d2bf271de121e93a0bc0048c690cebac,spyware,346617,1324,2784,2829,4153,2784
9787,d3cfc2d85e51d87a531407ad421578b956c25de6b752b18b4a9800d26695a360,spyware,73129,327,537,587,914,537
9788,d416f33de797f7f2652904bd3b7ff075910fa6c5e9a318797f3f7fd17f411a2a,spyware,345300,1389,2744,2802,4191,2744
9789,d4242125f26ebf120378f23cdda971ed3c61b538dbcfba029b1b9a6913a75c6f,spyware,345431,1353,2767,2811,4164,2767
9790,d45b55cd2d73faf68377b1a98bddab3d1af7c0902a6d270ce5327d202b85b5ce,spyware,53505,203,448,496,699,448
9791,d49366b39eead80e84c05b48637b2f4e5e71a73bec4cf982be51caa836d21286,spyware,73133,339,555,587,926,555
9792,d49cbedbd21d3bc4eecad7a3cbfe8f1b7a3b9f595d583faab45634854af7d125,spyware,14805,72,122,97,169,122
9793,d5215ee18fc17867e91aa22e418d968d7681d78f3fefebef3fcfb0dc2ce60f4c,spyware,345296,1358,2773,2736,4094,2773
9794,d53e51200cad2ea22f822cec1bf29fe71bb0e31b52b9a6420526c77103ae752c,spyware,398082,1629,3206,3191,4820,3206
9795,d57f71d9a05c4859a385ae7d7519f08998b7d252180d6b389de0690a23e58666,spyware,41945,256,298,313,569,298
9796,d59fcd1bfe8b5dc2394cebfcf951d61817e436ff155665a33de5df7ea571c3bd,spyware,73127,342,545,580,922,545
9797,d5a12587645a8ee50062fc392d76f4d21685f7bc0b65e277ab6f2bda751b7bc5,spyware,1261655,4824,9888,9959,14783,9888
9798,d687b66d75a1a4946fea2d406a59e7f572de7a62a1c5b31ad854698c0e61f163,spyware,345542,1389,2793,2797,4186,2793
9799,d6fe6174699384fe9f53610cf3332819ee7d142217292de85cc501a47f20f2af,spyware,43801,190,385,368,558,385
9800,d73ab23b8788c374bc5a32c42b0ee0ed05a6ac2d5d19aa67e8cd50dea7611795,spyware,73130,325,576,592,917,576
9801,d7413d7f978b174089e5508c1a37ddae9351603e04b88662a3c7c3d461e4fae0,spyware,345687,1385,2797,2785,4170,2797
9802,d78493bf500c04b65915aea7f5a89ee52472a13e2b294e9b79b41e1101602d6c,spyware,370868,1405,2939,2936,4341,2939
9803,d7c2b721e635ee6b687e335d26f0a25626514ca42759cbab4d2298b38b68b857,spyware,398087,1638,3161,3205,4843,3161
9804,d7e7265315b66e1c95234d34c3e53db74c8df1ecf06bf3f86796c143da8d0f9c,spyware,465507,1802,3641,3728,5530,3641
9805,d828e611a3aaecbb759702dba8a761e9787b40c85eaed186df0c0a75093fdc46,spyware,64299,257,538,553,810,538
9806,d89a91512236de11a8902a1c999bdaa407fd3ef4d990c0db0865d81c1454f2e1,spyware,345405,1317,2777,2754,4071,2777
9807,d8aae179bb781012dbe9e2ded636f64cabb125316419ecf1cad92e181510a7c8,spyware,459970,1899,3725,3869,5768,3725
9808,d8bdde53399e2230b0d097caf6f285df4c7ec8cfce5564e9e4206a762c1d3b97,spyware,45331,202,405,371,573,405
9809,d8be98397b93fb75084b50edd9be63e87665b2f0a8e0d708e5282593579ce658,spyware,51190,268,438,432,700,438
9810,d8d324b00aa1af6243d8534505a091f653615e4bf0434382b51b159946459ff3,spyware,345551,1401,2789,2766,4167,2789
9811,d8e664a5b401f6d1b4236d42608cd5991ec7167f29fcba0cf52229d55409b329,spyware,345615,1341,2781,2804,4145,2781
9812,d91007d5b4c05171bfff9eccb86dc80b465c5416e53c1efa0cc02f99ebdaabc1,spyware,70484,272,537,542,814,537
9813,d91bef3c39ea7ad574a8f1bf61f0c7dcbc56ab3956ddd0ffe5da41ff5b0c5d7b,spyware,368516,1416,2973,2921,4337,2973
9814,d92255c7a42fd7f95781f91a0ace34afb328435752a2a03e44aee8dddf8a8ba2,spyware,345558,1385,2794,2757,4142,2794
9815,d949747b768b2b6073ab04632e8f44f37a916f11d5b97e6fe8fdb64d00907695,spyware,345591,1331,2786,2749,4080,2786
9816,d96e11d94f7a61c1a3c9b30c6a8c0451f80f422f3f09dce6788257a7d60c8036,spyware,344627,1396,2779,2688,4084,2779
9817,d9ce32b16ab1677dbd4741cfb3229b65373e7a7fccd5cd7fba0facee4de13e07,spyware,42163,172,333,377,549,333
9818,d9d63ee88fc0117581e0460bf909ee01202132263ede54352ba1e7df8da7c617,spyware,411818,1545,3287,3241,4786,3287
9819,daba2e6e0280b1e15122582f05f7f5125959fa36734165fb95cf87026ebc5541,spyware,73127,343,553,563,906,553
9820,dad910b89d1e00b9e7996bd42bff1af33dcdabf29266dca807b9a6e1defad41a,spyware,73786,373,577,605,978,577
9821,db5fc060e468ff36a20c0c0115fcacc75ebc75a4e7d3d216408524d5e3a3cb4e,spyware,365117,1382,2882,3045,4427,2882
9822,dbad5c9a783aacb95e19ae921bc3717afee8bd6dea9764d5328ff19584b9a1fb,spyware,68902,285,528,558,843,528
9823,dbafa775cf8456d17112a5548a8dd4e5e7620025e2db0368e1d800c551cdfd83,spyware,345430,1333,2766,2814,4147,2766
9824,dbd05f2bd83dd34a7edc83e370c899fbb0037a050fa6b571fdf7b298280aca98,spyware,346373,1330,2778,2837,4167,2778
9825,dbd55dffd0fe8c774e83e15a31131141f00fb73e482a0fb212a9fe2160077123,spyware,48963,254,419,406,660,419
9826,dc086eee5631ef1d12c80ea3e5ec8e7821d5e7134b6bef1b1054e3b350b4a9eb,spyware,398309,1501,3140,3281,4782,3140
9827,dc32fedf978a33334b7c4f5f7d0f006583105ad95e7465f69e86061079e6ec19,spyware,51568,203,379,456,659,379
9828,dc4b268d69395f86b05fe7721e959138f9c7ebb4cb40e6f1b846e66019b0c46a,spyware,47365,184,357,400,584,357
9829,dc7a0c56b1edc039ec900e0b4ed5c3737e90f01535ff455fa873cff218d85fa9,spyware,51745,219,428,360,579,428
9830,dcdb5bfaf8cb7f76a882373dc55b3527aab073d445d05520b0908e5ecbbe583c,spyware,74060,323,561,564,887,561
9831,dd4346da5962a47a6f647b6d5ee44de624fdc915e2ef8b1f51ebabb226ea24eb,spyware,345720,1377,2724,2777,4154,2724
9832,dd68373a8d3445dcecef5ea4267099b14c6dfeee0af714eaa17f553b7140e83a,spyware,17366,82,122,123,205,122
9833,ddb35c78aa01cb5e85a3d799e3fcd7b0e95202dabb64c0bb88a9359dcc6b2ae0,spyware,347415,1324,2810,2815,4139,2810
9834,de29d1fef83592402d4f17431c30cf4e36977492a002da4c5d01eb926cced22d,spyware,58673,245,519,498,743,519
9835,de59de82f89890074a61c4e397642e9aa7c59e76ef0e22f7da8766c9ae698c61,spyware,355650,1415,2843,2765,4180,2843
9836,de75841aef62892cabe9d7cd1f70e6a80d586124c609f9c8be2274563e6ef294,spyware,74069,338,523,578,916,523
9837,dec4b986d07751c53a2c89243498104f380e42bbb5604de7c1cf0540eafabc67,spyware,352791,1389,2784,2855,4244,2784
9838,df2bd09ab02e50a480bfbf930ef571a275675eb8e6e3a8259ac5e09b691dd6f8,spyware,73131,319,585,576,895,585
9839,dfc23d0956807ceec259c1dd5e781a0c55452558827158cb575cea358c967e62,spyware,15767,54,110,113,167,110
9840,dfd5c6645b6baebc09db77a8fca2f8fbcee4a077b0355d3bb98431306c607279,spyware,70714,317,515,572,889,515
9841,e0022d2d41dc9e682cff2a1d94b3d96f60800b20824b513cc10ef8e79684097c,spyware,69048,243,534,570,813,534
9842,e07e88cfe5997019aa13654b58dc13896d0af340c13dabbc1c47111f3a9ea989,spyware,345700,1365,2700,2767,4132,2700
9843,e0efc42afdc94f2a85db4f303f0db262d94a82a8540ba0b2cc465a36dad9d334,spyware,361541,1519,2920,2966,4485,2920
9844,e127d0c2f13dbb5bbca4ffe2c458e3e667e55dfbc755754e674db5fe60e44b17,spyware,376564,1429,3079,2965,4394,3079
9845,e1440e1dbf51e487b976bc1934b704ab8b8c9b39ad59bded86d007a00a4b9962,spyware,345744,1391,2712,2787,4178,2712
9846,e1631824d8c5fcdc581a4c00e2ae49ec536ab947bf7e432a9d6bac309f7b3a97,spyware,345754,1336,2785,2737,4073,2785
9847,e1b3a2a5b112c3ab56de294689912a880a29769be537f235cadb89bb1decc53f,spyware,685678,2626,5516,5473,8099,5516
9848,e1eb7276db057916de0cd5eb386de3d8864cd55e82356c928a1b72c784dd2b31,spyware,74059,313,563,597,910,563
9849,e23fb22c4865a51bc61f60b12300e526f51ba53d2fc06a3f3c31b2c81babec91,spyware,466776,1872,3755,3695,5567,3755
9850,e26f649175dd5d28434b47a1d53038e498f0f9cf7013700199c627d16e3a045b,spyware,73129,327,555,594,921,555
9851,e28ff709e58412e95135d266ec53f44ec9aa7b47401aa12aab0ae352ac58ec31,spyware,331839,1348,2680,2664,4012,2680
9852,e2b692f5662da4088014a41f4f815d1c707bbe20b7ae807be54c4b0c3d220bde,spyware,365694,1409,2937,2913,4322,2937
9853,e301aa462b508f223b5ea169cd2558d09ed0fb061207ec38b56f78975c4b451c,spyware,377091,1495,3042,3122,4617,3042
9854,e356cbf402c66ef00884331392d502b684682f7f00ae01591dba7c9ff2c58ac0,spyware,346060,1360,2717,2773,4133,2717
9855,e389dca6d713297265d7c1a462ad7f1a51031ff5e22b561684bf1957e2932bee,spyware,51984,206,416,483,689,416
9856,e3db8fd98433d11fc5350f45e908214d5578d8cfe625816be1af3d1cd6c0baa7,spyware,372700,1539,3001,3021,4560,3001
9857,e4125743311b06c92fd5d699c23382b64c57a7a5fe76ebca1f6f72a567032bd6,spyware,40179,156,298,327,483,298
9858,e505402911f8abf1bd6f2b27cef85cbeeb8702076b5c5e640beabeeac6c3ec1a,spyware,345416,1404,2759,2720,4124,2759
9859,e5278fef55d1bba6b841a5fc90fd23ac36c0c89d352860dfd4444ec5b114d26d,spyware,73127,339,530,613,952,530
9860,e599968f7bd912eab9b1810affc7913cadabb434e4e6a4997143be259ac68625,spyware,73129,323,559,588,911,559
9861,e5d496262c3435e656e578c6b1026d9e852e7a57747c0932aa019086be23e629,spyware,82399,331,652,681,1012,652
9862,e5d9dcb680fe53fcdf8a74a5e58d358e1a98de2d4cc9f79d76baf5cd36ba3462,spyware,345411,1401,2757,2711,4112,2757
9863,e5e13cf5b99327759f53d78bf391a384393f08e384550c6416b09e43c3035453,spyware,54335,295,434,455,750,434
9864,e5f84a8e9aa74f5b67643d07b1cdebbcf401eb8ad61d251cfedbf98a5b5d2c71,spyware,70487,329,519,585,914,519
9865,e613069785c26e207419a78e3d8abba73507a78345af833f8f1c95ccefddc629,spyware,73129,347,572,580,927,572
9866,e63c7a0b0b19c08cd3202c6fb1e651ddb40a25b2627f6d7d7784e551c49f46f3,spyware,398051,1600,3174,3259,4859,3174
9867,e647fa02daf13f0b70bd00e114ac3c1c6eee211ae5fdcdff20777d43b8ee137b,spyware,355020,1313,2853,2886,4199,2853
9868,e661d6fc8484b541daff4ee4d749ca77b1416f22f7dc2016431c75c56c9b97d5,spyware,43797,200,337,324,524,337
9869,e67d4b7c36877b00f099846d275fd49294457bd8a6fd18f73e8a8508f4c0d4d2,spyware,345566,1386,2785,2782,4168,2785
9870,e7692b3be36962ba9499a8532addd6c2da194c5dc2f683290be0251bc6c44728,spyware,72394,298,553,586,884,553
9871,e76aef8b9f472bbc16dd80ea44d5649da332fd3af1b6e4360b2440d959147248,spyware,361528,1412,2879,2938,4350,2879
9872,e89061348cc3355f214f0abef9ffab15c51825dd9afcd8daedd4e8d8b4b81c77,spyware,361524,1358,2861,2869,4227,2861
9873,e8cd45a7b27f81d3796202654606e9517104a6566be34bc1c901f2c259c82f78,spyware,73131,331,556,591,922,556
9874,e9135db12596946b1310795a3dc437a02e96c3c6a657597482d5dc61d82d6c59,spyware,453735,1752,3654,3680,5432,3654
9875,e919e3357f56e9cc54d886a1ab62cc6c4d461a9c5214f9c5e1e381c397ed6abf,spyware,44549,169,377,386,555,377
9876,e93218011a1eaa5f8db44b43ae25553cc9937b9713361a22daa2715a66562edc,spyware,374739,1489,2956,3066,4555,2956
9877,e9b6c0169768c6a50541431dd4a80201deb3c2e81696948f9a35584c1be190b0,spyware,73133,338,547,588,926,547
9878,ea37c29a9abe14241a9ca6ac69c811d7c68a10a4c80cb35755eb91bf17c1b84b,spyware,70486,288,507,532,820,507
9879,eaa1d417496474d7fffacd7a432ba496189a98722ceef6441c6a23858bfba1bd,spyware,73134,334,572,624,958,572
9880,eaa8793b8e0dfa913c3c2eff25dac549d13f0b16ab900a55c40048b7ca9348f2,spyware,350694,1404,2845,2830,4234,2845
9881,eaf900be78a473586b50dc422fcf187f847b5a47cca1dd92704c5afdac877737,spyware,353695,1409,2802,2894,4303,2802
9882,ec02e6d9de862e59a0c6a22655da3bde06601458a9f48cf32fd9e8af69865cbd,spyware,41728,223,323,365,588,323
9883,ec417eff0c1fd42ab5d0600087d0b32fbefcc1fca15ca1745aa4d06af917f7b6,spyware,355309,1392,2837,2863,4255,2837
9884,eca65c7e24681b325ca2308df4c46a05c4b563506769e6821cf96faf274e588f,spyware,389326,1572,3180,3187,4759,3180
9885,ecc5aeebdb54f8cb52a3e3ba2ba62abe2713a76564bcb554b8633cecddbeb844,spyware,492850,2047,3997,3931,5978,3997
9886,ecd0996d5ac7402cb62de627d4965887661a3b06c5391403d06daccce95b4e7b,spyware,345809,1402,2747,2705,4107,2747
9887,ecd22362202cb062ba1f53da02530ba53b017264cf51ed76b0f9d68fe113395c,spyware,646707,2412,5194,5238,7650,5194
9888,ecd3efd1ae107f1fdc6e90a11424af47cc6a24af1f1d66bf92b4360d00039571,spyware,345593,1323,2781,2745,4068,2781
9889,ece890ac08faf1aed90d22f69d90e165e39795e9a90430ef70e3e64e1119d16b,spyware,346049,1347,2767,2808,4155,2767
9890,ed2792a6902b37b3ddfae11ee174249218b8639ea1b6d0ed8f6da81b5c48d396,spyware,73131,325,587,569,894,587
9891,ed966937d1f9fa16d554681617c5bb0525a6524803fb3b864c53cd9818c62719,spyware,82400,292,673,666,958,673
9892,eddf08130e9ef19277065c8dcba649658e53536b9488247ce0e03447b2c4bca5,spyware,74047,350,551,617,967,551
9893,ededaaf1a60c27d569e34db2ab646378e416dde84a3007f902c3a3b83c357921,spyware,345650,1384,2803,2781,4165,2803
9894,eea93dc64029c09ad8027cc626ae2af1457e7bfcc7b4995ab45e4f38b61160aa,spyware,345562,1334,2869,2799,4133,2869
9895,eefaefc31b285ceb92bf93a353e6cb5ec75b1984e2617ce9a6435bfe519b4e13,spyware,368698,1543,2963,2877,4420,2963
9896,ef0ae61f6b9d6caa9f9901aacf8a240ab88dab857a3881df24fa8fd81a2a54cd,spyware,345611,1320,2778,2744,4064,2778
9897,ef23ebe49ee51e0b1265cb6b8e8f19ee0e8bf4209ebe3799e5b15d60096c1e30,spyware,73127,342,545,580,922,545
9898,ef4795fb7244ff25c12fb29c78e59ed9be95be45d6d1c12dea3d348b1bc06bc4,spyware,345409,1371,2693,2715,4086,2693
9899,ef69dd56afa52190b58ec2328fc6736b779701b9945728316d0d4b90995d9584,spyware,381796,1533,2993,3147,4680,2993
9900,efa9a20ee30cd11c0677af92667444b02166928ad4e90ed747214fbeb3d84d60,spyware,68588,331,566,585,916,566
9901,efbe062f121ba44057522da6f2d1283a551bc220ff057c7224045bbde31353f8,spyware,48474,218,441,407,625,441
9902,f019e14d3706e706f3d779672ebc5e42d2c1564c0992b846a2d3698c66926082,spyware,368288,1482,2867,3014,4496,2867
9903,f0dac49582a287493e1171cafee8df1e174c8743274e65eb0c409d63b2f49ce8,spyware,345270,1379,2739,2804,4183,2739
9904,f165d31a1561ffd6b3c55f0231851514adae8003ebf07b72865fa1ae49d23d2e,spyware,345751,1335,2767,2798,4133,2767
9905,f1793d4dd572ab3cbdd805f7068d3b3bc4f51c658916708b9b359cb4339992a4,spyware,58556,279,462,533,812,462
9906,f19e9128fd6d76ac62f24ce2d4817eac716e1a7e7c9e213aa5e0605ad104d554,spyware,345417,1381,2796,2778,4159,2796
9907,f20b4d8df2d4978c6bd91b65b0d5ec3cfb5dd6841f731875e1d9903f3933b2d1,spyware,345711,1384,2788,2771,4155,2788
9908,f232cdfded1ab1dbdd539eb93146314f6abf832887bb5dad69bdbae79dde8cf0,spyware,73129,327,568,615,942,568
9909,f23a59c55968edc7592b6a22e78be0624de8d7cfbfd2afa94a0c372d90692fb8,spyware,73132,331,554,605,936,554
9910,f253c6f720df043d46d9674056b705932618f017345e3196675cf6b83d28f57e,spyware,376376,1434,3011,3047,4481,3011
9911,f254979b432a0c655f2bf217e8c740c95e5bcba0eb3a7665839c2940a1562b40,spyware,73136,309,527,611,920,527
9912,f26a18561ff2bb0c42a37139e3d292ad61a1d44552a6b6ca7ec05506cfc5ac98,spyware,345407,1326,2765,2865,4191,2765
9913,f295ba52bcc4ae55f2c50709c12466848d611973ffd302bc45dd6d8011f669ea,spyware,73129,333,531,594,927,531
9914,f2e09cbea8ed1baa529768ef49efaaedfa17928347c4cd7b8f76f1df211b3275,spyware,737236,3218,5759,5613,8831,5759
9915,f30d9340c6092a1cdf9005ee7f1e98677bc2838ea7d131e2892e399db243c1f5,spyware,417310,1693,3284,3419,5112,3284
9916,f32bb0c9547a0c22f7f401ef31114b1038155b7536d044433b3fc6f745402c14,spyware,345410,1388,2794,2772,4160,2794
9917,f331b8a800efee14dd464424c0fa893bd424b9352a9713d2e831486ce171822b,spyware,30212,137,225,250,387,225
9918,f3934d0465e029d6c56ba474f187481c1ea38e867985bb91f534dafd7de8a23e,spyware,53134,203,423,493,696,423
9919,f3a3a3e99d7fabc7737572abbfe97c72be6391daf218ea22c8057ae76e23c4eb,spyware,43793,212,339,335,547,339
9920,f3b50a00f6e7866155f6ba8b992f52d5eec7ad9cd261a568c72391a84ecad2ee,spyware,73128,330,530,607,937,530
9921,f46df039560f32e15623404f1e23507c839dba064fb2fd1b79b29276505de01c,spyware,320963,1271,2538,2556,3827,2538
9922,f471846c6734c5c237e410560e17ac7cf28838454b6412f415434b4a4dbacfc8,spyware,355545,1410,2826,2776,4186,2826
9923,f4741c9c78f84dc858677e753b2b99a0376ba1a764ab4201ada23fe2d7684bd3,spyware,20825,101,167,157,258,167
9924,f4748659a8e1836559a4f3b90ddf3440b15f638aaab000be2248e4a183b86407,spyware,47420,222,355,419,641,355
9925,f4c5891f9d39aa89d804832327e31833730a66f828d69d80221f7e429ebf3b2e,spyware,464680,1850,3830,3757,5607,3830
9926,f4d6ff2f1a57121c6964504694cccb9525e5b6a76d937b67dc4a0aceedc40c0b,spyware,43557,190,338,344,534,338
9927,f5d8e705120be62050330d2fecc2d9a33caaa09f49a4385a51af409ff0ad6a48,spyware,345406,1375,2778,2772,4147,2778
9928,f5e86c9fe75c78c4be49284e48c9a97a5d9341f7c1d04fdee659ddcab4bdb42b,spyware,940935,3817,7730,7498,11315,7730
9929,f5f1aecb131cf322c7c637878c74cf28e8c887d7ae767f8922bcf381b927ad15,spyware,356490,1458,2846,2934,4392,2846
9930,f60c0d2c12a7ffcc3ddf929228eb7edd76e52ceda57916dd8f815a52ba0dc507,spyware,9008,43,80,71,114,80
9931,f71b0d47162c6e6398557e5d048a9e5ad8968df81431f5c7207961a6ab8d9dc6,spyware,43373,153,371,394,547,371
9932,f7244eba8da6fd080e610a34176ef9255b549c6fe5da605d87fdf3b787ca66f1,spyware,345599,1374,2804,2787,4161,2804
9933,f7b75c1068f045e2821ab40baabffa593dc97759c08421cad8066d48f88bd96e,spyware,73137,338,559,573,911,559
9934,f879fed3da622264cf820a8198fd71fc298c767edfc7d640022f4a95056d81c5,spyware,2166530,8521,17266,17477,25998,17266
9935,f8a1fe8534e2c7402ce62afbeb587b9e6740fd2bd1ccce6c037c494bba9da83a,spyware,345555,1354,2858,2799,4153,2858
9936,f8b1dd427167df0711687133e11dcf7e0a84bc77f3ea37f2da9d2b3a7abd9119,spyware,73131,325,543,577,902,543
9937,f8baed6684598ab1ce6a1e9d91e95c682e138ac364a12cdfbb89753f4fbca28f,spyware,60935,280,479,488,768,479
9938,f8cd0c36dbd70fee5263c6e851f737855f734b3f7dc7e1bbcc173b81e36730ff,spyware,53142,201,430,448,649,430
9939,f8fd965a61d976ba85cce86cd3aafaf5c6db9a24192f4289a416f01534a7e2d3,spyware,73129,333,538,598,931,538
9940,f958b2f93beff3ced69736dc77b4290f9197b91d20a38a1145098d4776717e30,spyware,59876,241,486,472,713,486
9941,fa5895663fbcd895a617103011cd32054bdfb5888e3de152c64522f7ae83cb53,spyware,371414,1422,3006,3029,4451,3006
9942,fa5ff907b4e095d788d5a67fb4e178734680257ab955a5bfebb3b3ade4d98bdf,spyware,345659,1377,2778,2789,4166,2778
9943,fa80cdd56a20622eef419d0346450d1a877d98dea917c3e8e6ae8bbc622af6e9,spyware,345692,1367,2863,2731,4098,2863
9944,faab10cc7f75b9826452167e940be09d4dae5229f8b886f759e13c53a65a6bdd,spyware,73133,338,567,575,913,567
9945,fbed7794d68207b3d280ae38220d086d3eef38764e3bc2fb77d9bcc471d799cf,spyware,73131,318,546,574,892,546
9946,fc41c3a52b8f528a874d4dab5c6cabfb55d8c3c9353075cdac75f032bf67d5fa,spyware,73131,342,555,582,924,555
9947,fd4f3d65248ad337d22d58dc488463c7dac4867f64824f69c486fb12bd732cdf,spyware,345817,1378,2791,2770,4148,2791
9948,fd84a432324e26c1ffcedb323559ff30d7b70a8f71a7bdac85153ce005b1f555,spyware,487773,1803,3886,3843,5646,3886
9949,fe007203305444b19dcd2e413af24dbaea0220fe74f2f3b01498ace6e5299563,spyware,74412,341,533,578,919,533
9950,fe11aca0acb2232d672382650bf3a33b10030a05e052620fb302a1bfb37a101e,spyware,73135,324,542,609,933,542
9951,fe5c1a4023ca2863e0f2ff07674f20d1d7b89733ca8510262b1ad5711b885f8d,spyware,354126,1404,2820,2860,4264,2820
9952,fedd40afb5e8dc1aa23ec30c355bee94133a34d0be27ed80bcafde990e585ca5,spyware,329088,1313,2621,2639,3952,2621
9953,ff11e2abb32a84ed03a3f27a238b745b9fb64913324b6e02586240b45e8758b6,spyware,74543,361,576,606,967,576
9954,ff3fba1644490e1decde3a70df4bfe5c7398760ef5a1a933413d0c06aa21a6d7,spyware,477375,1771,3842,3845,5616,3842
9955,ff44d6df71321948275dd3d24383951014233918b4709f87e8611ef548e1303c,spyware,73126,354,571,573,927,571
9956,ff9850dc0aef10c9d8dd4380dbefd1d051263b353114a74e9da29c297d57a186,spyware,351251,1420,2781,2837,4257,2781
9957,ffb59e208fc8299d56b594843114dced7e04783c358dcbe5d66c948171e6c4b9,spyware,73130,343,559,598,941,559
9958,001eb7a647c0a5c2a61b8b8383a2c952f5e0b651210eebea53caf1cabc5a95c1,worm,223157,858,1728,1745,2603,1728
9959,003115923f6be8037156ef95eeca296b70cf61cf581846a59bc7401e917ad11c,worm,222953,887,1773,1718,2605,1773
9960,008a808d1510be16f663a40094b6ebe9b603f42a8401c2fbcd372cd68553d5a3,worm,223002,876,1721,1711,2587,1721
9961,00c65903c25da1f689f43408cecab6bfc8d45d75c72926e7816b3811816b60ed,worm,222834,884,1763,1814,2698,1763
9962,00e6a2b16e3e7f7630b85eb9b850760ce0b72e8f5b317bf7759be4d15f96b488,worm,222710,858,1635,1829,2687,1635
9963,0115b488e924e8034ba93d41cf7078541ff506e7848a765fff8d3d8a370189f4,worm,222874,907,1681,1783,2690,1681
9964,013931c0addb6ad822c51e1e359a74ded7ff5830d0c8fdceaa525f38580f4401,worm,223178,843,1774,1743,2586,1774
9965,0180c84461ffa36f86f8a5b5631816afc0bebb8d524862c2921925bb773cb425,worm,221620,828,1744,1711,2539,1744
9966,022250f278a929fcac202cf12b9d21beece7126596be48d978c9722a571162f8,worm,222979,895,1689,1811,2706,1689
9967,024e86a7429c886b135efc4ff87cce445184a26c21dfdb615304bcb94a80cbe8,worm,223343,840,1813,1816,2656,1813
9968,02e6716cd538cb9fbef66f159992af5f339624a109e6d20b6f918a532d4d0ae3,worm,111228,420,841,877,1297,841
9969,031688d067f12fa9e20ea4c22a1860358e1628c14d65ceee68c6d0f54ad93534,worm,222803,876,1747,1790,2666,1747
9970,03338a3412a673779bb19c4977cb7c9269cbc47502327d804f3080ccda11d90f,worm,321657,1255,2489,2538,3793,2489
9971,03f7cde69924f8dc4af7877ae4b6380f21119daf33280da8a96490b2ef289787,worm,327764,1300,2555,2622,3922,2555
9972,0400b4e316e3b5d7ac56711e69bd46d140086037977ff43f05fc29c58653e0f1,worm,223297,841,1748,1793,2634,1748
9973,046a0db22212957504a3e9de2b08acdd41b58b5b171f52051a47352ab7f25566,worm,223065,870,1676,1728,2598,1676
9974,047e5476b888b634854e5677b915020e1151a040473eafa987320a2ddc0e086e,worm,223296,838,1706,1845,2683,1706
9975,0486a890fe32451728bd26732d564d86520f02825677648f33b0163ed5ec58ae,worm,222974,928,1716,1716,2644,1716
9976,048e2ea022da99b053bdfe8613bbb17c9bbaee833c38029e283630399951462b,worm,221912,893,1741,1703,2596,1741
9977,04b1e3f4978e65a3104d33584f93365484f93895ea6ec38ee1ec18db451b09eb,worm,223294,848,1770,1757,2605,1770
9978,04e037144853480f1eaaf7446a71ce4a4d450a46fe9c24ec3274cc97da224ff3,worm,222711,876,1689,1795,2671,1689
9979,056ae6c730a724ffbb5d052cd9d6537092c54e9049674851589c51ffc9cc72d9,worm,223038,902,1739,1799,2701,1739
9980,05a910bd127d92540512ef4495967dbccfb2898563b0484ad24274c281489f26,worm,223014,901,1707,1755,2656,1707
9981,064b52d7f02d3c1b6c3fbda7c6c07466ef2a4c5349a3c661034d4fc130792286,worm,223176,852,1762,1803,2655,1762
9982,0686e6127589a80d20956c488e5b06499831d9023d7f7fb435d7f93053ff2de9,worm,222909,855,1736,1811,2666,1736
9983,06979d02f33119dcccd513340112378c822ddeb7e6da4780b78d506160beaa9f,worm,221775,836,1730,1788,2624,1730
9984,06988763db22772ce8dd567b51f5c72c1c04f8e81bfa86c3b29ba1ac493754d1,worm,223053,889,1719,1738,2627,1719
9985,07051eded2b26269dd66941cfb7e983cfccbea79625a82be03fa811d04b29816,worm,52151,193,405,412,605,405
9986,07637dd31039c1214f7b6ace373a840537eeb2387736f2fb77179fa5460dd7d9,worm,222862,858,1671,1812,2670,1671
9987,07b5fd43281d50b02e241145b3e286f30e53490c6a8cc6dd960989f8a0ef6d27,worm,222943,834,1742,1804,2638,1742
9988,07b5fdd9e8933f24bd7462421b3037a17f92eab335d9a7f74979604780f250dc,worm,284176,1205,2121,2294,3499,2121
9989,08b7d54013341000f7597f8b46c66c1192773a13bd3123ed309a8a9ed1b32ed2,worm,221923,927,1782,1697,2624,1782
9990,095289f55f037f0d634d53f959912df5679b4e31b0e88dfa93a0e3f8161fb865,worm,221946,883,1721,1743,2626,1721
9991,09537b1ae74ea08f6e38dd8bb4ed92c819c785b002e949c2a0858a6588e73869,worm,321761,1286,2523,2462,3748,2523
9992,097aed4378220bdabab3ea51e9f996451da779057942e4e1fc6893d4e682e149,worm,222855,872,1766,1760,2632,1766
9993,0a2c4cae0ddae321e1c4f4e9d21e9a1ff5f2bb56d7cacb8142dbd97113ed7317,worm,222893,885,1703,1774,2659,1703
9994,0a4c9267c4ba05665fb04bf09fa4790884a034a78a78d2e4fb7b1f3518d6b309,worm,222923,888,1701,1834,2722,1701
9995,0acc24154b6263d641c40c4017eab5c783d4e9b195b85adab5b730c886028a2f,worm,221847,863,1687,1805,2668,1687
9996,0afe3cc0fb5a771ae27b52841a61990a9a9b34091da5a3b8e56e942602953178,worm,223187,838,1756,1778,2616,1756
9997,0b59238fc87fc16317584780759321d7a1ff9fa3878842cc2edd949bdfeb3291,worm,222092,850,1800,1775,2625,1800
9998,0b80409d21f627e89aa06bbf7fda071f7f7d3b94c3c9ebcc9dc2664b5574ed70,worm,223028,858,1736,1738,2596,1736
9999,0b86dc98338348cb38da319b692aa7ce09a4b7068199e0641875d7956511f2f1,worm,222759,880,1694,1755,2635,1694
10000,0bd6282ca04a0511ee5d978dbcf350d5e63b77bc2e59d012ab7d29b103d5b571,worm,222043,844,1725,1778,2622,1725
10001,0bea78441fc4a1627e7cefa47d7869afdfd3d0296ed5a7002a7c2beb05ac344f,worm,222201,841,1720,1763,2604,1720
10002,0c242ef218350565d5285a5f8d3d5acef8a70aff6a3760fba9a2080004310fe6,worm,222980,862,1733,1792,2654,1733
10003,0c3a065b1c07877c27d21dfd3bc49010966a6435820f56c3e448e223e4937e39,worm,223070,875,1707,1781,2656,1707
10004,0c3f4dea939a27aa5a10dbf6f9ccd422bebe7096d627c092214cc15cb60b9ec9,worm,222533,944,1764,1804,2748,1764
10005,0c5d16ee4774884f389388ef8625fc2453fef1c35a92936eae599f973424ebe5,worm,221974,895,1691,1778,2673,1691
10006,0c76990163a3a36a3721f1a440e6bc07fdb0bbe7c1653abc4e7c04155934f18a,worm,223027,872,1672,1750,2622,1672
10007,0c8bcf5ce5932a8a8ee23ae1249abf09690ea38f251c7c35dc896615f8a4fc2c,worm,223169,858,1780,1755,2613,1780
10008,0d36b3a51505820c499c935d36962e0ab733dd60ecc097adbaf379a3b540ce68,worm,18464,51,141,152,203,141
10009,0d53818d884c3c409fa1731b74efc82497f5c16a1d9116c5bb131d76ab551700,worm,16009,75,123,131,206,123
10010,0de5ceb16058b2b50832c80129faca32ca6c4eb8edb4e6e2d2dba7dbf60726c7,worm,223010,865,1702,1768,2633,1702
10011,0df14feb05c534f5399ec415aa73dfbab5cff5bf42e8dc6960fe10143164bdf8,worm,223064,932,1748,1813,2745,1748
10012,0df174227bc43a03277ed066d88cdba0d91baa726ec383614cf0e371af5a5e2a,worm,223221,861,1756,1847,2708,1756
10013,0df6e422c73a656e7e5b7c122b3bb0131868fb3b8e0f8ed867aff1d5dd80083c,worm,222903,882,1699,1812,2694,1699
10014,0e521983a8a9b8f63998669874c8b80a9ab72a3c9e05e8b5d1464facd5c5b1c5,worm,223039,920,1755,1711,2631,1755
10015,0e6f27d45b581288edbd98a734af2864e0524a27409febbd8e72631348778812,worm,223223,854,1694,1725,2579,1694
10016,0e780fa183560e8090751e8f7e75f9d3ab95c47ba38a2a0890c0ea588f82e872,worm,222890,828,1763,1784,2612,1763
10017,0f39583ed25c8bf06aa07b9ba58e4f24f1534424deb2b08c2173ed8b8a42bfa9,worm,221864,839,1666,1782,2621,1666
10018,0f43afa8003398b4aeabda8e8ff2e6ce60fe615a01fce93b4c31ebcaa4360bd7,worm,223133,884,1755,1734,2618,1755
10019,0f5aaab8246c1fc0fa41b81cc3cb7a10517fc4b30ccd9a8452fdbfd885fac2d8,worm,221977,877,1767,1708,2585,1767
10020,0fc1e17719f14fd60d7782ad1cb0f06176a63c3ef589c2cdd954253b82c0964e,worm,221968,910,1693,1756,2666,1693
10021,106dc5fedec70fe70e8ec67e7dcd0ababcdb45e971261636844b78ab7c3b830c,worm,222097,857,1728,1810,2667,1728
10022,108b39ac2c0bfb056f1aac42e01e0f5b9a02c4f579c7e11bdb8ab6dc86d2ceaf,worm,221771,925,1733,1799,2724,1733
10023,10a7b9c5d86a25d1d6abb325b26b4d1510aad40d04c9af4de4ae89c29d8d7899,worm,223090,881,1720,1697,2578,1720
10024,10bc0210cf2ae272be313023b3e8491ecd196e93120dc7a5726f9466fa05a722,worm,222973,867,1768,1782,2649,1768
10025,10bc2a07cf73b97bdf4bf3f3b13810cef6364c2656f8a2a7966d303b05d046f5,worm,50552,193,414,398,591,414
10026,10e8879ac8b0860d73625f483574e06f16a9ca710b104b44fcbe66ac229d1523,worm,223138,824,1777,1710,2534,1777
10027,11047b219c6a57f8377bf628bd392581801b3fd6d2ebe53771f9d775aa74a026,worm,221888,856,1746,1774,2630,1746
10028,11173f3404c5d2082e078d06def73febb6ccaaf382f451335f4efc298bfca6e5,worm,223001,883,1741,1735,2618,1741
10029,1131fea285dae4d6c80fd058ea7453dacfd6065cba57fa178a185f629026826c,worm,222203,829,1736,1748,2577,1736
10030,11730de37f25b8113c3e7078588c6a04bf32f0f74c6e3e04ed3e20e208e70810,worm,223009,874,1741,1695,2569,1741
10031,119abd54fd7a51d4ba9a4ed5c066d65534df817c2b5170ddb2abec6810a84463,worm,30871,133,255,237,370,255
10032,11ae9d61d3d100c811e635566cd32fdf32021caaa433ee559f27c75feb344de3,worm,223028,905,1749,1734,2639,1749
10033,11bf4841b4114fbc788e032dace9ea81254c3d883f8311ddcfdaed6b25a75920,worm,223122,860,1723,1681,2541,1723
10034,12693f6ec37cf5fbf5f7b8f8d970c465b6083bcb2ce34e77b1d60a15c8bd38f0,worm,222820,896,1703,1812,2708,1703
10035,12cb0c8eca0bd8861783240b1512ff9a7785b1f0343ec95076a71cbf9bf03b22,worm,221886,864,1674,1748,2612,1674
10036,12e1548ee3b497af0699e430f87c795b0eea4868005f3e4d40b5e8abce2b7734,worm,222861,832,1774,1805,2637,1774
10037,135f23aa1e818df7b9a70b3e899e9dbb3592470cad90bc246275c9f9739fe397,worm,223122,879,1725,1802,2681,1725
10038,139cbe18ccca1e20e27096a81e10a1e10e1b093ab7ede6e994474d2655584cd8,worm,223169,918,1752,1721,2639,1752
10039,14120f6682647af59a73685d6a652dbf0a921ca130e5ffeb6cd21329209b8c31,worm,222879,816,1715,1763,2579,1715
10040,145be63be9950de4e05986ce1e4e1fa57b6adcb3377d9aad14d803129e86fb84,worm,222862,913,1771,1804,2717,1771
10041,1471feb9812a3c0b5513d026820784f1995c389ac96431e4829db804dea443f9,worm,223322,831,1780,1761,2592,1780
10042,1486a1c9e8d34317b1f5ec4c0f852278bd90ed2ecd5a9b1d90a951504f4470d2,worm,223037,875,1712,1763,2638,1712
10043,152cf74555d5db03855cbd087a2753477f92d9dad0bc8655006875ac1a83aa95,worm,223130,827,1701,1792,2619,1701
10044,1537647ff7f97df5bf8679196200bb159c5f659a876328d07bb0f59a6eac412a,worm,222964,890,1734,1816,2706,1734
10045,155a2783a51ca1f6c7a6cd1a7519cf54367946e8a32998695fc58a058fbe2649,worm,223249,890,1735,1857,2747,1735
10046,1564de5081cd596e26c874bf0618675c81c93bb516632c11f9426f75384d7d8e,worm,223026,869,1719,1730,2599,1719
10047,156742a6f6760bdeae09759c6879fc8063880d84ac1e3c203e05241feb22f6d4,worm,222883,867,1772,1795,2662,1772
10048,158df287ddbddd22f97642eff5f4cd2a1c505fe3468b1b521cbeda673979fbc6,worm,223080,858,1771,1762,2620,1771
10049,15f45880f4deaceb38e6f02ca1fb6c5f7c7baa1166d207204983cc539ae34108,worm,321805,1272,2508,2511,3783,2508
10050,1647e3c3011d7af8d77ba564a3607d7e5554eb208b5d32ff5bc2e538746c74b6,worm,221809,901,1727,1769,2670,1727
10051,16557a2e2cf2a7b5fa1611c5cb35625175ad7ff340e483ed5485b2f599a07736,worm,222898,863,1730,1794,2657,1730
10052,16a7e0a741a7d283c8108f5a115db341c754f6f784d16c156d699b2a6d4169bb,worm,222910,832,1750,1757,2589,1750
10053,16b905279e92b1b3bf495a2f35c18224bea8170d02d729618be4fc4c11ca0908,worm,321961,1238,2508,2581,3819,2508
10054,17127d0cc97a4569613d9ee90000f5800feb4a59eddf6f0696e1c79929e41b77,worm,223076,833,1717,1697,2530,1717
10055,1715db22df0fed54df8f04b830853035f6c0808ab3fab2529978fb4f93a4a558,worm,284425,1209,2112,2284,3493,2112
10056,17a837b13cc3022f84396f1b6f171ec566db0e4370533684608e2a8a730d348c,worm,222876,891,1717,1812,2703,1717
10057,17b4fd36e667054916bb9c2a72747dbb8a34cc04f549ab33d0ccc1d1f429a968,worm,222867,892,1678,1764,2656,1678
10058,17dc58f27c54780c8f6bf400355b80c2ca0639001ce091ff32945173ad5a8a66,worm,221739,880,1730,1799,2679,1730
10059,1809a993d605718e51e0045b043899b1c6900d739adf3afa92425e0150d7f6ce,worm,222940,894,1742,1768,2662,1742
10060,18123f9e9c3db988b02efe3dda9a957131a33fc4b20bc5bc16299e8735e3eb7b,worm,223168,833,1715,1767,2600,1715
10061,18208a154615b5d5a56a71af0f130ff1607c2982f4a03a8519b6f4afa2850325,worm,223246,861,1741,1821,2682,1741
10062,18af4c624579ecbfa89b5ad504e5b9e1650bd9d0b9b6be5336080a8ac3fd1811,worm,221909,836,1736,1768,2604,1736
10063,18c9054be36e7be9e4571886e92f95473f4fcc85b26eb5cf932df61bd451f3d9,worm,223162,901,1750,1738,2639,1750
10064,18ed72d4df3bc6de2cbd563288a0a28a9b2f9dbfc04c78de5538b58fb4bae36f,worm,221888,858,1703,1823,2681,1703
10065,18f4aa9b69fd0fc53f7006cf2159fdbfaae5cc30ae9443adfddc8e79a84eef3a,worm,222877,832,1757,1814,2646,1757
10066,1908bf61dc4701fae455f8d3e56d56f6b06ecf0b6ef59197ccaa05e3da08f86f,worm,223210,894,1772,1782,2676,1772
10067,19645bc65ffdb9cd8f99cd1221e3ba885f712037815d67d3a0efade76d5ea74d,worm,222958,875,1739,1792,2667,1739
10068,1a1d43d11df6505babdb4cbad0e0318694808c2ed1ffd31091669c4268494ef5,worm,222944,865,1694,1779,2644,1694
10069,1a8d0e3ada33f56e7f560f52b29bf0d841075c2dfacf4d226b4d9d94d493b8ba,worm,223119,887,1723,1741,2628,1723
10070,1acdaea714b1a26bb5cc189736b13b29d9ce7b25e759b1c3492a6e89988e65d0,worm,223040,904,1706,1791,2695,1706
10071,1b0c9102f8aa5880ce5c7c14bf4647a91793c7799a08a70cf8dd1f40c05376af,worm,223124,853,1811,1773,2626,1811
10072,1b3ef24b99d8097e527506de6a5e4081c042f2e800a4a9637ce84b99870c1155,worm,321666,1271,2535,2530,3801,2535
10073,1b4c46461a95fbb51da3a335c65d0c7b798e98ab82de634fee659db08dd3aa1e,worm,223153,822,1776,1780,2602,1776
10074,1b6da617c499356c0e6c78af6443a4a9c79df298b106923ccfc806acf154386e,worm,322010,1213,2525,2516,3729,2525
10075,1c8d08f6b9eed363af53b7a91cb15e0638098250783a6a7c3113f6151059244e,worm,223031,917,1721,1742,2659,1721
10076,1cbf525ca7152a7a84f98ded49ad64f08240924bdbf884714252e55e7be16aca,worm,221771,879,1699,1727,2606,1699
10077,1d717e7941fa46e8782a26f72b65bf58b031482c165e974a21c925c1726eecc7,worm,223024,927,1747,1787,2714,1747
10078,1dd64612efcd9dc6e75fb35ce8e6aaa5f7d46989e274f317622af62c23885394,worm,321865,1271,2564,2541,3812,2564
10079,1e4eaa64bfb5075be53a1472edc3bd829d8f3bd8601a17b3f4b2645a3392e317,worm,222839,873,1741,1732,2605,1741
10080,1f34d563b34542ea0c9dd7c70f9df697cee8d1d4b238375ef286ab16460e2aad,worm,223218,874,1760,1716,2590,1760
10081,1f52b04ea9363022d7b8a82cca331c971b9126fada67ea8649b03e794394e00e,worm,224916,897,1767,1845,2742,1767
10082,1f85b5206eab445534316a16c5978fdb2123a915e81e697a3c667084551bbc3c,worm,221778,879,1669,1778,2657,1669
10083,1f8e81e0b0231dad519ae02e47c9ef4ead821fd99fde91e35339a86c0bf7c27e,worm,222192,844,1772,1838,2682,1772
10084,2047b3310baec411c921eef4ca97e2c42c766991d2f3cec35a5538b27033ed77,worm,223190,911,1725,1726,2637,1725
10085,207e0ba8a3e6f7a1c8b4c197c466a9763dc3b80733cf64e12a4d40749f39b426,worm,223142,881,1789,1782,2663,1789
10086,21274acc338a1bc1cf58ace9c13140b4bbbdcfd7fea8e9e1302c3e64ef2b9170,worm,56160,219,447,441,660,447
10087,225121b7bd48e17f19897127d4894103a112bb50ac0b8aaaf0a6d969070b40fd,worm,18470,50,154,130,180,154
10088,225880c39e35434ac7c8923f3f70ad61ef248590c297c6706b1b4a1d30f54caf,worm,222678,860,1689,1788,2648,1689
10089,22e8d6ec37c4261a449c64a9ec63c78ba7f501f9c198913cacd9df89bf590caf,worm,222978,877,1657,1826,2703,1657
10090,23114eef5de76afe841de19a0b867be0e6d585450b3f8865f85bf90ac67547bb,worm,284267,1209,2119,2281,3490,2119
10091,232404b16c15579a85717bb4cbba5d74a674abc6bc86b9059d334a414219d853,worm,223210,898,1769,1724,2622,1769
10092,2399f0cbeb39bfdd8a0b5274ef9399d30d4da65cdb67bf226e028e7ddb004bd4,worm,223226,879,1773,1818,2697,1773
10093,249e16fc12b7316491e626c342bea3eca6e08a32d58dfc7774cc7aabab339619,worm,221612,850,1661,1726,2576,1661
10094,24e4407cef4895db899aafa8dea373ae47d2c7da0ac874216a0dd588d33afb22,worm,222062,874,1764,1744,2618,1764
10095,24e9214382a9df07bd24ef31e02a42743d295006b50b7960a851ae1f72a3f8d6,worm,223120,855,1774,1731,2586,1774
10096,251a50c01a8f1d0243c3cbf4e72aa8ce975b48faa58b220adfcfd820388897f2,worm,223249,870,1809,1840,2710,1809
10097,266174cbd2fa939a8322be2b47320459e64444d02a1071f67cbdbb9bbec1efe2,worm,225097,860,1810,1757,2617,1810
10098,26cc943d6bfcfcff20d53237a2053b793abe25750adf12ffa8c7b746a415e0f6,worm,321790,1260,2568,2536,3796,2568
10099,26cdccb1ca9d488d75eb1763778dcde3d240e7640994e6d982b881de9260c492,worm,223008,884,1802,1727,2611,1802
10100,27230a0fa2bc930a6a4a58c9f1524535a1f5929b1e7a88e4151906f16cfac5a2,worm,222018,882,1738,1761,2643,1738
10101,27292739eabc1f2f30eed7cb02fa1c22b24a4a5f9ff15f06a1176456eb0f8e5c,worm,222050,847,1782,1713,2560,1782
10102,27382a588927fcd90d672245628cab481de8e8903a76f57eb1592af3aae9b3f8,worm,223095,827,1776,1737,2564,1776
10103,27d789cce3ad60b77a5709d7658885a9e171159af239332569c9af16e88b311d,worm,223123,855,1739,1709,2564,1739
10104,27d7d7edcd1d97030d63bb4280758b300d3e30fc445a2d91d440653b6449ca9d,worm,223058,833,1744,1691,2524,1744
10105,27d878550c6d0ec0704cf7aff87f968a0fd6ecec2e0b7eca044bd74ea5c84115,worm,223283,860,1725,1754,2614,1725
10106,285ed7491fc142a37aca2fb1d5de0d48870015e55e1d15a48964109c1c9c03ea,worm,222834,849,1722,1799,2648,1722
10107,2860a70760ee3e86017a580adb2760e6679563cc98e79fd7f1e893f0b8b4c718,worm,321999,1217,2560,2543,3760,2560
10108,289146cca669b5fae111720e3340348a6e45a131ceccc273396f8764b168cff7,worm,284218,1210,2112,2283,3493,2112
10109,291abe369b9395278a290a139f60dd6f8ad2513b4cdb78daf88d91433ac4d613,worm,321853,1211,2559,2453,3664,2559
10110,2928d16a1dca4d771c02aa4e32a68813a1e65e6e953897cf45432cc5746dd680,worm,223167,892,1742,1707,2599,1742
10111,29e670efd6e1f053677b916d34fe8d869b1a4a76d5f9c27df90390af00861c50,worm,221711,860,1734,1754,2614,1734
10112,2b1448cd7759a6d89667bfa19ff6027ba7bd933e3913efe6b7e6cb8e44243c3e,worm,221998,883,1738,1762,2645,1738
10113,2b2410e55d4902b2ee39b7e8460d49e92f431db172eecf401efe88b24ea35f8a,worm,222887,863,1744,1774,2637,1744
10114,2b2b1a9bac9a63e6594b81aa0e04de5f30d46ce27612c7abec3a80a9e3785e9a,worm,221817,794,1763,1779,2573,1763
10115,2b9ed798285d5134078ee296ead8255e009764356dad4209a081ef9c9106749e,worm,223077,908,1734,1726,2634,1734
10116,2c62b48abdae97888f50a7f09e9022793e5563a8422801cd6f3facbd607384cf,worm,222822,860,1790,1773,2633,1790
10117,2c80c13ca3d939bbdb30839f3a9425450395466ecb6a2904172ba2a75dc0faf0,worm,223070,866,1699,1737,2603,1699
10118,2d1f44b106ee78a8ba84843a2c95f7ee10775325c63ccfc1071f651c3fcb4e01,worm,222845,842,1710,1747,2589,1710
10119,2d21aeb7e27a07c70797f456c1dccf519ef0248b385f868f4e3813e10c8647c8,worm,223061,876,1786,1763,2639,1786
10120,2da0236014c119afcc2b42029408ec1cb9d2d07f5f76853b3ceaae2edd9b20ed,worm,222903,879,1707,1819,2698,1707
10121,2de60068166a405e799ad45b8e3419fc8fadaefcdda313cfe952740405d1e7e4,worm,223070,893,1744,1758,2651,1744
10122,2df07cbe275da8d245c4a83f7e1f2b26eadc41ae72d633bd48120d47ff92c0e3,worm,222799,870,1699,1805,2675,1699
10123,2e05b17b7168a268a2e7eb16a8c5b075d36a10c1ffd01ad35591b88db99a8ac7,worm,221906,897,1689,1783,2680,1689
10124,2e33d9ff9db1ac406873afa1fd6c112fa46b7f00c303646834d791f6a71727c6,worm,223074,852,1702,1712,2564,1702
10125,2ea2c96b59ba6602f495512fa840339fe49b55bcd1b8939192258c4db136645e,worm,221922,865,1695,1725,2590,1695
10126,2f2d86c0b6701ac29856bdb4098ff247f680dd3032e1f8bd937686481d678db8,worm,222826,891,1722,1716,2607,1722
10127,2f6f79f59733504a9159f5ba13f10479bf51182743dc5513ce7101dca291703b,worm,223080,853,1775,1716,2569,1775
10128,303459327aee4efef9e2c3c1aba50901896532eb0d773c2e462e32e9b21931da,worm,221849,842,1717,1810,2652,1717
10129,30392dae92ca4c2c9621329a43e08aaf8c641e330aa5a3369971d44854f7b85b,worm,223073,858,1758,1733,2591,1758
10130,30c41ad0ac2f531eb7a976fa82e4b4471c84a1ff4ed087a4bbc0257556bc0e5e,worm,321876,1264,2522,2544,3808,2522
10131,30e71fac412a104ea5826225c591cd2a475f722ded4491782cbe9b6e121edf84,worm,321677,1302,2500,2555,3857,2500
10132,31424aff65ad4899ee550cec160a8d8cecec424926905a2d75d78e38e986355a,worm,223112,818,1699,1711,2529,1699
10133,31ac401cc24d855222a5342e63831c0fa997cac826d09e743b4062171986ad98,worm,223027,893,1742,1726,2619,1742
10134,31b15c5f5f3eb2bdde77ddd4ea10b4db5eade86f5d6c7c7aa59e3ea247a2b9ea,worm,221947,876,1714,1738,2614,1714
10135,327b61156dfc16a79e82ad6a1ed5150808bafa1797599cca78ab8b9c353a4916,worm,222953,880,1727,1833,2713,1727
10136,32bf444fef43cef781c5719b84b4cf80912ac347271d09977acff81551e2cd1d,worm,321677,1270,2538,2504,3774,2538
10137,33212ec274f417a05993ca427321a6085fa2df56ae5def1b19facd60e9061ab6,worm,222816,873,1735,1758,2631,1735
10138,333b5ad56cc72950a365b80560d661804fe28bb0387e9d865c55fc4fbe02b741,worm,222968,877,1695,1731,2608,1695
10139,333eb280f3d2f0914859a6c31015db78f8ba53ad0bc3fefc257bb1686d205362,worm,221855,874,1717,1771,2645,1717
10140,33557e22d0b3b195316b1a7877d0843f08439688e5b395f0ff7b33b01017d020,worm,321723,1301,2551,2435,3736,2551
10141,335bb03bf3097e908ec840509ea1ff62dd1cb3879075d039516eb47f26bfe1f3,worm,222878,886,1732,1739,2625,1732
10142,337ee5b39dd28da9ed8b05c9c2a9f77108cae17b281354f48032448db7f03762,worm,223013,909,1778,1733,2642,1778
10143,33851c4b226fe49c2b87e8c134ea867d7800131e40caf334b1220c00cac0a27a,worm,221803,845,1717,1788,2633,1717
10144,339071b684fc8c075a35b1654808842ed0ef41059febbf1ab2fe4bc3e379e2b9,worm,223129,858,1718,1712,2570,1718
10145,33ad1ca2f12bcc3d38de40f645c050a842e59a2dc60c1c8c18bd2c78074afdc7,worm,222775,883,1750,1810,2693,1750
10146,3476121ca8517fbe9c327fb62e309d5eda79b8120b23d1a0231982cf0eccf8ae,worm,221757,859,1722,1743,2602,1722
10147,35025d5e02ce97b4e8f91a6da0e98d1706ec9dd99e423a996b1885f9a6ec8897,worm,221988,814,1750,1711,2525,1750
10148,356c5f816cc49d2d42b12984881ffd515cd9f1d09bfafd3d909fe80a765942f6,worm,223272,870,1770,1767,2637,1770
10149,357dc80b0ae8ba8928ace993db690bcd8b9e2d75f361b39006e8b3c1fcc20ce3,worm,223041,889,1707,1790,2679,1707
10150,35b0db780c32b5b74666b55f04a4a37820058c5127fddee7ccd57a6962c5cf58,worm,221912,844,1718,1788,2632,1718
10151,364096485c406dc2591feb38d18cec01a1aca895dcc59624050a825e4af42d3b,worm,223002,868,1745,1764,2632,1745
10152,366b5d6c43f3a6fcd2fc53bad3c5096fa24dc602be3e43a9ec0954b70c1f8a55,worm,377302,1466,2978,2996,4462,2978
10153,36af9f97fdc02ecba0665f2b2fb81367b9e638a561b8e5d9356961182883f28a,worm,223193,889,1769,1715,2604,1769
10154,36eb048ee007c8802f8371f1e5dfae205ae56bc8aa9b40efe9f7b230036570c6,worm,222937,875,1755,1769,2644,1755
10155,370c5ceaaaf8d67721c744e0781736b9cd77fa88107b384565c033113951ddf5,worm,223212,888,1794,1793,2681,1794
10156,372acbafc4700f58b496913cebffc4a42c7700fef2579b4789d33297fd90e9a5,worm,222816,871,1738,1829,2700,1738
10157,37336205a9d4b96818a853789d6fc3a57d1ab0f6403dd4ddffb10b739c9b8aa8,worm,222982,890,1683,1759,2649,1683
10158,3751732f7da80115a5a04663cefef9f9b048e684adcc55abfd375688d3a47323,worm,223071,927,1716,1787,2714,1716
10159,37676449949656df1cc41506b3b014cf6fbdbd92e35e9b59f0dadf22a9adf69c,worm,221964,867,1744,1787,2654,1744
10160,37706afe57de3503ec6f2187b88ae2e2a92c2ff3f76ecdea7da6266b2b429b0b,worm,222986,873,1711,1798,2671,1711
10161,37fb29cb9f4e02e5cd9335bd91d9cb1ceb0b1f2234a61b7a96fea62f7c1dee74,worm,223182,837,1733,1771,2608,1733
10162,38375e84ff44058859ce149080120c1070fc3785c900a4c6ffa359b31ccb075e,worm,223147,853,1794,1732,2585,1794
10163,384e100174299ca84eeafc52e301da7afd6474d9c850f2497057b42e17e37f0d,worm,377379,1489,3019,2986,4475,3019
10164,387238a9c02c5a25840ac39dfb3e92b9380e053d04af01f7c15e3641578131fa,worm,223044,917,1711,1780,2697,1711
10165,38f20d2ccd764084c550814408afde029a21f94f31ef61ba837cea2fcf91bc1f,worm,321885,1238,2499,2518,3756,2499
10166,394328b7ed41679fcddee3af37e325fed8190e95caafe08184c1199c304bb331,worm,223109,847,1760,1735,2582,1760
10167,3a0d83c40d255cc3c8272de96f6b0fa4dc9c372dbfc5ea4f92d7e57c0930e8bd,worm,222771,879,1675,1754,2633,1675
10168,3aa651b7e46c57c760017d28447282c81862a2bb14f0dd4e36c729a3113ffb23,worm,223069,879,1767,1757,2636,1767
10169,3ae1dedfe8183b5cb19d1f89b42232986722e4b803c404ae5ad6188b9d4a661d,worm,321762,1290,2538,2517,3807,2538
10170,3b16b7716fb6b3592d632ec9ad0d44ef99eb305bab3715b71c7773cab4e99422,worm,321631,1246,2612,2492,3738,2612
10171,3b434528edc9561c3d886d479cc24ae0ddd683d49aa48f22c768cc205881d25f,worm,16141,71,131,115,186,131
10172,3b5883ff13ef4ed8034ea4e3e2cc417fe3fbd2df9a5fd6d7c8d983a872798e9d,worm,222946,883,1746,1784,2667,1746
10173,3b5ce1c4edfceaf714ba13f0184888f347d8be0f6082caaeb83dcecd73ae00b2,worm,221903,886,1676,1739,2625,1676
10174,3b5e3f66c77eba1e656fd06c73e4f05e54cfcc671ace636d4481aba453b73a1c,worm,221848,878,1704,1802,2680,1704
10175,3b8a0537735d188f87e41308a7eb0e625f6364350842345e9ee0181be02fdf6d,worm,222939,887,1763,1764,2651,1763
10176,3bb636eac9d039fd587517623f178caccd4c0848f8082541bb5751ea5771e4f2,worm,222995,898,1682,1756,2654,1682
10177,3c660c1c81387cedeedd7805db6183381a5f945d415a3baa34594e4a888888f3,worm,284101,1211,2114,2292,3503,2114
10178,3c7ad96d11ad1eeb18c8b7e07b5ec576ed04a32c965098c0c7d759dd3baf6284,worm,322006,1243,2575,2583,3826,2575
10179,3cf71d989d663f1fb302eeef8a899537f6c797439cd198fd983ce81d60cbf2b8,worm,59556,237,466,445,682,466
10180,3cfe64964afd7a86bc28ff2ffede1583d239128d82b081a50c824d5b1f396ad8,worm,222884,856,1735,1787,2643,1735
10181,3d35af364fcc1ca9c8d103936611cefce7ba38b4966ef7479619cea30a320b90,worm,223151,890,1767,1748,2638,1767
10182,3d6786931c4e0a1e1da7d63d5e7b9f93248d90091c8d513c7153996f9a5e6b32,worm,223197,835,1765,1745,2580,1765
10183,3d7851c6604814406666fe1d7a1b79163df00e108845c0046eda8798a68e78f4,worm,222755,864,1789,1790,2654,1789
10184,3dbedb714e3e53376a15678b5ca7c8656e925bde702590a122d55a1c36a15bb3,worm,223215,878,1786,1760,2638,1786
10185,3dde902b33c6e410b19fb7a154d7c41ebec932f528a687df3397ce24252e1a52,worm,222952,859,1728,1782,2641,1728
10186,3e9bf759e56e99e5f9c7d12314dbeb4bcb75c9b4c5a529570dfd52941083e19b,worm,223141,833,1772,1740,2573,1772
10187,3ea1b54d1291b9af891dfee9869704ec9c41e31b9296a98bc7e17e05d48aa3db,worm,223159,859,1780,1693,2552,1780
10188,3f38b6cf0a95ad55e99d20cd3e76d7297da6e98a227eb8c828a5f9b793f90e07,worm,222968,909,1697,1788,2697,1697
10189,3f4dd6337a3b4d938a1f95cebc81614e76936f97004a2f4e6a3043916e5baf8d,worm,221892,837,1746,1747,2584,1746
10190,3f82b705d775ea1759fa0ea209c80049d4e1a565fb7f10c15b55e2c37093f179,worm,222748,875,1759,1826,2701,1759
10191,3faa21286489fbd30869e16dfb68804c2754caf42e1d35797d71a292fabccac7,worm,222939,852,1680,1804,2656,1680
10192,3fd92e7cf7e87cc225c58a5c15c31ebe5e9370e1940225d0b92c1d15bf617ced,worm,222948,926,1738,1749,2675,1738
10193,3fdefb9bef1cdbadd5f2026bfe0b5b6f6452882e477c3afcb3d710a14ec84fdf,worm,223028,891,1697,1724,2615,1697
10194,403d9d9dedb63aa7c3e9eea6ce572db5d2c3e3becdc91081d19a0164b26a5d91,worm,223129,876,1690,1764,2640,1690
10195,406b8c140ba7b463f3a496df8f087ae129487f60cca0937542c57b01af269bf5,worm,166462,679,1333,1281,1960,1333
10196,4070813eab9c8bf7de7b1e1657f517475072e69d3b5b288c6687e09d3b66c5fc,worm,222960,881,1727,1768,2649,1727
10197,40b7884634142dccc72e846288e42886b27088432400decc2955597687c0d8e9,worm,222871,863,1742,1763,2626,1742
10198,412d6c614c00a18fbe24198d949026b45944f5574c3d204225c59d660bc80432,worm,222996,905,1713,1817,2722,1713
10199,42086bb4b6832afa995f831c007f83a5cafef2f30521f7873ac950a6c24afa7e,worm,223109,868,1762,1768,2636,1762
10200,4214f072f206e5dfe507b014b9dc91571a9164c98e6afe900f914710c9352f4b,worm,222862,877,1775,1762,2639,1775
10201,425dff94bc14716c01f1d445e7efa2e691b85d1b1e345013ba8222200461faa8,worm,222759,810,1761,1741,2551,1761
10202,426331e011e1e0818001dd62b0a15f13c6e63509f5fdde6cf522bf06aa506052,worm,223249,851,1756,1759,2610,1756
10203,4281a988ae2a26901244746572a61c76fad573293b3e4afcac64a7db584ec0cd,worm,222933,888,1674,1804,2692,1674
10204,42acd8a8ca1294e5948e05cdbefea2f0ef2dbe837f8475df28197e787825b8c6,worm,223091,869,1781,1702,2571,1781
10205,42c7bf5f3c562e393a448d04ac161628e4a6f93bf590b76c8e8e7a8a832a7a44,worm,221846,860,1736,1736,2596,1736
10206,42d95b5a73f9e148544cea8e4670e06d526f134d8f67a6e632d403c1671c67dc,worm,221874,870,1727,1733,2603,1727
10207,43380ab221b6e2a8254e22764a4aca5ce19f33f4e39032b0dd628eb0c88918ca,worm,222239,885,1782,1774,2659,1782
10208,433968a5eaec256b09a467e2e49ea20962b67c0ca24acf630666a60b0e4ae5aa,worm,223025,892,1757,1707,2599,1757
10209,435e298583d1056f65626834633cd2b01c19a5f032b50edfce22805b9bfe6f34,worm,222052,853,1706,1740,2593,1706
10210,4373c659e6a231c56fe33999a6f9ef9bf2adfc0d4314d986bf021ec63c5b59ce,worm,221988,901,1778,1720,2621,1778
10211,439606571da0acb0bec98cc55c230b1df5c1231ed8e84221fe0065250dea7f52,worm,223039,882,1746,1713,2595,1746
10212,439c7a6e73d6c3ac8b5df4487c5b0582b40cb7d34e2ec1bbafb3c10f6acd74e4,worm,221729,877,1772,1696,2573,1772
10213,445b075bb48fe99654eeb31920168676eea254f80a9dd0531d74e70b499e75fc,worm,222915,881,1709,1708,2589,1709
10214,449893c9c948660b48fca9cb803392fba9c89c616e543e7a4f81cf2f78d64635,worm,221797,882,1740,1773,2655,1740
10215,451b248830aa392d11ec2de39d5472f0790c7ee3b12b4341a589c7590e6a6edc,worm,222819,936,1694,1773,2709,1694
10216,45846a647324900b2061d0e2728d6843e180aa56bd710488f261ed13d4358475,worm,284302,1212,2115,2278,3490,2115
10217,4592d85cd2493054ae43c1d9aa3b29cc5e7a442746328e5b6c47f0b306820bbe,worm,221879,850,1668,1773,2623,1668
10218,45d8ef734e890dd15134e7bce6b1f99f5cd93b42e30535833b0ed2a381d21a0d,worm,221902,839,1730,1829,2668,1730
10219,4617be4ec99ea8747ada98765efdbfaacd84ae9a01b24695f69b74f3a4c75321,worm,223049,901,1742,1779,2680,1742
10220,4643f1f82a224ed4b32356106c2ccb50029275ff8057ade10e0d1742641e1e09,worm,222827,868,1727,1743,2611,1727
10221,4675601b1a61c21a492ee6fb33f4b6b9785cd2d76f93875e6ab7c0d5598f9684,worm,222047,870,1738,1725,2595,1738
10222,4767a62e267eba6349f192545eb82a3db780482ae976f047ef7b683fddd2a2b0,worm,222908,848,1761,1772,2620,1761
10223,476b14b8fe40a8400e77d8cc17e2903987a45d88a32ddefdcffe9e44ec52ca30,worm,222862,867,1758,1785,2652,1758
10224,4776010ddf83997ffae3010e76619b4900876f86c7d49417dc60f384eca5a968,worm,321726,1280,2574,2491,3771,2574
10225,48b6ad4860e4ae27530f8480aff8ab70d4d6527343ece591576c6e3aa49e6f46,worm,223154,899,1721,1819,2718,1721
10226,48eb9829bb9201dfa5c89f522848f3a68e02032d553b33ddb921c3c00421fdf7,worm,223012,859,1768,1798,2657,1768
10227,48fdc8bd531c718faf60957172363e002a4f008ee15bfd7f52e30e1f5c05bad4,worm,221641,884,1735,1778,2662,1735
10228,492d76fdcd2de408c8ddfee8553e06b562f24462ad654bed5f51c27dbfb1471a,worm,222025,808,1705,1756,2564,1705
10229,49443f36675c4505ee84969523ace65b683533ae3a6fda4969ae363635ae0c41,worm,221890,894,1679,1773,2667,1679
10230,496f1019a7c63c25ebcd9d2502b5870b167c5b8a5a5eea320a15041ad718b3f3,worm,222949,895,1751,1762,2657,1751
10231,498c18855c40420374cb1cdb367d1f4666b7f6feec40081440270b4d671b7f0d,worm,222969,882,1693,1761,2643,1693
10232,49c92f82ecea035ba68db60ae7ac4a29fa2fc9748b43f7128ddf0f565211a100,worm,223028,881,1726,1772,2653,1726
10233,4a951a9c6ed7e914bfcdecbe81f404d12ca1c981ecbd02e39c7a62fc475056ad,worm,222762,845,1738,1740,2585,1738
10234,4a960df2efffec47893570355269fe88c5d89cf6ee8d4b426f691390f6cf3e62,worm,321590,1218,2524,2540,3758,2524
10235,4a9c0d7c56464be58dd713ce4cc7df4d03cd66d4f3614f37b5eff94be360dd88,worm,221790,832,1752,1780,2612,1752
10236,4aa0e2a9e5c0ce5658c73bd32b6aff5f754bef16607a07760341f672cc2a1cb3,worm,221911,855,1745,1769,2624,1745
10237,4afeadd002f8df249a74505a1fc6c16a5aad660a7937dceff88cc2a27f381c9f,worm,223036,926,1705,1781,2707,1705
10238,4b38caace08a68a42eb86b2cad06d7bc1c528d8a417a7b4b8103b4d8e3db6326,worm,223054,893,1770,1765,2658,1770
10239,4b67de32a866a07e258d71a96d15b2e95814540cd027e5ade09d51ffd1a3ece5,worm,284629,1207,2119,2284,3491,2119
10240,4b757b918fb52b2f7b74fefe5864c45ec720d8313fbf3d45da650fab31ce1c78,worm,223146,845,1727,1717,2562,1727
10241,4bb0bedfdf6dd28fc5ea1b528c86b669081c6f7259d80bbcc964d4787bbda2e7,worm,222991,866,1755,1760,2626,1755
10242,4bb2a5d64fe837d8a72812b64c8ed8ede8dd3dcb9a0f70cd7b1db6867b4e798f,worm,223203,891,1771,1757,2648,1771
10243,4bf948c5cecc9c72ecece5f0c16d0c48e778bf85f1158cbe1ccd6606391e979a,worm,223108,870,1764,1741,2611,1764
10244,4c11d9ed41a13ae7580c9f0d9180486e2dc24b2b18e83c8b91a4582cda4bf33f,worm,223103,879,1752,1724,2603,1752
10245,4c177e0c5d2fe9103e44776c26baebb0f841a8b61ab05533ea9d8ecd2f7bb1c1,worm,223068,867,1763,1736,2603,1763
10246,4c3fe381a3cfe5abf22a71a2ade68e8e004d7e12646cc8673b577709fb7b4ad5,worm,50684,189,396,418,607,396
10247,4c877cc32b8ddb7894092e5248003d8f38900ee5b9875fe9e65ae7e5e16d91f6,worm,223086,895,1741,1751,2646,1741
10248,4c967e73b687603a463e84e9dac9073b495471674efdc41e7dd22135fcb79170,worm,223212,882,1762,1691,2573,1762
10249,4cd09015640a4739920565ebbec287efb75f909717642f37b49543b573c41406,worm,223079,865,1715,1813,2678,1715
10250,4ce55b98345c341acd98dcd96d006e2d900074ef4b1cdf9d3a9612b70f8cb916,worm,223018,924,1726,1708,2632,1726
10251,4ce7ecd5ec813363043485df9fcf8768f940f845f1ed8ada15b08448676561e6,worm,321903,1215,2554,2504,3719,2554
10252,4cf40a5a044288081754be956d9a2385f013624e5b2bf9e8e926c9d4e5f1e3c1,worm,221926,858,1662,1820,2678,1662
10253,4d1dc2a54260834f86a4fa7df750c417f2704ee068c397e1c90f14cf1e4775c4,worm,222666,902,1711,1750,2652,1711
10254,4d5cb81e9f04d01ee71a6ee8c2c2b4940d3bf7f826401357b41890d46d2f17f1,worm,221976,889,1718,1688,2577,1718
10255,4de72fbb9f2ff8c3261f9beb6674979f0fd1a59933b8ea385a3a4bac63f3f4a2,worm,222539,911,1738,1787,2698,1738
10256,4e2274dcc97c87788801183f1032013b2a810bd58874952e5a8fdac6eb4c7723,worm,321892,1288,2594,2560,3848,2594
10257,4e44afe8d8914654c11a6bfddbe4ce12d1e36d92e861bb198d2b42067a270456,worm,223186,868,1800,1740,2608,1800
10258,4e94abc4400e1cf5f05b71a04c5d1e3806a3a6d4a85d79dfa405ff4f60eaa701,worm,221994,840,1706,1743,2583,1706
10259,4ec58a90f82910b77cf11074c6dfd242013378d9107e212a8821b54da370c7e9,worm,223044,899,1704,1787,2686,1704
10260,4f0c181c11671627b2bf82008968fb178849fe86da6599556a21a35db9f76a71,worm,223025,901,1799,1756,2657,1799
10261,4f8182649aa23487726e6ffa21e4295436f583fe2be41290bb1c61bf017d17d3,worm,222881,863,1713,1733,2596,1713
10262,4f8e791e2a12e5e79aae90ccc1225a3dbb85b55a10d3a6db19f4c95794111c2c,worm,223067,849,1781,1751,2600,1781
10263,5020a68bd297387d26f196ef23ca196244034733ff5098162b6b115ee55624e5,worm,222880,828,1738,1776,2604,1738
10264,5034140d260b8ffe8b5814ff5643082b3388beaa3def3ef45986c5ec097e62f9,worm,90010,337,697,725,1062,697
10265,506be59aaf24ea0741a2f875fb4ccdb1601cdd908120e972924cd8ac7aa9b7e6,worm,223059,889,1750,1726,2615,1750
10266,5116d2a6892bb08f80ba20806c0f7d80ce5ff9ce12a5704a28e0ecb71c95548a,worm,16006,64,156,128,192,156
10267,51427d73b0bfb2d70149c948cc4c3dd71eb242d2d0d85c108b850510f1d99ccc,worm,222896,876,1715,1819,2695,1715
10268,517b35191cfabf1cc7072204170776d981045a2e5017cd4678664f330e440518,worm,223028,898,1686,1689,2587,1686
10269,51aaf6e78aff6d572bd7b925c650c5fc2c18b5f2e5332b66ce7af8034a4ec7c9,worm,222049,876,1735,1718,2594,1735
10270,51d4372090ced78cc8523a7df2179becd102dad365ee03fb8b852ce56c82ce9d,worm,221811,882,1770,1775,2657,1770
10271,51fd861bc1acac81ff52f69a9a4b8a07ddd5c1e180bcb94553eae335b0960f2b,worm,18467,45,123,132,177,123
10272,520a7fff90606fc1a600fe780d781eb6eae24dc4f99597ee538d2eff426104b9,worm,221867,873,1725,1768,2641,1725
10273,52532aa30ff1cd7a283754fa7577a2bcce011b35ea3daaf079b80bfbbf766183,worm,221794,857,1736,1780,2637,1736
10274,5264bf03355ae1b608481c2e9865070838c70fc532fb25608fa010a11605537d,worm,221855,913,1787,1768,2681,1787
10275,52769c4edb75223d8218e224fff03a3519b031d7ec64aa99a42ed223f2390827,worm,223069,926,1719,1788,2714,1719
10276,5293ba90e8a06349f06d61ff97a63c2fbe33fb0ae9599ee2326894e9cb9fc68c,worm,285310,1217,2124,2298,3515,2124
10277,5345ebb494f3ef9c1c5371c0dbcec80cd184311203d37ac44adca8821d908ab6,worm,222896,833,1743,1811,2644,1743
10278,53d54e258f3682ec1ee9aceae0dd53968846c76633c80bd0bb2317e37668a30d,worm,221851,874,1726,1755,2629,1726
10279,53dafd94a4c0de35281253b6085f86217edc8f0194873fd1d67fc53803f48850,worm,221898,871,1690,1749,2620,1690
10280,53e653ccdcd74708d16ba08a9b45eb3618f7ecc67b02de81707da181b210939f,worm,221846,883,1773,1754,2637,1773
10281,541ceff26cba6d031c50dd0492040eaf0264b4ba00fc5f6260be7bef32e44277,worm,71304,240,538,564,804,538
10282,543c97319da83f008e0e086211eec5010fde4f4c773ffa558251fc262f6f88ac,worm,222982,874,1740,1716,2590,1740
10283,54463e18edffb4ef3d2e6ec4ab5f2674c40c4194c6b8fe8ef1fcd5183e5b23a8,worm,223082,878,1713,1737,2615,1713
10284,5462c4e304f8636d5b42490b84483d883269f4bf655a766dd15704a7f380e753,worm,222014,880,1701,1729,2609,1701
10285,547c3e5b748cf7cb9b929bb5d4e89c5aec5da0c0b5daee8f1b2cb5798627a154,worm,222961,877,1719,1837,2714,1719
10286,54c04a24f47f3e93e2e86f8443264bc080deebf0ae826bafb54a3902d6881653,worm,16009,53,129,155,208,129
10287,54d33ce150144adcedaececd8fd89520cc13a4f45d228880ad8edfd164ad15ee,worm,223252,879,1782,1818,2697,1782
10288,54dcb76c4209d9d40d01b7f099083c1a30c664c5fed7f933a9f811b3f62042c5,worm,223054,916,1721,1764,2680,1721
10289,5514c37780c8dee5a0ae88644858399adfaeb2decadcc03df95792551dd5cb9d,worm,222683,823,1686,1750,2573,1686
10290,5581d7923c703849a4fe5664777ab2898816a8605191b700dc5d0906f9cc2e98,worm,223176,846,1760,1808,2654,1760
10291,55e75d0ba6988a203d2ad4c2777c91b1e3bb3c3fd750e52e96aaf773d54b97b5,worm,321789,1268,2588,2490,3758,2588
10292,55ebab9461e2c728b1ad93672edfd60ff51b2a417db73e5b557bbfde6d4618f8,worm,222064,846,1773,1746,2592,1773
10293,55f77c6e452e06f7be7e5b41d03bd0e8083da7f72326e8a5067816e445ffadb4,worm,223117,852,1742,1795,2647,1742
10294,564cec1cefa7457e337bd3691775f3ffb42227f395810396519e41c1a11047a5,worm,223196,858,1721,1782,2640,1721
10295,566b60c9ba6addfc2e92894586156bdb7c64b09ba74ed3e8f1a0a69331e21765,worm,223199,870,1751,1758,2628,1751
10296,56b3dcccd494a3dd7d87ffb89357c7779380133f770d480bbc2db37651762a3a,worm,223114,847,1761,1727,2574,1761
10297,56b70b23283dd7577de900ee3cba0d3c2bf5c50fcfed96ba3dda571e7b0655b6,worm,221893,851,1671,1805,2656,1671
10298,57088f8935113eac006b521e6d1dc6745ec4a2135555e356a450d3d8b317847d,worm,222036,831,1757,1753,2584,1757
10299,57c41418e830f628d4d23798c9a0d6f3bd7501116211f5e7bf1e02f98a04c9bd,worm,222985,862,1715,1701,2563,1715
10300,57d5f228ab396e8d0817997cd7ca2878bd0b7b5bece6d4161d262b6d66fa104c,worm,377545,1422,3051,2984,4406,3051
10301,58557094f29dc00d8bf39e5e30973e5c4fd8cfb2d831c063782d6fa5982aead5,worm,221834,852,1710,1790,2642,1710
10302,58d252550e951672324b18f4a543ac2cd14a513c88bd24958c5c75d8e1f5baa1,worm,222958,872,1751,1782,2654,1751
10303,58e0f0dca6d8a1cb24728f9997b3564ee0b96f5d33d6a241258dddf65ca21f69,worm,223116,842,1722,1765,2607,1722
10304,58f9fe74413808de382da95e20df05027b723dffd3e2cd31152409010484e701,worm,222958,875,1689,1762,2637,1689
10305,59188d70334c8e9d6ae8445a8c89284f53004676c628fdd399726945d618c50d,worm,223004,850,1774,1679,2529,1774
10306,5a1efbca0aed1d6ef1275e76535052fb0728a704a8e57c67c20a4cd76ef85b4c,worm,223274,849,1761,1761,2610,1761
10307,5a48d8c1a6b8cddafd4bd6e05bc201ea6f1ef9f1b3f7cde90c568defce3ede91,worm,223085,817,1747,1726,2543,1747
10308,5a7274859219b0c82e7c60e3c4dc6dfe52450427b9e14c2ee99d90e44d5c44e4,worm,222923,853,1715,1807,2660,1715
10309,5ac603f3f43faadf74f170083b7ac0ab7e1914f0d5cd1e24a5e9c106bc308bb1,worm,221804,822,1734,1833,2655,1734
10310,5aca6f6dd26e1bb8dfd2d4d7dc3582dec83cbb994afd3a88fe6268a21c1fe48a,worm,222820,873,1768,1740,2613,1768
10311,5aeef8b8d48cb6e23f4609a1b7f5ae515324b1db3bff144cc11aced1b2b5352e,worm,149930,547,1156,1118,1665,1156
10312,5b45656eaad3ff73a6fb058058944f77c3d29053592942a9725d01c0c3c434b7,worm,222896,877,1757,1745,2622,1757
10313,5b9c81cbdd2d6db6128af87841a710c58461eaf57f80814909c96b751b0033fa,worm,223079,898,1737,1788,2686,1737
10314,5bd8af5d5c79cbf77aa70a507bf6f9b890e7f178a1e0fc89b95a1ab08122387b,worm,222935,875,1700,1799,2674,1700
10315,5c454e876cdbb4f6993f67e59b1d86e6c698f67992aa802d383dd60ada6e859d,worm,222930,855,1758,1802,2657,1758
10316,5c738301b6409aec0d85197d88c965650af8e5f9f6b4e2554f7c9ca4d7fac55b,worm,223221,879,1793,1737,2616,1793
10317,5c7cbd067eddcd4bb4c8704072c4ba0aedc72dddef492104cb4c95dc17981653,worm,58739,214,445,454,668,445
10318,5c90da113e78c476fe008cca9ce6ec6af6f5483a897f4742d76e689748ec6c69,worm,222916,834,1783,1801,2635,1783
10319,5cb63938e60582749d9c9b31cb32d958e04052fedab4ec6fa71d18179b8ff56d,worm,221933,860,1730,1764,2624,1730
10320,5cea15fa391872fff5ac790cd795569d254190e74709d1e408bb3fe83aaee7d6,worm,221711,837,1718,1761,2598,1718
10321,5d21e51057592e20fa88f132f9cd9009636c74348c2836a38aabc0eec9c8d186,worm,222081,873,1732,1703,2576,1732
10322,5df2d38495d63c6e04ebf5b1b58c3fba8ee6eb7c65ce60d4e8f9acd7c8045014,worm,223113,834,1752,1724,2558,1752
10323,5e4889460e3e374a44d909bd441e3ab1c6c232bb87834633d9625696c9c34fed,worm,222988,883,1719,1731,2614,1719
10324,5e964917a40a401db80fd7e0ab891f872b06aa3ea35ff94625b9a271b1a632e0,worm,222968,864,1742,1727,2591,1742
10325,5f29edb4e56ebc68ab5747096a1f545ef5752842d2c23a0d3ec154854d69f758,worm,222015,848,1722,1719,2567,1722
10326,5f6fcddcf3ac0345c00326659c624897ce46c42896097d31feaeff6329456cfe,worm,223076,863,1732,1723,2586,1732
10327,5f90657f23e470164558cca8a1971890604e397dd2f863c8ff9ff3f074a2f6e3,worm,221762,935,1772,1798,2733,1772
10328,5f93bea3aa3acf51e9df0aca62ee5ee64980a0cdcdad75d017643f75b58f3617,worm,222079,882,1742,1715,2597,1742
10329,5fa9ec99cbf0f34175d0f55cd76f1ce50f7ccacc93b835d6cf9aeeea08f01f73,worm,221893,891,1686,1759,2650,1686
10330,600a070948670b40cc71dfde8dc9bc8445498de22a7ebb5e52b38471efc7aa4b,worm,222961,842,1717,1695,2537,1717
10331,6032221569a58b31447c283f3266409f6b1201aa57894cd1eff305e9f365388e,worm,222937,865,1729,1768,2633,1729
10332,60824f5077d7d05b25288045d22f465446bc7b1d4ad64f3012e485855f65393b,worm,222997,911,1763,1718,2629,1763
10333,60e70b05af14c929ec7de1d64dc81925533f5b7e6fef77bcf76a3753e46c0993,worm,222899,823,1719,1783,2606,1719
10334,613ec3c824d20858cca337d1f1e134b5bc776abe1060f2c121b54e417dc86a3c,worm,221967,892,1744,1708,2600,1744
10335,6167e8031ee6ade07c4504b941a7c8b4056827b5a51002b7c73abf3b470bafc5,worm,223143,899,1776,1732,2631,1776
10336,61e3b389e032d6419d43399a0b7f70b4f4ef10d02fa9ac56ff78262e3ca9ee51,worm,222885,852,1785,1817,2669,1785
10337,61e95f58e9de157867029693cfd07fab2d7b11f87a7b6908a77b44cbe60d04ab,worm,321805,1246,2490,2472,3718,2490
10338,627a9b76475dbe6090657c82b4669b8417656c06c30da4a8df4d560b735abea1,worm,321871,1285,2536,2530,3815,2536
10339,62a446425bf8b70660f9bdd07c7cffc35414f36e7786aedcecce8957c1b8734f,worm,222156,864,1757,1846,2710,1757
10340,62d8bbf52dda9e4da654e16b9e77b30d64b3f9a76a9da3f1da78bfff909d224f,worm,222865,850,1752,1796,2646,1752
10341,6396e39d0757a20543f3b7fc7ae53a9c836c9c1271728fc91225e7574b065d48,worm,222020,820,1742,1697,2517,1742
10342,639e9d998bfd2ee4da1b0710ac9d272046b639ba0797352fe5f183c92f61d145,worm,223082,870,1737,1768,2638,1737
10343,63db0960c1562ca639fe25f9ec083e0554c5a72ea9da9d9fce56db7597ad6a17,worm,63992,244,492,495,739,492
10344,63ea70bbcf14890e2608053948ba7ea9327176aea6b549b906549bf836657490,worm,222901,842,1694,1810,2652,1694
10345,6428b60e84d8ec09452b6d67d0d17b2a40a0a71edade38440a5fe78e8273d377,worm,222751,860,1775,1780,2640,1775
10346,649242c55a1476948f3e4144af14717997dd7fbc0d95bcab7d5ca76794f4e068,worm,321956,1255,2523,2612,3867,2523
10347,64aae0468cf9310360914d17b2ce47eacb627bd6959fa457560d9b6102558e4f,worm,222836,886,1737,1827,2713,1737
10348,64ddd904bab232be271d3d49db9cec436fd70454d899d0585ec56649a94228a6,worm,221759,856,1733,1747,2603,1733
10349,650e96f8c03d9be30dcf49a96c07bb7bc68207ec0e7ceadc06824f0921365aa5,worm,223269,910,1782,1811,2721,1782
10350,65108dd90961fbdc8e9d4a6818925f337621c16a66acec31c53a074957601b13,worm,222936,887,1736,1777,2664,1736
10351,65336a2a55bfe62c1a00fe6bf2b289c05153cf5e5248d50237671f66b0248033,worm,223239,872,1744,1777,2649,1744
10352,654e76e6fbb31254c91d2365ff2e649930b3cd9b5a9dc45648bb0d015514b5b8,worm,222940,906,1766,1779,2685,1766
10353,66264aeb22fe5308d9a75c901762b30b07dc6dc959d2c2487ff9e617e9135ce8,worm,223027,896,1727,1697,2593,1727
10354,6646862ac87499e972f230158c6e9f98a41f33e565e66e2da582ebab7de400d5,worm,223337,886,1787,1770,2656,1787
10355,6661c931ee5bca881c3ed7271085ae30b81d2e908df12e5cf697e2cac6b3c608,worm,223040,873,1703,1756,2629,1703
10356,66867bf47302c3df4e15d1b536540b8ff14cbe41f2a6b34ca98b96de54f57203,worm,222847,910,1794,1821,2731,1794
10357,673347997848faddb21b827fc0c07ff575b3c6e768e2bd66124ab752168f3a92,worm,222949,901,1749,1776,2677,1749
10358,67393af14d449ca23e3d66b433f454ff60488c0d6f5f3f7c6edd74ca9e0b5ad5,worm,166357,643,1280,1310,1953,1280
10359,67be275402cb559663c31fa7fb1a12b827209306e448b436e5e52e39f97b8601,worm,46451,162,344,369,531,344
10360,67c849381221629d798cd97981682897a384551f57e07c2bebf9d06825e26782,worm,223232,874,1760,1739,2613,1760
10361,67f636d00f1e5d558d33a9b93edacebd50f0b3fbe35d325abbc48a495a2e5aa2,worm,222859,906,1707,1716,2622,1707
10362,68758eef814e8d439589807efb843e218429668dcadf3f45d422694897b34559,worm,221898,892,1730,1790,2682,1730
10363,6879bb01d3812fb4097cc270dce983ef9f77622b522d220ccba63703782b2d2e,worm,321837,1269,2573,2533,3802,2573
10364,687fd60cf5f198a7527c8f2ef5b6c249f5417d775c4f35a24b01f0a5ff611a48,worm,223021,855,1766,1776,2631,1766
10365,6932909a375f0670b4ce0e7081894e5190b13545745f0994a296d6bcbfb5dec6,worm,150074,555,1171,1171,1726,1171
10366,69ee8eef08c962171913422a2f65e7b8259a20343d07fe5a46362cfa2371b0ff,worm,223082,849,1745,1792,2641,1745
10367,69f0ce5898fd1e8541d62cb6a0c3d0d3b6664709e95508c92686016f1ec340d4,worm,221802,884,1764,1783,2667,1764
10368,6a61ebe3a7156905de4005574846517ecbfa27904623e946f48c7115202906a3,worm,223101,866,1822,1788,2654,1822
10369,6a84dde43cba92691dd8c398bec8c90d11f687113e423b74ab36fca7be052475,worm,222613,901,1646,1764,2665,1646
10370,6b2e39a10321e9c8b8e8bd1b40452a55ddeb0460e99e1b2867f11c5c86dfa12c,worm,223072,904,1733,1810,2714,1733
10371,6bad0b67da6f305b3be6f6d1d082c7d221bc5acd8e30fe5838d91e9bcd8cfb5a,worm,221996,872,1805,1718,2590,1805
10372,6c5b730adfa684bd05bed838202efdb4cb84f7aeae3bbb63854a583a5cd01a69,worm,223013,906,1747,1762,2668,1747
10373,6c7525957404afda408232eff8b8b5582f39c22afbd8327de03eeaf5e1481017,worm,222568,875,1728,1754,2629,1728
10374,6cb584d2c7e31c8088bb24d55f414d58d5cb4093adb7cec0c8587f0693be4c09,worm,223187,867,1754,1744,2611,1754
10375,6cff509d6a610c86aa829582752d7b666696881361c1b8f14bf2fc9aff3ae651,worm,321906,1281,2565,2541,3822,2565
10376,6d1d67e8a655c662f5abfa2d712f0a9390ce6861e527a22feb1a4596a36314d4,worm,222993,873,1740,1755,2628,1740
10377,6d9ad17e797a104078e57b1e48a14464db31d3f2c2a0861174b5ee28f443cbce,worm,221990,914,1731,1736,2650,1731
10378,6e605f1d45d17637f102f5f29629b4ba32506ef5cafb0db071c543fc51fb16ff,worm,223045,922,1792,1701,2623,1792
10379,6ec3a458682386091e9a93a7cdbf85d5045c1d21b3a5e17b89bcb9aafc57b086,worm,221679,859,1716,1755,2614,1716
10380,6ecac47bd81f067276cb3c255fb71ff4e1ceb7e5529e427873514ee2ea0da467,worm,222755,814,1746,1763,2577,1746
10381,6ed2b35ab759e3cb0f036960d6554da0f6d77f3186b716d93cb84a23c80beee4,worm,221936,903,1762,1689,2592,1762
10382,6edd52f6072183ccec19257449c3872f511bc8f8c5367fd227c28caa81a5e56f,worm,221880,876,1775,1746,2622,1775
10383,6ede02a64c386800f1f8584f1461150a581d8c43e2d914186b881fce018a276d,worm,221982,869,1734,1738,2607,1734
10384,6edf1e04427bfe13e52b6c6e70d6a99619d729ad69d8840c75ef356d6e73f436,worm,222015,821,1742,1677,2498,1742
10385,6f01448265917aa1ed9df78df79821ff0ed1efd13698c543057c113a4785a61d,worm,223054,888,1754,1722,2610,1754
10386,6f12b032f788bce1481991f4a8fd2c884267bab7002920a821417123ce156ea2,worm,223089,838,1718,1770,2608,1718
10387,6f5f492756c313340d6dcd1cfd85463f6d9add837768e45c638f08db41b17e7d,worm,16010,53,130,135,188,130
10388,6f72949818d8ec032df61706e1cef979588b506a5d6d6a44bb4ef512b7b5d17e,worm,223074,894,1774,1725,2619,1774
10389,6fcc459cc8fad1360200e0c0f97e0c4aced1e7df7c184d9d27c0ba3b1511490b,worm,149939,626,1119,1197,1823,1119
10390,6fcd82f74f1f754438621ee4b9fbefcaefcafc3970ed987eac027cbbdc4530ef,worm,223241,850,1712,1795,2645,1712
10391,7037e5366ffe4e5b5d5706e332df03ce655a92cdf0a9e4d6ce0ba1dea1a8beaf,worm,149957,570,1203,1207,1777,1203
10392,705960c7e61dfaf4271a1e6d3b6a018300dfab71b263c831bd7d836d283c41de,worm,223262,810,1729,1823,2633,1729
10393,70986b27c764675b995ebb566f71022baa95964b8794b0a80c65267f3a189aee,worm,223074,905,1706,1798,2703,1706
10394,715c0dfc8c5edd58acd6d7f1535d7339d79ce839dcc56fbc14221f3222459a9e,worm,223013,840,1707,1797,2637,1707
10395,717be863f4ef7b2437dd18054897022cde6ba002d0ab65d9e009c21ea2800c33,worm,221911,824,1699,1777,2601,1699
10396,71c00ecd1830b6578b0a5dc0ff0e715428a6b782ea9d5248206a41466a456b4f,worm,221771,872,1721,1771,2643,1721
10397,71dd6b31c8999e8b3b57121abc69d67461ea0d26a4890d1a0e2ab1b088890129,worm,222984,871,1705,1767,2638,1705
10398,7234602b0fa326c44a016ae0938a2ee6f860ef851c5d5c41f2b045c942e5e471,worm,223040,908,1750,1725,2633,1750
10399,723b4280b97c29d6965de658603d9915d654669f24f6a644cab8b8af67e80d9e,worm,222166,832,1729,1760,2592,1729
10400,72632c25b2f6c361b7dbad455ddc6a0b7aef8c6eb8683deda4b7baeb38f1f90f,worm,222802,837,1725,1810,2647,1725
10401,727fcdd2b0fe8684a61101a1548186fc971584b219c45e439f03a12826c7ac7d,worm,221887,871,1772,1759,2630,1772
10402,728e1e30f587c9ea1b38bebcd905ec1b73fd216315d414eee274972baa1525b3,worm,223072,884,1698,1775,2659,1698
10403,72ded296afebf5b6702383c86dc0da5dd87c9bacd488021281591cf103d39421,worm,222822,907,1747,1817,2724,1747
10404,72fc413dc710b863c6ea50efe6c0c6da1636575d8f46539c83bd692edd40df07,worm,223022,915,1748,1686,2601,1748
10405,735e73eba7ece0660c938e5ad629e2f1ac1487a84f778733b20278c2916c9cc2,worm,321829,1189,2525,2424,3613,2525
10406,73b92b4e1c27f5a57d63a87c805606899b74d97cd470256dccc7c1cd5f3d49a3,worm,223193,901,1735,1756,2657,1735
10407,742d0214474ff038b1c5ddb19d988960254e80d29e57d4defef0de59ec99f799,worm,223175,880,1763,1775,2655,1763
10408,74d21003bffdce1523abaab08bfa60ce37b3b0ce599f14e4a65b75a0043edcbf,worm,223115,901,1749,1804,2705,1749
10409,7505f86ce3304f977beac750c5dfc8315f128b376a83a70a8abd36816c18affd,worm,222987,912,1751,1748,2660,1751
10410,750647b60e06fe8d4a0675855e45d01d9957e2f6daa33339f1ed1d5af387430b,worm,223308,868,1781,1711,2579,1781
10411,750ba2e0ed2ae84f3e3333760537e41068dc3c028403b7f1c05deeadb95eb4ee,worm,223053,915,1708,1756,2671,1708
10412,752c035a95a7de4d9ea1ab38b3819015b7621ff571b13c4f285322e3536e4218,worm,223182,895,1734,1738,2633,1734
10413,7538e8bff5462f236576c5dee3bca3a6f8617942a330f5f7f8385b80fd48d96b,worm,222111,841,1752,1692,2533,1752
10414,754e9bcd7dcc9c7c68e21b44204385a1aca5220dbda8c1be635a66616cb1ebd5,worm,284272,1205,2122,2288,3493,2122
10415,757d7705b05fd730ce0cfd3edd8517cc6e09dfc080dd9a57820dbf756a53333b,worm,221812,847,1693,1797,2644,1693
10416,758e9612d7b5967649acfa4faa5358ee113f12725500f68e4c533ad697fa707b,worm,321740,1291,2522,2575,3866,2522
10417,75a0df039f7f31b39042317b52c6d839934eb095568b760581ff8c008b5e9ef0,worm,223028,859,1779,1752,2611,1779
10418,75b30dcc26a9595f53713dbb214c79ce6294a77d10e5ad131a9cb1dcd722847e,worm,222861,872,1725,1729,2601,1725
10419,7671e539b7a701887e83311c9df854d1cd47a257e1f1c09e152af4d7f5c41ce1,worm,222940,877,1790,1793,2670,1790
10420,767bdf3e693ccc09f9a0ae26c29b9c8a2a13cf37ed8ae2804c657d4849dd2250,worm,149948,572,1183,1190,1762,1183
10421,769e96baf3fb5d209e71abd284ff59abf6181eb78c71dd34dac4aafe59f9ecb8,worm,221793,864,1738,1747,2611,1738
10422,76d41241e88c5f30caaae4c1f3e5ae7a9e5505dd5d3a5c0e510a5ad21e8c9d4e,worm,222964,886,1726,1754,2640,1726
10423,76e909dbc47cddf73a5e2c3f9d6a64be68fd0a4040ac8c9298a1d9841a4397c3,worm,223175,859,1798,1732,2591,1798
10424,77bfa3698171ae7b67bda7de55036505a3f316a8028824619400b543b0b7c08c,worm,321596,1255,2470,2500,3755,2470
10425,77c02c8806eef5b11839474adaca3421250b82d0a031b4ce13facddfd541f3e1,worm,222823,842,1776,1806,2648,1776
10426,77d015c08be2765b0a3e3ed8a056b5793bdfad67ed2d36cbabea41e94e7c7800,worm,221719,889,1721,1752,2641,1721
10427,77fedf24ea9efd8e4aba5dc997a95e07f62a3014da0fe9f566f18c8a97a715fa,worm,223174,912,1766,1737,2649,1766
10428,78090f57173fd3625caded14298898b56fc9506cc83b45b702b08a500ac52a51,worm,223009,865,1697,1786,2651,1697
10429,78182ca2203b5b93db8cf7d598c3702fcaf243f5faf9921df2f682b20629f031,worm,222804,847,1778,1708,2555,1778
10430,78407026fa392394c45aecb06c4d4682d42cbdd3761b3e344591f2c2c5639ac3,worm,223124,811,1725,1751,2562,1725
10431,78a2122f6eefe1cc53fa155ec2c15ed1f5558d2b1abf069a763aa2d07c1f8640,worm,321804,1302,2556,2490,3792,2556
10432,78e88594c09d72c9a207923a54c9d14b4a6f341d16600f0ca6482b048f0ddcf2,worm,222978,870,1747,1787,2657,1747
10433,7908cf4fc8bf403dc810446b75feeb51e15225fd16f629e533c984c8e6fb6cc6,worm,222632,931,1678,1735,2666,1678
10434,794192cc59d7c6ce29883f9f063c397b0f8aad3a8ce9b30bb7117f1e110801f3,worm,223039,913,1723,1724,2637,1723
10435,79561d396a4d7f732ca092451dcdb16ccdd17b385cf079f1a53ce9869746c905,worm,223060,909,1746,1768,2677,1746
10436,79a22139b0bc8187317c0fafc4b51a5d9b483fd966e9db7ef6fc8b1185ff6055,worm,223164,858,1749,1688,2546,1749
10437,79c0fd9d2a607cbca5d68a6d9492c304289add99c4988dac1a2aab1b0cc3c595,worm,221623,873,1715,1765,2638,1715
10438,7a0c252f4e4c6e018f8598141dd619566b2b2b7136312c0d755ffa6bee1e9fde,worm,222889,824,1763,1860,2684,1763
10439,7a3405e4b60e3c5607edd368465b996b11ff9768e64deb1a2cc5e2a300a9b2b6,worm,222999,896,1729,1804,2700,1729
10440,7a3dbdca81baaf9043e693515c2d9834807ecfacac6d48440cad4602f938e244,worm,223110,849,1725,1760,2609,1725
10441,7a65e6975ad3b5d626caea9084e2587d0838ac441bbacf4ab9005d0b500cfae9,worm,221569,846,1679,1813,2659,1679
10442,7adec08632b3be3e70a3e096b39f27eebffe4af0c59c2bfd3c576837d4e6316a,worm,18463,59,124,161,220,124
10443,7b03ad4814a93a085153ba60f7d84488374806c745c11f78dfff770259919f1a,worm,222947,878,1763,1750,2628,1763
10444,7b417bbfcbd05e5c6f1e5518f4d1802c11a6c3feb5774ec8eacf324ceecb63cf,worm,222987,895,1762,1799,2694,1762
10445,7b5882fa70d3e4f11ff624d491b8f4231c20e9d84c792555330ac875db671e4b,worm,321927,1217,2525,2559,3776,2525
10446,7b79a18fbf7f2776bc4f0dfb1e6232b16467666e93977e00673db4bc7de47d2f,worm,19978,69,143,187,256,143
10447,7b7f852c96544d5680e0dcb19b774a68bccaeae70f06bccc44907fc5229de115,worm,321779,1294,2553,2542,3836,2553
10448,7bb9fea2aa323a5180bff6ebd312fe92c3a4eb66d3d18d0e1b10220531aacada,worm,223013,859,1767,1769,2628,1767
10449,7c34281b045cd66430151c72c7062e2af641ee2359fd47543010dfd7821b4352,worm,222014,848,1732,1711,2559,1732
10450,7c87edc7892490b4d31e9db4a3da2648d9ecce095628a2565b65604798d9708f,worm,223067,904,1737,1679,2583,1737
10451,7ca32212cff173b298d4f85b086d0ec62c8373f4b6a65445636b187768caef1f,worm,223080,889,1783,1778,2667,1783
10452,7cf90e5aebec7aefbfed930ec2999ab5811395dbd733eb05d45f87d6160fa206,worm,222550,940,1747,1795,2735,1747
10453,7d564c38beffa391ebc781132328396d3db724afb1ecaa18f42782821b74a35d,worm,221702,861,1773,1755,2616,1773
10454,7da7d33244ef6829a8468fbb6d0c783ef04707a5f35b0abf47e642eed48b39a4,worm,221778,841,1763,1803,2644,1763
10455,7db2306e8880d51fc06e754b14bde7d5f1c52cf519438a3ac516cff6f6a274d0,worm,223055,933,1710,1709,2642,1710
10456,7ed354c84ac74cd56334f622b3d65015d7eca36a5fd7e9267201d99936969102,worm,321856,1244,2517,2554,3798,2517
10457,7ed453d053c74b690ecad1f3bbb9a8543b539d0d44e92e35df091956137e5e80,worm,321713,1266,2525,2595,3861,2525
10458,7ef59d83e7f5e787748825c3e398c9c2d74a8463929ef85ff87151211b8719a2,worm,222977,850,1719,1743,2593,1719
10459,7f63f5dce1b9aa00210d28c7222ae7aa70eb81b9e582094076f5b9ee34ce9d5c,worm,222914,880,1774,1802,2682,1774
10460,7fb5ace91e6d2d30819c8789427be875d1f32d357fe338bd00603c3d122ebce8,worm,222855,917,1768,1772,2689,1768
10461,7fcf2b955369f8a5535121ad20cda324a1a106364c07cb636f7871c7f35236c3,worm,18470,54,142,145,199,142
10462,7ffed311c02fdbfc31187125ee841437c3dcc80fc98bdc881e3168a04c824489,worm,221800,880,1717,1783,2663,1717
10463,8056408f0db31b3de8f04e5b4281ce82cb2fa495ea4ed34fd4f2ab7a480512ec,worm,221995,861,1706,1735,2596,1706
10464,807696fe23c0424f5e5e7f38f5693e94b3becb6ee68034696dfeee6490c6a1d0,worm,222690,848,1700,1848,2696,1700
10465,807c2d0fb595fa07c78e0d5da966c87a67c85dba28bffd439bf4205dc2899293,worm,221674,861,1742,1741,2602,1742
10466,80866e09f137e5ce590913457fff538305f41ba94ba80ce218dd1484d8e997ff,worm,222866,850,1803,1840,2690,1803
10467,80d1e711730351c023fc35a29b5de9230008f7bf5a577e09fd116b2aec30c16a,worm,222794,832,1800,1774,2606,1800
10468,80fd91b04ed7b07ec7f4aca3ebdeac298c3e6e9757fdf3e85a040738cdc62fce,worm,222962,901,1742,1784,2685,1742
10469,812216bacd514a8f35ebcc09639e4bfd5baccabb5dde957f1e4fd4c7c07095ae,worm,223038,901,1745,1757,2658,1745
10470,818e366bd82fa4bb6c2a9302ca9b15dddb1cf3fad86bc4d8f3b6c5783ba21bbf,worm,223044,938,1739,1700,2638,1739
10471,82196cacf733f9d167c9cc7e2e259b554bf69abbdaf69b3c65f3034955c77b47,worm,222144,842,1722,1709,2551,1722
10472,82a52243bb8b8d704de1eddf55c7d025d52604fd27d73222163cc050578d6750,worm,222880,854,1675,1836,2690,1675
10473,8302685eac8ffcf96f743517c26da9b40c4e43515f8693ab63ab02a39f25230c,worm,221821,869,1711,1772,2641,1711
10474,83051efe7dfc9cb5a3f82878ccd79a86afe3767f9497cadd19cbe26d85d01ceb,worm,222825,831,1726,1748,2579,1726
10475,83c94a198837d3d448e148369420cbde1665f96e4840574ffab0ba0b29fa2259,worm,221713,824,1747,1834,2658,1747
10476,84359d3c55b20937800ea95832ad552690db6dee1bf5672a755efab8e3f7670e,worm,223008,874,1688,1782,2656,1688
10477,84412d79360c309532a06c89a74a16409e7ea458e8c83115961eb70c9f647d09,worm,223106,845,1786,1752,2597,1786
10478,846973195239b575fa9e99ada58d338382fb6742031144ff62817196700fd171,worm,222967,912,1722,1754,2666,1722
10479,849e4c2574c26ec22dd9c12a5e86036b97792c468374459127f9c3a941e18339,worm,223003,888,1727,1778,2666,1727
10480,84e3515a8315d3522ad664645fd6a43f32c031041779088468881978f71ed733,worm,223084,829,1723,1736,2565,1723
10481,8569b3769da39bd68f9fb5da8f778aea789e980518f1ce49b722d845208acfb9,worm,222097,842,1733,1796,2638,1733
10482,8594af95bb3dd15c6c13c5a4c7b5025664f566985c051b4be6dcb29ab6ca9752,worm,223003,867,1668,1785,2652,1668
10483,860c647881fd1c8ca0182f25b35100e99aa2af4087ad26c0f143f45b0ea483b1,worm,150086,558,1191,1143,1701,1191
10484,87296f2036e03d3e8d895a1e8614607755225f7c531f292270274988f66b9fbd,worm,222946,890,1753,1803,2693,1753
10485,87b3daccd31e469a778701d5ea59430cf4b0863551f87b50bb8b4077a5938ac1,worm,222709,821,1693,1779,2600,1693
10486,881d75ad4e53d8d92eca3f2f10a557c48109b5c9311f3c14a7fa1662396bf4ed,worm,223028,902,1755,1698,2600,1755
10487,88bf5faa6b982ae60dfab3e8a37368d3ad5d960c699b6b9d116e94ab3249afd9,worm,222992,953,1720,1710,2663,1720
10488,88bf97a46e5d047fa5225e19d79ad517d1aca8a4df57c572b416d26f9585b88e,worm,18469,70,129,140,210,129
10489,88c137f4d4092b6b8583c7e235d17155e45cca323954ff648f77764daee82e8b,worm,223205,868,1747,1731,2599,1747
10490,88e00dbe3d0a744b21a9b4c14141fae614d3b2e1e315df7da6ca5ad5a75507c0,worm,221926,909,1748,1707,2616,1748
10491,8902cef17cb8df687cd8847f42b9c6b23d6b235ff3631a2a213f0b9510f2e4b0,worm,223122,846,1732,1716,2562,1732
10492,899442d276afae32211f23cce199806ba3ffd695b1e36b3903950687a2901c56,worm,221874,885,1712,1780,2665,1712
10493,89aa97188402303627f97cd6957b1fa648d23af012f3ee691a70b60700eecd86,worm,222778,895,1747,1815,2710,1747
10494,8a2ca9bd3aadf8977fd6355926c07de8adc1802bfec4a56b78fe4f8afb0f0188,worm,222716,867,1731,1790,2657,1731
10495,8b33cc1d6e83fa0e445316236efb5f2156c8894f219aabac1d45b792d7d37100,worm,223061,899,1681,1826,2725,1681
10496,8b4155b72c2469f4390e19453fee47feb6ea31d0bb81b92e2a2ec45b27695fcb,worm,222707,853,1765,1726,2579,1765
10497,8b5bbd6f78796782300e6c6c6bbb86b240e28732b0289b7009521c3e879f5639,worm,222968,893,1733,1781,2674,1733
10498,8b5fb9b61dc880c9e7eb26fd2bda01b398504f71da22a29a023ee01f34baccd8,worm,223128,853,1769,1720,2573,1769
10499,8c42e9d7f4a7de589b176934dd9982977008439d7a23ab5cd00944d8357f50fe,worm,222973,866,1725,1789,2655,1725
10500,8c6a9448492141793aef629352b4ecbbebbdeaa703f34da1cfdaf2d50f2d5b73,worm,223034,902,1724,1778,2680,1724
10501,8c82a5b80b02ac9c350f9da5fac7ea965de6038df3856a1ab86036d65988157a,worm,223055,893,1779,1741,2634,1779
10502,8c8a2e7fe800610f92396f88121f1b96c65be9f8617f733491a4b6a0e1035212,worm,221627,829,1739,1715,2544,1739
10503,8cb7345df222cca34b2a616794ec3b09cfa0659754a5b241e6a32f4c9aa51743,worm,222000,908,1768,1764,2672,1768
10504,8cd9333a130835b5fe8b54bd7ef882d3f9b1f5e4c407acea55319749cc6cd04e,worm,223191,897,1771,1747,2644,1771
10505,8d34d92f67f90ba163aca3d317a7b290878e2c3dd21ba837282a2a3aa4708183,worm,223170,860,1750,1727,2587,1750
10506,8d798e3bb91196dae5c016cc9ef545e7f07ce5e71971df722b3ec43d5e3880d8,worm,221738,862,1747,1760,2622,1747
10507,8d98bf524d10f33c7effe51ac6e9bf6f1f41577299c38af74440f01e0da0dbd1,worm,222802,817,1801,1771,2588,1801
10508,8dcd3435ebe4ce4eb760d1514bce5edf1d5273247aa0c15cf09dd8d41eb82886,worm,222834,856,1730,1746,2602,1730
10509,8e1ae7f463e5b08439176fff4da8da38cf1aea0bc35f04dc9376c6254cf3d910,worm,223042,941,1688,1753,2694,1688
10510,8e1af64be1be317a5be7b33420e6fa4b68663e6d6c41131a137ae43e7ea9d1e4,worm,223169,832,1778,1636,2468,1778
10511,8e73c903fbc471e7914a659a6717b8a530a4b725de5818cba584af4d88227b04,worm,221842,871,1762,1783,2654,1762
10512,8f5eca7cd3e50851adffa23568a9b19f1b0afc1834713dee4db8f3c43ad6f6ca,worm,221756,824,1740,1761,2585,1740
10513,8f60d758b6cdcf43915d20933907fa60b7c01b86c26d1353d324f91fb50acbef,worm,222999,910,1791,1708,2618,1791
10514,8f81fc2299f57c516d510581606f0ff4869b4f471e75ac2ffc01f8510c518f86,worm,223003,917,1762,1695,2612,1762
10515,8fd716e3de1dd45a418aeac2493be248315a80882e4476d0451af26921bcd2d7,worm,222803,854,1755,1774,2628,1755
10516,8fd734984ba5be219a499455cc6e80fd82241f20850d1fa204182a6ba2b04689,worm,222935,885,1761,1788,2673,1761
10517,901ce63d2e6aca29c98d5ec2d77a2caa697236a42f827bc660bc0b8bc9bd40aa,worm,223031,889,1711,1765,2654,1711
10518,9055cb3fcb65d0e34e3e6936aee1495d12e41fe8bbbd87112bd41cb3d4276c0a,worm,223077,906,1720,1769,2675,1720
10519,9090d3239aac250da7ec8091fd77115bf0796bd0e0ed8dd8e8c3ae51e6cc38d8,worm,321628,1245,2593,2539,3784,2593
10520,90c66fdacee225137642df6fb1c71d2f941ddb8c411f3b426943e2c2832be23a,worm,223055,901,1805,1719,2620,1805
10521,910c5a899a51e528d70e0d37eaa8757353c5f3ac81eecbe0f0803440bf049e90,worm,222888,850,1747,1786,2636,1747
10522,913875ba6c9fbc4481faee059e1094722a589eab280a4f321d94954686815bd3,worm,222860,856,1734,1769,2625,1734
10523,913d34bbb800944ff5545c7a9451783dcf5fc946194d8bc8c88f6c13f39d9756,worm,221757,882,1781,1784,2666,1781
10524,91444f381dbd1d4031625385cbcd3b940b31dc85b7324b59df64ae9b7b5d2870,worm,223121,830,1754,1739,2569,1754
10525,91c362190f6228501ae0c4dd91bea1ab683d3a900fabfb5b06c80aa850076890,worm,334973,1323,2616,2639,3962,2616
10526,926fde2b0079d40f0bb9049c7f54931aac6bbb963f04b14f99a650e51705a4e4,worm,221844,864,1765,1772,2636,1765
10527,929333fb4364cfdd959c562fadc1e73a13777c69a9d4ab55096269bd51e94b20,worm,222958,870,1731,1741,2611,1731
10528,92dab2a3da675cbbe8a65942e3da85417030a427d537e5b0c34a6bebd6805431,worm,222929,904,1720,1770,2674,1720
10529,92e9ab240eeee75d76ecccf211c474ee3363d241396fa5f23d55c01106dcd321,worm,222694,859,1633,1735,2594,1633
10530,932ff4d0ee52cc93f79a63bc87fdbb1d5e7963912030ae8b8bb31aa3dd1bb4c6,worm,221960,927,1756,1742,2669,1756
10531,934ffc441d0eddebe89ad838491304f624f532e63a0b8936eab6100b4e8e3278,worm,222804,827,1716,1754,2581,1716
10532,939593d541969601728c35c7cf64357448548beb7a1f3bb98c88189722585e19,worm,223142,860,1737,1747,2607,1737
10533,93a15bb48617066b9f627f4b472dbf73e9dd9afffb3a0e3b6a4c033b45ce178a,worm,222583,881,1739,1810,2691,1739
10534,93a7c78a38734094d8446f645add182389bda8b4ccdc1265490858965d5f9995,worm,221734,876,1643,1809,2685,1643
10535,93af30b0197b696ba40f339b09cbbfb7ff47e4f114b2439eb822eaa89dfb5524,worm,223086,864,1744,1739,2603,1744
10536,93afc2f1600737bb47e340fec63b90bb5e3b37f09913e5f5a35d85e7d667679e,worm,222886,864,1737,1791,2655,1737
10537,93cccf4da045c14ffa39e45bd7556fd4a90905d83172086fc39db6eaacbaf24a,worm,223075,875,1771,1736,2611,1771
10538,94117d41bb1cf751ecfdcd61069daa6f9bfb520894427b2221c40f7739e0d9d3,worm,223191,849,1700,1760,2609,1700
10539,94b942ca96040152a47c2afd65897fee27a9a31d8588231423988a85be58a7b0,worm,221626,837,1645,1743,2580,1645
10540,94db3e888c4f5d7b49af4d26e8e7312bc7a27efcc2c0b9e73b57b1ab1b8dd158,worm,221928,934,1789,1676,2610,1789
10541,950372b3e0f63168ed8f5d35f0f07fa4d77c8b29a394b8a9770cabcd6fef88a5,worm,222982,850,1708,1774,2624,1708
10542,951005b814bfed1e1a0c516bd44ccd0d1e430182c22b35a0f290d6fc35e5b50c,worm,321623,1200,2474,2595,3795,2474
10543,95951cb33ca00d891a65c1846ce46097f5c7beb82c8d4d23a0930456326c279b,worm,223027,916,1741,1801,2717,1741
10544,95bfb2a946252787832cd27d03a8d4c524e5ebbcd1fa8eb143d33d45853a244e,worm,222175,816,1738,1750,2566,1738
10545,95f5ad25c51c29701d8c8db7f4e2c5f0bc569f697d82528575cca16b782713eb,worm,223244,876,1763,1751,2627,1763
10546,95f70f3f4db6412a44b7f0e0d44e1439b73a8531a48de4c70e5e809dfa8e1aed,worm,221940,883,1673,1752,2635,1673
10547,95fa060b878bf561b8ba3d56e971265928f284c792bc1e2d2fd1660ec6ef6aa4,worm,18469,59,123,130,189,123
10548,9637807a66c681879fceaadf7d35ad74d83e9fe612c750855f3fdbf2390abb35,worm,223088,861,1710,1750,2611,1710
10549,963d80e964bf1730f01af37c97a34f86b223b77f1d510a719b2c768769e12e4e,worm,222908,846,1724,1804,2650,1724
10550,964e124b6b454b65ff22fdae4dd34910f01ec057c64202a1819a6dc89308fa92,worm,223070,859,1747,1795,2654,1747
10551,965051aa41caed677d5ea2966f2c823771fd490600b06901126de91132f16872,worm,221646,867,1755,1811,2678,1755
10552,96888543a368cdda313279507affff7bd306c41735e02cefb46571c497a47516,worm,222770,885,1727,1808,2693,1727
10553,96b6771c704ab194f8fd1d57359be0ded03ea8a7c2550edb7e00195e34a82a21,worm,221490,868,1741,1769,2637,1741
10554,972158597359cd08d8efa1b611e2b29e8f06856f87d9bb940ce9294cee3e9153,worm,321425,1272,2463,2529,3801,2463
10555,977f7b0f9644cbeb1faeb0eaa00fb6f99b9323fdd0ebbd7421b48ac2d9ebedf8,worm,223033,908,1751,1750,2658,1751
10556,97baf64cb84593030fd5a23845b3769705204c72326dc11838e0063b9ac2de0d,worm,222909,875,1679,1821,2696,1679
10557,97efbc47d383229137b8ec7690cdf662a04471bfce0fbca8a71cd5d651ea3472,worm,223224,838,1731,1875,2713,1731
10558,9855bbbdc9bdde459970d209cf3fabdb4a6acac20adb3ef5000fd582616c7558,worm,223047,900,1740,1696,2596,1740
10559,9884bfaf840b704006ffd96472093c3677dbe96ec60d89cb8caf1b1b5ab7ebff,worm,222959,877,1758,1769,2646,1758
10560,994b8ea9bd5cd84008a87500af58bc6209f4e94e9ff356cb6e50225b85aa56c3,worm,221700,873,1775,1818,2691,1775
10561,99777fe94098de403746eea511df4acc62ee9cac6e74c9d892e9edc8300bc7a6,worm,222934,885,1763,1794,2679,1763
10562,9a06d4ec4b80cd33b57d58c9a1a35be5fa9570933b0c56c7fdc94a890f00d5c5,worm,284281,1209,2109,2293,3502,2109
10563,9a59049fcf04073db01776b8832bdeadce30a9dfad6b691aef32ed605eeadd33,worm,223419,860,1802,1757,2617,1802
10564,9b151e77643bf9fa29594e0d0d9d4ae26dbf33ea6f199ec69e84832dc1512db1,worm,223064,878,1743,1731,2609,1743
10565,9b174a0fec31b1647c75fea641277385638ba1621cdd7ea071c49a29cbb6c57f,worm,221864,885,1747,1741,2626,1747
10566,9b923586d970fdc04c3e944fba747acb4d6687c39b615a3fc35f288e6bd9e7ea,worm,221930,870,1743,1759,2629,1743
10567,9ba2c23b1e2646fd66a762d639d547fbbf062b9344c71e605df980939f82c901,worm,222228,871,1767,1795,2666,1767
10568,9bec9b5876eb28b09394b9c5fd9aa28e57dfe64dc2b505c5f5b93534c223df59,worm,223393,876,1801,1713,2589,1801
10569,9c5a7739fda39330dbf1427fbffcaadbcabf09c18fc207a6713a056af4808130,worm,221642,855,1718,1722,2577,1718
10570,9cae51bbdd6bd373823495e90b143e480233dd7559d880a0371119d694c9b1a8,worm,223241,853,1715,1794,2647,1715
10571,9cb7c2847ff1c45f698c6023e06533231795392e168eee18937e7b3c9eb8577b,worm,321580,1258,2551,2619,3877,2551
10572,9cdbc8f2ca9a81994a0a2633c6e5229b9ed7653b129414926a6b771e5f473eab,worm,223067,896,1695,1787,2683,1695
10573,9d2078a0770a55ebbd8054e73f5a2c424835c8ef9111b161212d4ba141f4f71d,worm,221942,876,1752,1770,2646,1752
10574,9d3ddb32245873bbf2be93137a982bace6ae75ebc2301775554b8e5d82c6fc9a,worm,221952,901,1741,1756,2657,1741
10575,9d7d45bb2ca5b3b317ec4fac64b68557312f0938baf20c0117682e6387de0dc4,worm,223142,907,1783,1793,2700,1783
10576,9e2bad64e3ce363be949fc8cbed0eef8b9a427eb21069c51a57ee4e763a9c0a1,worm,222778,835,1778,1756,2591,1778
10577,9e2f7479b088c7574c8595345231f44fab3df730d7e3b62aa353200b2bf8a8b3,worm,223076,888,1708,1745,2633,1708
10578,9e2fe5e993283ef2a4e3f6279e3fb9775ea3ff3fc4deb37a59597e95fe73cd4b,worm,284175,1206,2110,2287,3493,2110
10579,9e75347a22b59f425000b7a3263ba5879a6ddf03ede9afecfe4fc16a0b1c1d89,worm,222768,886,1712,1771,2657,1712
10580,9ec750b99575ddd7daad21999cd45dd123fed7be08e0a043d405a4a10e4b6376,worm,221891,855,1696,1739,2594,1696
10581,9ed4e2aa950cbaab9a5f9a3ca8184cdb8ea0c3fcc0577e7f04299ab7df882bd7,worm,221961,864,1704,1728,2592,1704
10582,9fb23c190b28cf4aaf7125b84c5c418695ec6457c39dd12486980fee992d08ae,worm,322009,1303,2595,2579,3882,2595
10583,9fd9f7604c84222da139b3b002f846b2effba4e04884ef07705e384d262c105e,worm,222067,876,1751,1693,2569,1751
10584,a01c9d2471ecc39936be8160a080a76a1a7e3ca05f0e25ead86d0b20b210abb3,worm,223124,855,1748,1759,2614,1748
10585,a03f727e038734a9c9c0db77b00e49e3e5b30593068d74d73c89dad63f07b017,worm,223145,827,1773,1748,2575,1773
10586,a08e8c7b5d61dd780dbe873a84b7ee60a36085a7a69acc0881418572304c4cc8,worm,222861,847,1742,1791,2638,1742
10587,a0d917194f13f132f391e8a68778e4747a3fff514c1839e655148d5cc2afe281,worm,221888,867,1739,1764,2631,1739
10588,a0dffb5f5b0105b785233500b5ab0d5964b93a9d85e27567f413f90fdf1bbfc7,worm,222988,885,1730,1737,2622,1730
10589,a18842fefa4867bbe13ac56c4d0b7901922a0ca3cea41a9acb5c5ec2b8b50338,worm,221663,868,1768,1753,2621,1768
10590,a1b6e2f6a45194b7f3b1fa9c6888e9fa152f794909aff61f441d69c64f55f4f1,worm,223086,884,1743,1772,2656,1743
10591,a1c94e162faf9e2a1a1328ef49d1b365499011bb2a9f9d697c47ab023706d1fe,worm,223137,842,1730,1749,2591,1730
10592,a20f9ab08876b4b059b68146b13ea9c95b57882f77db8797fa4a1cf0c732e808,worm,222704,896,1729,1774,2670,1729
10593,a221cd1f60ec61a5ea489d1c7c7617ce8737f863836a0ed557733ba0395bbe56,worm,221851,891,1737,1718,2609,1737
10594,a26fb2b864f318dafff39d659fd31444c10e7f665cd993807b04e9cf97913da6,worm,223084,872,1757,1731,2603,1757
10595,a28e63a3328ff8e9192b28b641609e098b239be525a5f1549a78322113954093,worm,222102,827,1718,1781,2608,1718
10596,a294bd9c3c299660f939c8d12912fcc80b9163a62fd4848d1d2b3cb537069027,worm,222924,909,1736,1799,2708,1736
10597,a29b6b38563ed723254a13b55543b8d8461cdd9675ae8f7663b71f53a0b0cfb2,worm,223130,865,1725,1767,2632,1725
10598,a37c943d3f869726a965d9135d8eaffaf1690615a63ebbe016b58f904bdd3a7e,worm,221918,873,1697,1744,2617,1697
10599,a3bf11f55c2643a8d3422a78ad5aba388957e6103cda997f53007740c288f164,worm,223157,863,1685,1758,2621,1685
10600,a3c5367201fb976ffca05bfe3ee5dd1bc95164575d3f087ee8b495380b591b94,worm,18470,53,127,157,210,127
10601,a3fabb340b6f623c16125ad0374af309b5d9ef7b5f2a6a650cd4f2b293d8356f,worm,223140,872,1763,1744,2616,1763
10602,a47920d1aa39aaeed70f309adad4d025555258372269c6c637516daea591cafb,worm,221811,871,1734,1811,2682,1734
10603,a4807070a6f7a1dc01fa2196a3d44c08dae93e2e6091043251973e19549955ff,worm,321531,1205,2541,2519,3724,2541
10604,a4e403e4737d1c70a9b86443df0d4f5f9a8699ed51e54f4819de3faef1826d08,worm,16011,58,127,134,192,127
10605,a52788f7633cd6f1d2a8384453b43b417c64bb6ea5b10e7f364c4bf5812e74cc,worm,222780,848,1715,1775,2623,1715
10606,a62b6572e55829cb58774962254832a3ac03f1c708b6ab44b398761373b5f3d2,worm,222958,829,1753,1749,2578,1753
10607,a6559986aacdce32344fbf9e4a998612c33d49ea5b9b23b6dbd7544a93d3a85c,worm,321892,1233,2516,2491,3724,2516
10608,a68072ba9d7daf040c365d2a06917e90d10fdd228582674925159d219987a1d7,worm,222890,892,1772,1768,2660,1772
10609,a6870b38e9071d084352d00af5e6185c1b0cfdcf294ac67643426b0ccdb5a7ed,worm,222862,850,1728,1790,2640,1728
10610,a6ea4bce6b41eabead8699e88f1b65e6d2f18b96c7f29141cc57330347125786,worm,223045,905,1736,1719,2624,1736
10611,a6f02f6f47cecef00d06ff1a3e5e51219446283c92fa655141dc94c0b50279c2,worm,321729,1235,2533,2469,3704,2533
10612,a7214bdf3cfe5c5adc40fddd6edd5d7221cb6637bcb6519939709f9490130ade,worm,222060,809,1771,1697,2506,1771
10613,a72b9781f97e873cfcfad7830c5b606f4eeb7c8b1aca727ddeb2ec79e05c232f,worm,223003,887,1712,1760,2647,1712
10614,a7b86b2263d2ff902910c6a1f9353f2f39a462ee90de854b306b77c94c3135d8,worm,321848,1239,2521,2519,3758,2521
10615,a7c2c07cd4c59803e4c1709bd7423db8dfc66e6114ecebcf27bd74847c411c4b,worm,223034,914,1723,1809,2723,1723
10616,a7e6b1ca07c49065a34787252ea2c147dffe709f9756b11d86b74ca116064d05,worm,221986,872,1745,1755,2627,1745
10617,a8b5257719d0046ad2930a0609f5979f0947c15f83ab1cc92f8e425c58cc659a,worm,223227,851,1659,1809,2660,1659
10618,a99113d27f92566c8dd5cbb587514a5b227572390ae5c58aac1f3f7dddb65d6e,worm,223163,913,1753,1735,2648,1753
10619,a9b2c17573e354b2f331abd5dc162541a0202db94c9d67b6ace1cefdb122cd3b,worm,222937,885,1729,1807,2692,1729
10620,a9b2e5351424e3d62c85d7ed30bec13f00b787ca37232ca7e989d74206543caa,worm,223080,912,1726,1799,2711,1726
10621,a9d626b61570086995dfc5a1053010e2a41e89675d6f48e64a4ced61ebbfe4a3,worm,223061,915,1677,1789,2704,1677
10622,a9f5fc6175480a8498700d0328e42006c4f6a0750107303beabf708e0a3ff914,worm,223072,925,1759,1803,2728,1759
10623,aa09516217f92f614450144183773e8c0e9c2bdc8eef7d85a75b4609a4b70254,worm,223201,875,1721,1777,2652,1721
10624,aa49723a4a33bca57d2f7eeaaa00e395e7a39499e49d8014fecbd2862d37286b,worm,222927,867,1756,1798,2665,1756
10625,aa603ff04e942a54c02d90aa9b0465bb127ebb12974da3b78451e3b41e531f10,worm,222902,869,1753,1778,2647,1753
10626,aabd8238e98503de474aca4ca2e26db2d0be4d5781b1403a6653a3bbba14c304,worm,222829,866,1742,1814,2680,1742
10627,ab19b871cf8573c22dc1e750d18db73789f1d6f92077e7854aa62b67febe2ce1,worm,221966,843,1711,1688,2531,1711
10628,ab3ea84dd7794d9c8f52733cd211a59449c155cb94868efe44a5deee551b4df5,worm,321791,1227,2591,2502,3729,2591
10629,ab541b4edc3fdb2091a56c45b6a5d12e6c90fa26acdcef1e643c455175fa2296,worm,222836,872,1754,1725,2597,1754
10630,ab639a5fb3e44227bc348ac25b28537600190312c3ca8853228a8354b677f183,worm,223174,887,1751,1717,2604,1751
10631,ab68c5c3c70755c99a67e00d4e2107526572741386896799eb5dba8edc4607cd,worm,222079,893,1751,1773,2666,1751
10632,abadb8ee586f3a5c681cd41805b433f121ea92cfd37d49956752680fec5a54b6,worm,223065,878,1740,1731,2609,1740
10633,ac18c7d9fb076d2d08070878484bf6fb2b9f12f22f71edd28270585a41779504,worm,23086,80,170,223,303,170
10634,ac2b458ed10e4c465aba1eec8bfadeb8ced426ed1c0ae1765673c5e86e3fc371,worm,222665,855,1701,1795,2650,1701
10635,ac88f1849de085d5b0180657bdd6fe8edf2b925d9ee9708eb94a1e722099fce2,worm,223137,864,1745,1766,2630,1745
10636,ad30c0455cfbc66b9c90489484c52274cdeb76157a4bacce371b4438bd6571b4,worm,16491,68,132,117,185,132
10637,ad3bf66c486192fff5ee10a0c5d6c33e2c879c66ff55bc0325a7f8ab54a2b05b,worm,223140,874,1789,1717,2591,1789
10638,ad425d77de10f7749f77ac3466a19c3827d0b3878bd93be6e0015e04a3366d83,worm,221956,863,1715,1695,2558,1715
10639,ad5304e4a96cc0d20f0a933d1741ab62ca048e415e9fe2dd8572948fc6e7a31b,worm,223302,876,1720,1791,2667,1720
10640,adda1cfd2f8f774a3e28b311687f0890dadab9a36fc523ec1a820b6ad6b22d4c,worm,222817,854,1687,1771,2625,1687
10641,aded3610933e7d674d3cb64bc10b2f3b426315f8f20efb1e30b88fb03b6cb20c,worm,15987,57,113,135,192,113
10642,ae05cf5f1fac641cf8927009c7400bad94c9db22eaae560a1e90882c34b6fc43,worm,221744,863,1734,1777,2640,1734
10643,ae72cfd097dd30de29845dc184fb246e61ea7194f36ff89bbeb0410eb894d2ef,worm,223006,939,1731,1768,2707,1731
10644,ae9735a5fa9eb3e5079d560abb2fb47f3d9579bc6fcab04b0c70149ace94983c,worm,223185,864,1729,1770,2634,1729
10645,aef7e1444600c4e10748e9ab87edf6412f6669fcfee528f2ff035695b6b510ac,worm,222962,865,1752,1722,2587,1752
10646,af728ab16772e4a966633a748b337bc1083c90a63fe01038311649611151d24d,worm,222803,917,1734,1774,2691,1734
10647,afb135a77437aa1b89f24e5e66a2cd316f884fafd6661926da136f2b3a93f006,worm,223144,862,1709,1759,2621,1709
10648,b01129121a024e7a2039c2be050f2401b2bdd010d9fb25f253036139867f93bd,worm,321486,1261,2523,2542,3803,2523
10649,b0250c37c934ea055570427ce5f2b652297cd947e3b6f2536ac2caa7e842a821,worm,223106,852,1767,1767,2619,1767
10650,b0b89749f4fd92ba09faccf29cf8bbd03093059a13d8201370007ec9b4818ae9,worm,321596,1239,2476,2635,3874,2476
10651,b0d435a9bded1c13ad61e5f2af08ca68dcd200bcec6ad7b76f25dc32e6fdc95a,worm,222889,859,1776,1848,2707,1776
10652,b129a74ab765bfbfbbd9b3f6520dd954b3abb67b7bf9fb96e97bd04234c36e71,worm,223092,841,1750,1743,2584,1750
10653,b13751d30b73fa2be249ef4fcfeb0c8b70c769960c3e2edd05a5f2fdf69dd7eb,worm,223071,856,1691,1759,2615,1691
10654,b1513bfbd14a21049b7e34f0918fbb4bd714131530431d02554b727c20a1e441,worm,223210,916,1814,1750,2666,1814
10655,b222a14cae472f09b15fa2ba00450745890886835352400ed4a112f98c215e19,worm,223131,854,1809,1731,2585,1809
10656,b28f2e87779a79466389194b755546d5c60bc44790072f293b4a27dfd014b42e,worm,221562,829,1751,1784,2613,1751
10657,b29d7bf76442990aa7d337a82f618c5419ec19944dc23d6b5afee8e8bae2afb4,worm,222801,921,1756,1832,2753,1756
10658,b313bee7df88529a09c4cc4061eb90075e323536c92b0b4f0f707eebe2763206,worm,222962,878,1735,1833,2711,1735
10659,b35a4aa97633f1534c5300f91379abea3b531377300a8542d862cf8408cb2ba1,worm,223158,854,1781,1787,2641,1781
10660,b38f9c86acf58253387b0f9f41c0ae63db1c753ce8f1e8681316ec25fb94f457,worm,222714,881,1685,1770,2651,1685
10661,b4c7a629fc05449868f08d3e681994ee04ad1fca8715431e4b701e1545c50be5,worm,223091,875,1788,1784,2659,1788
10662,b4f989e779752dbe5f50813515060afc553bd512c82afc384eca5844ba5ae005,worm,222894,841,1746,1830,2671,1746
10663,b5125437d76c3fa7972408bd5aa9744168166b58ac50cd73616140268205f9bc,worm,223007,864,1772,1774,2638,1772
10664,b573d4f2944018d6f1795f046b80a0f4abef1f9bbd229baeb25ac9966729e862,worm,221892,884,1717,1820,2704,1717
10665,b5bdaa2be6fd78d471ab0811293caf4a6d2dc81f8dc34ce50370f7ff1b3c6d8e,worm,16010,63,135,141,204,135
10666,b6105fb399c05b1fb83dfa32aa13abef4da487c8fa3a9a83704f62cb460f6ac3,worm,222883,833,1747,1790,2623,1747
10667,b65e766309e8bf221a5f5f3618c9e9bb61cb42957050dd36075510f656694330,worm,321550,1204,2543,2566,3770,2543
10668,b69ede689c40fcc2cfb69f3bec8f80aa1cf8d3833fca7d8610dbbd24919f9153,worm,221753,915,1759,1789,2704,1759
10669,b706b70c1a1c7188538e0ce05ecd00a699acef52a3ae9d4c27beb7ff353636c6,worm,222958,892,1749,1740,2632,1749
10670,b711d2bb82b04698250262ed5abf93f5b9ec165005a0cb5893ada3b61bad1fa5,worm,223123,843,1726,1762,2605,1726
10671,b73ae5b82a38290b76d6bfd028f1d569c7aa12351cae073fe3d24a4a74575a16,worm,223093,833,1720,1772,2605,1720
10672,b7432133066e433af53b580db4927728c0df360f1083021318d5a7f8f934343f,worm,223103,891,1704,1773,2664,1704
10673,b745f24e9d864d03e439c98707ee0b9b22f2341de4d0be73d7fe14842df7dbee,worm,221828,853,1732,1785,2638,1732
10674,b79b468d512df6d242a518df1b29b743aa477e6ae6980ca4dbc36d6065dea9e8,worm,222936,900,1756,1771,2671,1756
10675,b85ac6275ba4763d4b31e4b1691a625622ff66454d4145cb353c6dff2d03199d,worm,222908,855,1692,1802,2657,1692
10676,b85d1387a7ca825eedf65f1c10e76c99f4b77a9ab71d7dad08f2cb09c7416601,worm,221740,858,1783,1771,2629,1783
10677,b88b84464eef2ae17c768c3633dd692e77b39d644b611369f3047bd538fc8217,worm,223013,859,1709,1801,2660,1709
10678,b8dda9c2fbed53d2642e93f44f9d68ac03dada19c5107cfeda48845bdfe37366,worm,221898,865,1757,1781,2646,1757
10679,b9127776dd02e675230fc995a69eb08e237e4956faa69b5d59d25c1b8f2e22eb,worm,221947,874,1744,1740,2614,1744
10680,b9639bf994de560060d2792d412ef4c7c182017385d1d036672caf9d4da20679,worm,321647,1255,2529,2582,3837,2529
10681,b9dd99febd9ca439324f58be0c669237ed624eaf73749a96c18170c8c99e9198,worm,321940,1205,2547,2599,3804,2547
10682,ba7b14c367257b6689526d4b68f45f88ce1e0960a7368a6070870b5e9caefec7,worm,222914,821,1713,1842,2663,1713
10683,bac933171e527819b0bec0c0db705cd7c770ccc7b5d3dd26d9f86b682f9c45e4,worm,16013,71,116,130,201,116
10684,bb11af7a8ab7a787996a5304a63e311d37dc93b483c1c6d274f1a613382c5396,worm,221820,867,1755,1773,2640,1755
10685,bb3f99b331b0965a824a3b81013707d4bf775256f69b87d730007ef55e850fa9,worm,223239,841,1795,1737,2578,1795
10686,bb486e443420fde29d276b5e264c2fd70b1302a6f4df998a7041bcdf67bd044b,worm,321910,1215,2546,2406,3621,2546
10687,bb7b8a9b5f9d0c5c506af93ca1d63974c6bc32aac90a90aa14c8ee0628d700d4,worm,222136,849,1787,1799,2648,1787
10688,bc554ebfd08b1a23ca75a3c12b892a899af54c34a799d561e5b93957c413d2b5,worm,223041,915,1749,1731,2646,1749
10689,bc85dccc9b3a2990e58fac1b361c8c75370ff0c9219b866942172ecd70e849c9,worm,223196,882,1731,1721,2603,1731
10690,bc9c483dd465d2589fb6e500bfbe0c6284a10245fea0776f549732a7d4e27eb3,worm,223016,843,1760,1767,2610,1760
10691,bcacc12ad39c0c89e2d9cedee65bed9de29167ff4925100eff925a0b6941a6ad,worm,223139,881,1729,1759,2640,1729
10692,bcd59c6a645f8410ab80649d67aea5eb87afe9ad2bfd355a04e64f031e4cd1e4,worm,222962,866,1798,1778,2644,1798
10693,bced707db79ef5c67d56bd5d0666ac0d705b98560aac91f3d6e5dd45d343099c,worm,222070,856,1706,1803,2659,1706
10694,bd085a7b1a3ebe0474808e4f32cf68adfd9fdf58e25946b0975457d1920f52fa,worm,223128,872,1689,1746,2618,1689
10695,bd2245782293eb9597e6401e1ae81f9fd65cc0ee41b58193eda8baa3528dcac3,worm,222692,872,1692,1737,2609,1692
10696,bdfdc03042b6213ef7d20a27e8d7b6e81db97bc51d879d9e8caa49829a8d0fd3,worm,223040,904,1728,1782,2686,1728
10697,be2ca63402f2e76399a2b32669318970c0b76b08eb38c5e5a1e820159fc746f7,worm,222857,824,1762,1841,2665,1762
10698,be75310fe352e68f511d05b8caf222c386468f2da09d6ef2cdacf2850742cc72,worm,166382,623,1333,1296,1919,1333
10699,be8608f65fb5ccc6544caf36f6cca5f2de9fd4e17322fc37014f00ce86423150,worm,223151,852,1729,1721,2573,1729
10700,be8f9e91ef7e3aa4a013463ec72c9e823ea0e326b772848d1a7c1bc7cb8d4118,worm,321986,1202,2587,2576,3778,2587
10701,bec159bd7e4a399443952a24b8e12581d27b9fa96dc1ca2d869415f50cb178cd,worm,222001,903,1736,1711,2614,1736
10702,bf596e914383a3b3865fb72e8f5310ecbb416dfedcc479b0631a71d5449c1e8e,worm,222925,877,1754,1790,2667,1754
10703,bf670d45dd865e204803000f964dc5d7365c5c0f94d0261de14cb7a25264b46b,worm,149963,572,1160,1184,1756,1160
10704,bfce02aa4f56962e429dbc638a15cb3120f5e495d0aab44eb362947953d1f414,worm,223184,867,1754,1751,2618,1754
10705,c055c8c62c15eb4de43125d34a1374979fd56460c99df2ea9da4f19900d75f56,worm,223132,873,1727,1729,2602,1727
10706,c05fc4ced048f320e986258a38ff764ca88bb34df2c11ed7727162a6c6887a3b,worm,221732,826,1737,1775,2601,1737
10707,c0c9736f06124132aadc0d953f3bb9eb82d576ac3a50d8c61e7de96a353cae57,worm,222892,920,1715,1806,2726,1715
10708,c1154db9ad126bc49c8a9f3047da00d25bbd7138dd7299249b98890d2b342328,worm,222981,821,1741,1781,2602,1741
10709,c146dac39a53453adddea94443c5935b712dd170b331502f48f07c48ac502e6e,worm,221768,873,1685,1749,2622,1685
10710,c166bd765d5abb63bc1ff7d2f5746cbe03f8ada8d061e2a1ee5dd25fdcd0e73c,worm,223089,849,1792,1761,2610,1792
10711,c2241d768f71640bcd81c5e79b7ba287a26d5c7fc4be1cc9ff9387430d44571b,worm,221829,861,1678,1821,2682,1678
10712,c2393a27b4cc3198102bd2bb7d7f21a5ba9dd838a8cce4a7cf402ed43c432dda,worm,222903,837,1760,1789,2626,1760
10713,c287ab6ffd7264cf24bd518c09948b29fa1ccf0e6988bc4566fb1c1a62a4557f,worm,223165,853,1726,1693,2546,1726
10714,c2a6619026280f8d5cd69359119a365f5ed25e665fd794291bf0fdf56735386e,worm,221818,852,1765,1796,2648,1765
10715,c2d1a0678aa3d2cd0c06bd89dacdb177f7e2e370ca562308fefc8f3090069840,worm,222041,865,1725,1732,2597,1725
10716,c32e1f87eef1d8867d764f89cc7d71b69e4cd4911becbb5b57b076469aa4b915,worm,221936,920,1767,1692,2612,1767
10717,c34d761cac72f67ce5525b3e74de84eea2569703399b0d2335dbce8ae63d4eef,worm,284380,1205,2116,2285,3490,2116
10718,c35cc13f7d3c84994e902fdf7f67767df5802d6dca88addac60582bef8270259,worm,222976,850,1724,1803,2653,1724
10719,c3a05d9b650d3ff3a07fca5097cf9e6122066882ba59c43069c33613bbaf7afc,worm,223049,892,1745,1806,2698,1745
10720,c3b89ba7e63bfa6c4c67f3e1100bc34043b21fb32c6692d7ac87203a4a07da51,worm,222905,825,1757,1814,2639,1757
10721,c3ccd459a3bf02081210b0afb3b013054f1eb7d40460b2d706a1326b2b9db35d,worm,223327,929,1752,1772,2701,1752
10722,c3cd61a7dae9010d678441ab577e087f36e516c63ca2f748f1b48219291c973d,worm,377507,1474,2997,3008,4482,2997
10723,c3ee29bc15874c9df5f86e85d41dc6de175f60b6843ab8b6f340403516a288d2,worm,221965,895,1743,1784,2679,1743
10724,c422f846520ac3011e04d2b6213a233299868def19b8b7f073745bf39592aee8,worm,321724,1282,2509,2614,3896,2509
10725,c429d11b2f9f7a04ba5fac720d07e28a2fdbb95d45d0bfc3391f8fa30e1ccf88,worm,221774,819,1769,1756,2575,1769
10726,c43ed098c67ffafc4e97af2150acab7c1b239e213f94b1a75c788ceb4191c9c7,worm,222818,882,1688,1739,2621,1688
10727,c4f798d5db2246ea220b16c6ef6ea77f822f631331f36c6fdab81a9a3d810c0e,worm,321602,1244,2565,2572,3816,2565
10728,c551e21e6337984bc1cce2cc3c5846bc42c695803b3b75036555230c0f53a1cc,worm,321819,1251,2443,2504,3755,2443
10729,c614e342b1708bf5de84f06524a23479f726134858a015fef472274891f5dcb1,worm,221896,845,1707,1682,2527,1707
10730,c6738c042484752001205ad2e1d3adf30d0e30a26727bcea5f9b33929eaaa60c,worm,221904,831,1692,1803,2634,1692
10731,c675cca512a802fb6322d45b90abd4fb34f7123e6e958a34d5785f316f1df532,worm,223107,902,1729,1705,2607,1729
10732,c6c1d6a63e863080eb99ed5f900220cad07b06a22929f6bb834c2ce188533884,worm,223071,869,1732,1750,2619,1732
10733,c6ebe1fe9d5543a90af8a813f8116fac211356e81688a1ba6d598008349cc582,worm,223131,830,1762,1733,2563,1762
10734,c761b124cfc9649a227083e5cd9ffe50fd3ce73ff4762346e5e25bf2d85328c5,worm,321762,1346,2532,2451,3797,2532
10735,c7837520024472b70c2bf649661ea6cd7a38ea237eade615b6cc20a29383d8e5,worm,222988,883,1675,1823,2706,1675
10736,c7898e5c42c42757ec70d8c4650e96d6b17f3198c87b55313fd4d692e23dc46a,worm,284223,1202,2114,2285,3487,2114
10737,c818055905d511705beb7b62f3c134f081390c50657481d4f47b5788f03ecd29,worm,223132,860,1730,1677,2537,1730
10738,c81fc32114faecbf87a39ea6f3f34e2690bd05ac8cb3c55191573e356bbc59e9,worm,223052,887,1722,1736,2623,1722
10739,c8a6dc9a2a47bba90d8de99eca41a83032beb36d7088f40840d2e5e59a0e132d,worm,222926,859,1783,1790,2649,1783
10740,c8b6acd3db254fe72e27105e3bad294eeea5cb8fd3fd98a29fbdccb03140b100,worm,222135,879,1761,1829,2708,1761
10741,c8cffb1d8e7c40cda36e6d72019621f8c022c8dff2e8e5eeb1b03ae4f9cbb73f,worm,222886,876,1683,1845,2721,1683
10742,c8f263995431733d1cce2d421d38a0207ad3d338d6443944aaffad48b64a27f0,worm,250457,950,1933,2002,2952,1933
10743,c9f1384a5f44819f1e499aba13c1aba6306d801f33061046aab3327c272e7303,worm,221938,941,1748,1716,2657,1748
10744,ca0afaa9cc56932068a50dbebd8073fb4b63182500a18d1ecec813e4d28669e8,worm,221739,897,1746,1782,2679,1746
10745,ca1b7e21b34e05bb500b3bc52d8e541684654312a8110fa841e531f77c7cc9a4,worm,223037,932,1788,1726,2658,1788
10746,ca5cb987c9d2c69bacc152963488a7a069adb2e22b2a171bd0eaf00ade508bb4,worm,223187,869,1769,1735,2604,1769
10747,caecc13139822d22fd20a497c038c5cea5a086f68f42d09a8e1495cb1502f2f1,worm,223278,894,1773,1846,2740,1773
10748,cafeb6647ac1761cf880e2bdb3d6e89a3d7acfbf0251589036e558d3e839a03f,worm,222860,881,1656,1810,2691,1656
10749,cb3789c4cf1b86f00f6287b26a626a01a0b283d25ccbd312de8ac48b2fce906c,worm,222810,885,1728,1822,2707,1728
10750,cb83f35a057da2a4c2b0bdd66cd6bc063960ad2873bbdd3d881dd0afd2b8184d,worm,223128,855,1720,1771,2626,1720
10751,cbe181bd4f12eb6779ee4a056a44649cd3623d85792ec458837879f232e075e1,worm,221842,865,1701,1774,2639,1701
10752,cc487657fbd8844a5dc29814a35512d3d309ec6fbf6c676dbf66d0009e704269,worm,221814,908,1728,1762,2670,1728
10753,cd12e67fbd4c450eed47911fd9d9158aa72856452c9d082e88168bba5222bf72,worm,221635,887,1739,1779,2666,1739
10754,cd1fe0d73346c65b523cefb4c9ea4e62656924e784ef73931ce83b683d94327c,worm,222537,869,1725,1784,2653,1725
10755,cd2f62663f53fe3e8353d5aa138cb08a347aa9cdaa59caa4b8420d445465e6b2,worm,223094,876,1728,1745,2621,1728
10756,cdf96591c51b06db97884eae664753d42d41cf9a9f0085ece426983ce3762feb,worm,321634,1257,2482,2573,3830,2482
10757,ce391a3d899f10095ec896033082c42548fb9eb9cee99aacb7b75649d8ccbe5d,worm,221984,867,1721,1760,2627,1721
10758,ce95fbe362d25879d4be8e289cfc2698b52459fd4178fa5f49d69815e4100a38,worm,321689,1274,2522,2588,3862,2522
10759,ce9863e152290320df7efa71a87ffa3eb72b0c893c223e5251fbfd875638b947,worm,222623,893,1704,1765,2658,1704
10760,ce9e58d3cb784896f506c9261aeb4b399cdd01bc1942786cb58719bb0bfd6a56,worm,321757,1290,2550,2545,3835,2550
10761,cecccf3d877362b6e4de654ad684bb4bab145db84e77d4d08f5c818ad3544d7d,worm,222908,893,1722,1752,2645,1722
10762,cecf5eba316d3ed7bd2403992f92b426bcd90771885f87b1a7c4bdad3c51149b,worm,221531,874,1727,1717,2591,1727
10763,cef135f538d35bf448b5927d4c244645b3a563a0924a2346ce2f095861d5c7c7,worm,222857,848,1778,1757,2605,1778
10764,cf2d213d6900b81b275e65449b6964fb959570ca8eacbe51b8b85db66d19e6f6,worm,221856,863,1761,1744,2607,1761
10765,cfbe9d968f642e315f418536514ee426fd0f4616a1037141367964cae39065bf,worm,221752,887,1758,1745,2632,1758
10766,d00796649727fb9fa065777314c78161ee424f417b13b025cf44fa1c247a5985,worm,321967,1212,2541,2576,3788,2541
10767,d00e0857c78a8b06992e7a3b3c3665c7912ba81aa97afdc4138e54af8083a918,worm,222881,880,1754,1806,2686,1754
10768,d07ee200adb1019988b0835ada815ebc97228025170ee49df453851ec257ea16,worm,321761,1274,2561,2525,3799,2561
10769,d095029bd87ae8ebafdb29337d59c5bd96442f28e9ac8a1da33021b9859764cb,worm,222972,885,1725,1746,2631,1725
10770,d0a5e7414d2b87de23f6e57371bbabd3ea6b844e56b7bc05fa3e68251c233e79,worm,222867,833,1775,1839,2672,1775
10771,d15a6e3f7468d9b8f158467404d7fda7bb44ae183780411b8cd2b03a08b9db0b,worm,222880,875,1741,1773,2648,1741
10772,d1c16d712ede775ec850c32ebd5c9c195a3cef54abd64627b038cb6398a5cde4,worm,377478,1460,2991,3029,4489,2991
10773,d20754c592a0877025771f5dc6b338b83a6991b7bf0d3bbefa762dc4403d2885,worm,223138,860,1778,1731,2591,1778
10774,d23f9f5a7f665eae8ca256580024c1ae7255b5e814623a7aa4642e846440c9d3,worm,321977,1238,2501,2562,3800,2501
10775,d278d21f4dbe945d1678d811c9bb9db381c54a50beae6cb23090b7abff8162b6,worm,223155,866,1704,1744,2610,1704
10776,d2869c09de6bf07909c70798acfbf0b85d68b7b5f020d2db4265decc3837234f,worm,377263,1471,3070,3073,4544,3070
10777,d2ac8212fba516b08c968eec40a73be2f0cbe7bd4bc865191aeda43330b83481,worm,223098,913,1699,1719,2632,1699
10778,d2b03025a036833b4312c466263d1c2606e8c6d0f9a19627a1ba52acd60517cf,worm,221725,884,1694,1771,2655,1694
10779,d2b62710ac5ffb885f7f5f1a31038e434ea0062abf298965e43a339aa23d2911,worm,223181,854,1798,1695,2549,1798
10780,d2ba091aef996e8cc941f0746749e35036f5cce5123765acc5769436a2e8f0b2,worm,16006,64,134,142,206,134
10781,d2ec1c1daa723370432367e625ddb1e1bb2b420ff1568909e76406c8361e13d5,worm,223050,931,1750,1794,2725,1750
10782,d374310ad3f58f9117988f48cf0dc14562087c1d764cab31965a6f5936679516,worm,223252,831,1747,1787,2618,1747
10783,d39c433c0443b2c481a510ee45d87f2763d35cfe96b0d6ed64baa515b05cb85d,worm,223174,847,1749,1739,2586,1749
10784,d3affb031ebc8ea327397729b639b6b3723a928ee5c7bedfef5039a98fe35b46,worm,221867,873,1785,1760,2633,1785
10785,d3b40a6423db5c21b27eefe779f4d2e626b8995f84f704d46ae6e3971fa96962,worm,221968,897,1688,1771,2668,1688
10786,d416c760fe35a9dc0196559c0c5ecb88fd800e3a97a1f0158fb4349e7e366a55,worm,322033,1222,2549,2563,3785,2549
10787,d4852597539f969f0239455f0306a4c69bd48842b1037362bfd7d1807509d365,worm,221906,846,1724,1781,2627,1724
10788,d4c58d9048583b454696c87e8b360cead76228299ceb6f50808e7a620b72ce77,worm,150136,571,1138,1216,1787,1138
10789,d4fe931392c91c85a89234e343935311af36a0c502ac7f933e7f5f4d432422ad,worm,221621,879,1672,1768,2647,1672
10790,d51396eb2d0b3d2b40361996c29fc39afc6bd075f22a0c9f626d911efc6748e1,worm,321919,1202,2475,2591,3793,2475
10791,d5319f94de62147a9df609f9d9a9af1f8763363efe103b1057f2e5f414b985c5,worm,223095,889,1721,1746,2635,1721
10792,d57e6de0a54c9447b12e8a75e455263b44112a0fe0bf6f6ef755d9581a3cce0d,worm,221826,880,1729,1800,2680,1729
10793,d5d07c14ec01c1654abd47096dbf60df952d6a5811c20ee587b969c991a19f75,worm,223163,834,1784,1716,2550,1784
10794,d5e4aa04efc473dbd595b66cc99ce52afa2cdca2975121f7b2f3d552d1ee8600,worm,223018,905,1698,1744,2649,1698
10795,d601a487f220f57b3f8c0014ca3ecfa41d1a874edb535ca0633e610fbd863883,worm,223197,851,1728,1727,2578,1728
10796,d61a036e513abad5417aa8178487bbb8a32f254a3245c9dac178546239f81494,worm,223049,859,1713,1741,2600,1713
10797,d626cd74f1a241b402b24aafb866eadebf29c9fda838066273304cb5cc78e713,worm,223127,846,1756,1760,2606,1756
10798,d6f097b42d473b5ba9d0fd25d132d1f9903528e4af549ef2cc250293092652da,worm,221847,861,1715,1779,2640,1715
10799,d7519ffc9fc42528517e67050fd18d6d0854659969c03665684feb7bfb654449,worm,223218,906,1727,1730,2636,1727
10800,d792ed596dc04ef70dbe46104e9b1b3c3d4f8964a05509e1794d246a7156c2d1,worm,321974,1261,2592,2569,3830,2592
10801,d7dc66cf914016dda389e1e9561b70b22d0304e2f1390f557eab08715614bfe7,worm,222650,850,1728,1768,2618,1728
10802,d7f66640eac884638e2a7f15e8d7662549845b237d2e9081c147de0f7e782d5c,worm,223007,920,1747,1779,2699,1747
10803,d820ae034e5892d7bef7eb7a4d6cccf4291ba414c31154294971a82156a27045,worm,321518,1229,2553,2559,3788,2553
10804,d820e2849c7b76be352b11a14f2c4b20636f8cf4038accae8e17e940c187ed84,worm,222993,898,1681,1779,2677,1681
10805,d82c9df3f08627fc2edcffdf6c103f2bfe32fbeff295c7aca8cfec7d14666d89,worm,222970,879,1740,1763,2642,1740
10806,d87833b367478b421a7f41574c5ae677fdd235f466a94194d99ec48551ad5eac,worm,223198,902,1818,1788,2690,1818
10807,d89fb16b3a6d837f47ce0687ded997d3c520b381e4eac2ec83c959ea8c9679ba,worm,223012,878,1700,1752,2630,1700
10808,d92d1b66a7c5c7027baaee280a19fa1c30f7707c94a2d18701612722db82f4d4,worm,222895,873,1754,1788,2661,1754
10809,d9565924b25a06cda8fea11593d42bbef6dc89d7eab2e05a53e990a5d3b609c1,worm,321744,1253,2518,2538,3791,2518
10810,d97c9e481e25103a367d3db09cdd89a14d67d5b49658a89099c61f2dae060eea,worm,221811,826,1754,1795,2621,1754
10811,d9a0cd5c6eb7817beee54b058bf5cdda81d2da7b8247301de51f4be200811413,worm,223188,805,1790,1739,2544,1790
10812,d9e610e9731df6c441ee84eca744da0cb6e573b6ee910a6bfcf25f58f3211eab,worm,18463,48,145,123,171,145
10813,da1df597433601c594f89b17ed1301c236454760b3ded327ddd1863a582afe52,worm,221985,917,1709,1718,2635,1709
10814,da3ae8713e81d893bc1f529abeb284725edb991989e31ded3d1d694923feb3f4,worm,223139,868,1776,1722,2590,1776
10815,da403b6435993dec6b25d642d864db34754e6d981fda89a89d2ad60c22edde91,worm,222907,837,1751,1801,2638,1751
10816,dbd1a9068a04e26cbb6ebadbb93c45c888336a6ff253ed8f68bb943534ee8b95,worm,222765,854,1779,1777,2631,1779
10817,dbfa235583eeaf4e10ae331993a044f3a0d08916bcf969b45d194b9c0b3331ce,worm,223024,915,1730,1781,2696,1730
10818,dc3a1c764304ff76b4210c445f954f877dddc73a7cc5e1b25e66acd6924068d3,worm,222792,896,1704,1728,2624,1704
10819,dc703cd215dca690b07b96211c0a83f583c99e4fb6229c36b3bf6eaee3ed5158,worm,222909,828,1749,1778,2606,1749
10820,dc83e3d4d1848996cb39648588b2b9053047bb41a0493746849fd32b7ebfd21f,worm,223254,888,1660,1857,2745,1660
10821,dca7048db6c2d869b205cb73b3e3e6641de2ea2466740b59a5223d2b5cde8749,worm,222804,846,1745,1794,2640,1745
10822,dcd04e68cc2cc0c778abe127bc51a05559502a304f7ee32a6c2fa6a94e820321,worm,222792,865,1718,1766,2631,1718
10823,dd64817ac5e66a2f6a57e388eb89e613212242d405d7095e496b052a3f52fe78,worm,223015,897,1718,1778,2675,1718
10824,ddc46ee24db810161fe7187c7873422fee1ac094c2abc292409db8519dcaba76,worm,16013,51,118,150,201,118
10825,ddd6c1ec26e1fc1ae14bad38202f13a51626c8291026d869e0741479846e9a00,worm,321845,1249,2565,2547,3796,2565
10826,ddea77006ab77392fb9c346f028f6683306d72a29eda5039bb4907bc7fa57f9c,worm,321561,1283,2479,2571,3854,2479
10827,ddf3ac411c81626e87ee384edba3ee90b947d60cddc4fc859a72c96c15df04c7,worm,222967,880,1706,1697,2577,1706
10828,deb5ab4becc9820b6c22155fd26deb86a76948defb562ffbcda2ce768934747f,worm,221890,865,1656,1745,2610,1656
10829,deded41f40a9924d8d47df952f45265fa7258c0003679ca9063192fe614b2cc2,worm,321695,1325,2528,2581,3906,2528
10830,df62a12f06bdf7881a7bb1f53fecc17dd9815412a8251130898e1e126e18690f,worm,223114,836,1756,1751,2587,1756
10831,e0326f4c4458f5652f5f966c7c722158d7ced9334c8e1f6dbcdf85243800ed7e,worm,222629,891,1797,1737,2628,1797
10832,e04ffc63a2acd8fb89c3b5698364e49e5be7cc53c3f964d6ac9b370c8293b744,worm,222203,860,1745,1782,2642,1745
10833,e053505483fc60359ca3b875f24f3a826aed02f8327aaeb9bf2f25c0e117776b,worm,223242,832,1750,1709,2541,1750
10834,e0a3d548442f9f8e65c558bc3d19bca8deac4dd314b5a7207e06b80a76bbe0ca,worm,223075,905,1739,1763,2668,1739
10835,e113eae466f276520bf339f3a350a16a101a521c4148cc43d27aabf0c22721ec,worm,221953,880,1741,1738,2618,1741
10836,e128836efb56734783487102b7368fdb02a89eb3c334e51da4278e86a7b14bff,worm,222929,921,1740,1780,2701,1740
10837,e13c903f424b387612aa56e7dd72618cfc238e3b35bd6236fc6a9739a3b9bdba,worm,321720,1296,2446,2605,3901,2446
10838,e146bba4238a916388026447fc95c0b69bef40897e6ab0800baf325032693d73,worm,222839,861,1751,1767,2628,1751
10839,e193c84945f952aec682e25281636f59dfe2fcc2b867851860bb359bbd06bd74,worm,222135,810,1750,1822,2632,1750
10840,e1cc851dc19dbe3dcd3055b699d6b6f57836fa94272ad2aafe4f0fde126e62d5,worm,222065,875,1751,1789,2664,1751
10841,e1dcc1e894645255c04871742ef5e170ee17afbf480e41477c4afbdd51247520,worm,222919,864,1721,1836,2700,1721
10842,e205b2ce91d23f00d86d9892574506b509a077ee5bf28604393e136237451022,worm,221908,855,1733,1721,2576,1733
10843,e20e17ed193b6a1c7853de579d388f32e73e8b18a556cfc205591701cc8ebba8,worm,223248,881,1795,1819,2700,1795
10844,e303a35d4702de17f3211da969ed71e0935ef55afc3441a7830a7ffe55cf94e0,worm,222963,886,1720,1746,2632,1720
10845,e31bbce7a30fad98ff4e9c10a9c408a41e44d8a773b566c3f10698c0f5e611c5,worm,222967,874,1695,1787,2661,1695
10846,e3b47e4511ab55075a6f34947c830a9318eb5d919a1f27d4ef2e3be0abdb5990,worm,223068,903,1713,1773,2676,1713
10847,e3d81c60599222ce8696ba3f2aaba3c7616a22ed84e246d40c939dc5a1fc3c4b,worm,223144,820,1734,1773,2593,1734
10848,e403a762f1e11cc0dda1b925ed1d45acc2230a6f135fc3dbba814cf0c9a43f80,worm,223013,878,1757,1732,2610,1757
10849,e442c4e4aef961c06f8f26d97f352e4e0e1d61733cdf1c87b56a3373f9e77e9c,worm,221777,838,1722,1789,2627,1722
10850,e479b8af9a6a6c787007154c67c506215cc5e8e22f00107e9f014e8a4105bfe8,worm,222193,842,1707,1745,2587,1707
10851,e47cc788aa5664b33147bb9956456ce4e8554eaf2cc1b54132f69dae2040c3bf,worm,223079,923,1755,1700,2623,1755
10852,e4a7209f16cc6ce0c10fdd6901f2bb0310603b87be7b56d2100b1207b64db4fe,worm,223064,917,1803,1745,2662,1803
10853,e4df32d4262fd5f496cb84b271133521dcd33d22e2934bdc93580efe1e966991,worm,223089,883,1726,1825,2708,1726
10854,e51f86ff45b9610655236597ece994a64170a2e7c64b0283cd7a98fa9ec09709,worm,223064,877,1732,1753,2630,1732
10855,e55613e2bbeb16584e42326be888e29c7c02ada80b40085877e5f78e1a90f85d,worm,221885,889,1717,1762,2651,1717
10856,e5e4fb7af965befcf27aa93d0a9b2303eea7e8173ea6df5b9bad62728cab6cf4,worm,222739,833,1788,1743,2576,1788
10857,e61757cf6e012156dc73f897c854a8116d777f17b7fe60ac032e59479028434a,worm,321699,1277,2510,2466,3743,2510
10858,e68895e2bc4b2bf6c23458d0b265643806fad24616231fbd153c9de6e0719417,worm,221853,860,1680,1764,2624,1680
10859,e6d661e06cb97fe21ccb06232cc8effe26b8e5c2f50437181500a3247b25e7aa,worm,221960,929,1707,1724,2653,1707
10860,e70d9c5cec8842f2a6e6be10cdb78b676644592aa102ce3eda94566550c9150b,worm,222006,861,1762,1713,2574,1762
10861,e7292996452772eeb8f111c70dc0d63335681b616f4b3d5f78996843ac78e8fd,worm,321583,1213,2557,2592,3805,2557
10862,e7540e49e6301ca999338dbe16f6f2c7960e7811db9ec1a51e5fdb5237987daf,worm,222861,883,1742,1734,2617,1742
10863,e78051bd65bc12aa132e44b92476a39003acfe14ad4615d0d450755c42af5c0c,worm,223088,914,1675,1768,2682,1675
10864,e7b30bacdcbc028be87092e916b653af79b3b27631caf7c769827ed62adb366a,worm,221946,917,1745,1689,2606,1745
10865,e7c26fa6edbb8be3abcf88539e841e99a6ec6f9aec0e910fcd90adab40e8af73,worm,221797,873,1780,1771,2644,1780
10866,e85b2319affadfc8eba6591cdc237aba507ef0f2bb0116ba72dd8ae8de6e4e4d,worm,284321,1212,2114,2291,3503,2114
10867,e873c154c06d99a72ea1ce366a8a6fb4b4d08c6ac05c71d9c7975240acc7d3d0,worm,223231,827,1713,1779,2606,1713
10868,e8818fe1647f93472de8f5699beede6bf6d73db2421101674d659a1e359be7bc,worm,222824,873,1772,1741,2614,1772
10869,e94242556c1ac332b23216f7fd40756f66a8ab6bc6dae236af93549ab1a13217,worm,222134,878,1798,1702,2580,1798
10870,e970d1f5974ee5c8a953fe85c20726f4f4ffe7111ce17f008181772981fe08dc,worm,221956,891,1819,1707,2598,1819
10871,e99e0b4123b99a38ec6af7266913148424a7f5395e73e07a9058cf399296c7d4,worm,223127,848,1744,1735,2583,1744
10872,ea0967e885a2f7b93a1160a2ad8a5267010c476ec3301ce6da2e77cd0791ed32,worm,222942,900,1750,1736,2636,1750
10873,ea5c068f401f76e4f8c9548940d39fa4346770b1d972ea7497b8be51473964e5,worm,223003,922,1826,1724,2646,1826
10874,ead9649315648bc5580e07cf8673a7306a94e0466f7120c27e478175196249b9,worm,221913,851,1704,1694,2545,1704
10875,eae7059d0d55f73f409e424e454b8ab89825e7e80b6cfa345bd331abb25a5df8,worm,222753,876,1734,1761,2637,1734
10876,eb5e71d2f50674874f507b06161ebaa309fbef9452641f16293f86f302fb9d5d,worm,223040,914,1774,1762,2676,1774
10877,eb9e3dbb48d15e47a9020093bfac074382f00317464e930ab0f5b74865aca967,worm,222761,880,1743,1759,2639,1743
10878,ebaf3068830c78293fc96a10d6a824098e78f26f5f1b0cb62dbf065988e96efd,worm,222897,896,1670,1809,2705,1670
10879,ebaf5d41ebbb95c16942e473cd052cfe4e5683563e5bae48d015ded74716c5e1,worm,321657,1303,2561,2541,3844,2561
10880,ec9b2123396d4faf114cc5dd03f0e7bd16f9fb35a795bc33fe610c96934d4859,worm,221686,871,1766,1739,2610,1766
10881,eca5e42116002cb428b878234cfe6431104becc39128b93ed41aa958f5577ff8,worm,18466,65,119,142,207,119
10882,ecdace717c96166493ab6123101a1ae88068fb6015b2bb1f5fccd50d38746261,worm,163528,670,1311,1313,1983,1311
10883,ed5bf414917f3794debb5013a7345f793f1cf8d4147ae5ce1053564df0a8a97f,worm,222793,875,1774,1831,2706,1774
10884,ed698fc816847c656d2d0fb0b4f32c094a09ecc96f40fa85487d88a413fc5303,worm,222845,871,1779,1728,2599,1779
10885,ed99fae1ae2cb8a814b9c35818fe957a098032e96d88cd2998f0c62f27edb3bd,worm,321764,1259,2563,2514,3773,2563
10886,ee1c60602c71b101a689f514409277503a1845de6a601d666ab057264e37d2af,worm,222852,804,1733,1824,2628,1733
10887,ee34e3f1d35218b252ed1acb6233bc99be75d40ab6f11a017a769556ae4e96f3,worm,222902,868,1729,1795,2663,1729
10888,ef420326e956696cac48371d0e829e4f7451d2ece99a435c9536c7e4a2fe09be,worm,321988,1238,2504,2553,3791,2504
10889,ef4c571c781486c4c799976254e4812ea574c71f2300d28547c5678da48000d3,worm,223006,929,1762,1727,2656,1762
10890,ef4c7c634c91821fc34e94a1df30cc9abf270f511ea37cec68688e7a69ece50a,worm,223215,885,1818,1758,2643,1818
10891,efa5c62f1003907428b99e7bd8bfa4334692f82c61204306fa7f5de750bb6351,worm,222194,836,1692,1840,2676,1692
10892,eff51a87c67c75374d461de7eea10a3d7d29de574f109bdf32a8bd940c0d545e,worm,222687,872,1695,1840,2712,1695
10893,f007ed306f3a9cf16c0f3995037908cd9242777a07471b41161b6b7f20bf7f31,worm,221803,862,1773,1772,2634,1773
10894,f029c097cd7fee16a4496ef62d5b85a9192ad7c69c2b78708a33804b6a79ef4b,worm,19635,73,139,185,258,139
10895,f03e065ad74ba2ebded76f1d83bf083c0d9511764ac41b8ec3129aa0156fdf71,worm,222111,872,1726,1708,2580,1726
10896,f0455f323b9ba5ce602018fbfeb0431fe1529e63c197468961d9104fc1d7b7b1,worm,223083,913,1710,1788,2701,1710
10897,f0f881bf3dd72e7110c52f9cccde15f279766aec93628159b551f13e0e1ed8e8,worm,222813,857,1741,1779,2636,1741
10898,f15470b0a8107c122038b3b7c26e542b5a560fa1ba936106b055d588d81433f8,worm,221910,845,1779,1752,2597,1779
10899,f18690b05798e934b8dcdf07ee2446f1dbcef1b11b2749e3dd26127fe8554802,worm,223241,864,1704,1814,2678,1704
10900,f1a530fd921851e98ba8c26b93ac5943d395be77afe690a289cc22bfaba1356b,worm,223126,860,1742,1701,2561,1742
10901,f1d3aeeb6ab48dd461e479bc3fb454f3210eea80ffb0242fa724e69a723541d7,worm,223148,882,1726,1761,2643,1726
10902,f1fede9c25864a51ad1b95bc9865b070e8fb1519888189feb7e82908fbeb0219,worm,222976,896,1763,1764,2660,1763
10903,f25602f8a398bf3803eea489e6a4b2e0a2e964171e745d04deefa184c1f9f7b3,worm,222939,888,1770,1768,2656,1770
10904,f2aae374b45e529d175206b3e505f85d278d85138cdbb9447e66d753a069c008,worm,221992,903,1750,1741,2644,1750
10905,f2b4a60edda1bff7a7cf9333d11f0df045381188e2f5f6504008b3da7a99e3b4,worm,223110,919,1791,1787,2706,1791
10906,f31f63106607dee32ee298f6b9853bd138bfe56c1d5e05ba40ddbab074011f84,worm,223008,863,1678,1736,2599,1678
10907,f31fe62f9602e6b3954c7a3b1c33e6050c7e122c531a0e53bc5ced8ef88ca9f3,worm,223335,875,1746,1800,2675,1746
10908,f34c792ef55927e58dd9610d9ac82b4c60ee5cc20098c3f5da3d8e0207380f3f,worm,221999,849,1784,1776,2625,1784
10909,f3aad618b8f2aa124609c6e429b2ce4fc1f8ed743f5e7a2122ac6bf6eb65d6a3,worm,16006,54,117,130,184,117
10910,f3bad0d2f32770b71673834603c16476ee09750edb3d1043493511011b9222b8,worm,223069,872,1736,1807,2679,1736
10911,f3baee8609d8b0c3cd4126bc3b45c2503c103bd8b8918ddff14d8afee38ec328,worm,222980,908,1753,1721,2629,1753
10912,f42ff8871a45dcb36a1256ad319536eb41c2356690fcd25c40f5580b1bd0e144,worm,222895,833,1778,1782,2615,1778
10913,f44e7f157802bb75a565ae3a7693815f7665a20f2544deffb40e89d5b51c8238,worm,221789,806,1717,1763,2569,1717
10914,f4d4722a69dde054f5036f34ea9beb2249f8d49d551bd7885db78521aa73fcf9,worm,223185,891,1726,1746,2637,1726
10915,f4f7f717056977b3c5ea847356fb3331df22dc8b3c6540790a9baf053ec3e258,worm,222997,853,1741,1742,2595,1741
10916,f502328b1a6d33d8cf30452f5609c7b74356634149edd85d369653dd1f1d69c2,worm,18469,57,114,154,211,114
10917,f604ea0dda9dcf90af400368a4ce921709066b859d550fe81b51daac6778044e,worm,221947,893,1734,1821,2714,1734
10918,f627f64ee9ef7cde538cd1e09ff31f771bd57a566ce27d270b5bcb24abcdfc6f,worm,223315,880,1789,1802,2682,1789
10919,f636fc9d31035a42e865225b05bc14f5ef20744dba598a8126caba478879f726,worm,221541,910,1648,1712,2622,1648
10920,f6556a13b2867038bbb3e3f1a6603908a4de69cf939b587bd7348d97a6d7355c,worm,221906,840,1743,1784,2624,1743
10921,f6ca623cdadedda61c527cba1fe36e19e63ba922b73e6ce6f594ef689e3b551f,worm,221812,856,1739,1771,2627,1739
10922,f6cf24f18f9d6ddb1cdd69a8d8d0ae971c52dcf2a7ae74047026f592d47804c4,worm,221985,924,1742,1738,2662,1742
10923,f6dfac5e1e3f431a4b900f2b85eea05eb6c2f443203e9f5542f2868b54408a17,worm,223026,940,1755,1728,2668,1755
10924,f7291a82b0a2c4dc4d379209da6f2425713c5709a3ae67211ea00bc7a5d59244,worm,222119,861,1818,1732,2593,1818
10925,f7775eaac56fffb6d27390b0eefbcb9134009d8468caecf70194b4961e024f37,worm,222998,910,1732,1773,2683,1732
10926,f798f68d5c0be9a5deb1d6745df95d3fbeca43ba8361b7be84c82ec7c3c22964,worm,223080,876,1698,1722,2598,1698
10927,f7c9e90bce65caebe7524238df2992671d57a8cc17b3521756a41bf1e8f08cee,worm,321690,1272,2476,2607,3879,2476
10928,f88d627a3628a8779b3bfdebed2e18a2018d2f5fad4affef8502cd831d5583ea,worm,223207,844,1737,1751,2595,1737
10929,f8c64238070863b6662187b1141f2c6fb61d976322d1711287e357299d54af51,worm,222997,892,1702,1732,2624,1702
10930,f94df0e8e1c28b50774bf8df8a745b48f4c5b995040ba4903e798b3e90482a99,worm,222998,881,1724,1765,2646,1724
10931,fa2784e0d25799831dcec5478ab932ad7b0cd5ef27bc8010a20bf2c681208819,worm,223003,861,1738,1748,2609,1738
10932,fa28d8dc2efd4fc869b6f140f0939fc957cc699c376edc3289d27d7dd4a8e246,worm,222875,861,1757,1791,2652,1757
10933,fa2af2c6d071571c9acb63a873828f59d2fe4422fdfa74d967b12532d62068c2,worm,223094,889,1736,1691,2580,1736
10934,fa79d1db77d0caf287d803e98cff60a5fb551ce7a5c91c7e69a08ae583265371,worm,222015,878,1699,1684,2562,1699
10935,faccc4aadb056db57a265151a20ff5fa0b2e15d691d1b76e208e6d308cf4dcd5,worm,223109,850,1737,1709,2559,1737
10936,fb399db0a553cffa9e894c5a1ad8c0cc365c2bb8227ad1a4330bac46a7f904ce,worm,221834,898,1718,1730,2628,1718
10937,fb4023de284842a0226c94e6d13987020fb4404be817feaa2bafd8776d8c7f16,worm,221880,868,1712,1770,2638,1712
10938,fb83637db0fe5ddc7b8a8b9c99f17e42d0e6feb49e752a81926a79c6f56a59f0,worm,77413,264,599,655,919,599
10939,fb98f96f593dd85caf2dfafb7593970a222c27c76511b125adabe1afb21be15b,worm,222968,882,1743,1770,2652,1743
10940,fbae656635299d9cbee12e3fd25f9537677645b115e80409c02cc3721d1562d2,worm,222755,882,1738,1790,2672,1738
10941,fbe652ef1b2004436de6396652d30bfec69d3ade4eaa81c481bc8b0acff58aeb,worm,223152,849,1781,1734,2583,1781
10942,fbf7fd50382ef6efcae33fb8cff43424be977af47ed43efabfc101594b3b36b2,worm,223121,870,1771,1732,2602,1771
10943,fc23e0ddf0bca68b3f255954ce2c3aca1f2247d33170e866c72392a8b170e4fe,worm,321468,1217,2465,2643,3860,2465
10944,fc3370153fc42b4e498ea95845994b6ca3f7572396b5aad54e77e78e62fe1cdf,worm,221622,883,1727,1719,2602,1727
10945,fd059f9973e902b6ea85c4c4d1277819a383d3adb9b4d1edcee10d3905712a9e,worm,222828,865,1720,1754,2619,1720
10946,fdd346e8cb90e382a1881e0243467b640ede2e8b92f300efd2b64bd8fe363fa7,worm,221739,839,1746,1785,2624,1746
10947,fde8ec62faaae41b67b280778a5f2b56c168c279b2b764f66e44f2cb6ee9d427,worm,223293,841,1724,1760,2601,1724
10948,fe187901a04d1f6a5f79bf7ea53ea4acba0c72d2706911776e9af7d24b108e46,worm,223021,883,1716,1728,2611,1716
10949,fe4fc9a33b7ae259e82f1761f9c8ca2b1ba5f0bfbd07e41c8287103ea22a31b7,worm,321797,1212,2469,2473,3685,2469
10950,fe6b3700af012672f67f32224025122de7e44a815fd7989e91cb1092616d9ece,worm,223065,915,1774,1690,2605,1774
10951,fec833bdf4b8151aed87c540b1dad3998785e901d0ee41c6dc4ef6da01009da3,worm,223202,876,1735,1763,2639,1735
10952,ff21d31ac2303a3a2ce8de0ba0dea1778667cd57a11759e88827b210b074c293,worm,222712,868,1748,1836,2704,1748
10953,ff4783ffec54af85bd39258d5c6f295e54f6bd6c64da09f4b9b8ebdbf684bc60,worm,46049,195,341,401,596,341
10954,ff80b4e5c8aebda9ae9f8d069fbb1950ce41c0ff4c5f2529bca361dccbf346fe,worm,223208,856,1750,1831,2687,1750
10955,ff99673762d6020d4ce5ad9bec2b1044262a9dd575f32b4b057418f003f6c7de,worm,223147,893,1732,1753,2646,1732
10956,ffa44315ce0bd3439edecfec4ce458b4f6fa4a6df8a6bf32fbd5d0456f983fd5,worm,222817,831,1738,1732,2563,1738
10957,ffe6c4f79d2bf5ef3cada96c22ee0cafcf6075eeb957fabab95cf0c66b99ed76,worm,222951,851,1710,1752,2603,1710
